,Company,0217price,0217amt,0517price,0517amt,0817price,0817amt,1117price,1117amt,0217-0517chng,0517-0817chng
0,21VIANET GROUP INC,7.01588427732,25371,5.48135902902,22987,5.03916579354,20043,5.65601848164,12553,-2384,-2944
1,2U INC,30.1385400632,24686,39.660834514,91047,46.922062877,250330,56.037494593,210377,66361,159283
2,3-D SYS CORP DEL,13.2901038103,840475,14.9588187487,724723,18.7005609307,1160393,13.3893329386,324288,-115752,435670
3,3M CO,178.570538193,2045679,191.329818607,2205767,208.190236741,2539951,209.900152223,2906925,160088,334184
4,500 COM LTD,15.3350191503,67623,13.4078720116,66006,10.8869946831,11849,11.0460251046,5975,-1617,-54157
5,51JOB INC,33.8111150193,22744,36.653031469,24691,44.7305480637,58953,60.6280193237,20700,1947,34262
6,58 COM INC,28.0010320404,720902,35.3896416832,601758,44.1098059252,673297,63.1399739536,687235,-119144,71539
7,8X8 INC NEW,14.3008474576,200128,15.2496927718,232726,14.5480253726,254605,13.5004753853,427022,32598,21879
8,A10 NETWORKS INC,8.31169629277,130178,9.14714182582,121896,8.43526693769,111674,7.55561774171,185822,-8282,-10222
9,AAON INC,33.0575970971,65038,35.3805073431,28462,36.8098159509,17441,34.4848375234,49761,-36576,-11021
10,AAR CORP,33.0529461124,97722,33.6306301662,58191,34.7645984589,89804,37.7790116602,180100,-39531,31613
11,AARONS INC,31.9892885683,944785,29.7406716678,860068,38.9001698075,842130,43.6310178821,933281,-84717,-17938
12,ABAXIS INC,52.7908430089,30403,48.5176707052,35822,52.9930539296,25626,44.6549162615,59232,5419,-10196
13,ABB LTD,21.0706481258,567899,23.4001273229,659740,24.9002183575,697022,24.7482515802,665744,91841,37282
14,ABBOTT LABS,38.4100355078,24272693,44.4100300122,23833670,48.6099962948,18725058,53.359990388,17378264,-439023,-5108612
15,ABBVIE INC,62.619919876,7703060,65.1601042889,8219861,72.509975725,9674986,88.8598974924,9820538,516801,1455125
16,ABEONA THERAPEUTICS INC,4.84868751045,11962,5.0,116000,6.42054574639,10591,17.0513489991,143625,104038,-105409
17,ABERCROMBIE & FITCH CO,12.0002162897,517824,11.930339825,811712,12.4404118759,572891,14.440581876,1335611,293888,-238821
18,ABIOMED INC,112.679276698,511709,125.199513159,511871,143.299493949,551921,168.599338113,500085,162,40050
19,ABM INDS INC,40.8402245017,2058069,43.6002832511,1923382,41.5203604205,1774816,41.709912752,6139284,-134687,-148566
20,ABRAXAS PETE CORP,2.57212155501,190893,2.0196056251,362447,1.62003407297,382708,1.87795442473,186373,171554,20261
21,ACACIA COMMUNICATIONS INC,61.8048711812,7103,58.6291991721,25124,41.4722821016,31081,47.1037416821,45835,18021,5957
22,ACACIA RESH CORP,6.49953574745,110931,5.74640013678,134519,4.09843400447,111750,4.55239705206,67437,23588,-22769
23,ACADIA HEALTHCARE COMPANY IN,33.099874954,2384722,43.5999191835,4271407,49.3800270241,4375352,47.759948779,4096759,1886685,103945
24,ACADIA PHARMACEUTICALS INC,28.8397405097,1544258,34.3797616705,1122899,27.8904609509,1908251,37.6700701761,1820278,-421359,785352
25,ACADIA RLTY TR,32.6798570972,5017678,30.0601215384,4632117,27.8000595042,5750851,28.6199091379,6831014,-385561,1118734
26,ACCELERON PHARMA INC,25.5189371155,473805,26.4699397544,503439,30.388976593,520057,37.3205454249,632681,29634,16618
27,ACCENTURE PLC IRELAND,117.130089407,3075162,119.879873671,3501647,123.679972987,4406728,135.070024701,4671066,426485,905081
28,ACCESS NATL CORP,27.7543445251,11854,30.0455235205,16475,26.5175056971,9654,28.6969527014,10698,4621,-6821
29,ACCO BRANDS CORP,13.0510925924,203278,13.1472369313,181483,11.6499488795,180945,11.8993309002,263040,-21795,-538
30,ACCURAY INC,4.58781362007,13950,4.73933649289,30173,4.74935896871,226978,4.00025585892,203237,16223,196805
31,ACETO CORP,21.9795682886,71066,15.8090899679,96590,15.4399271098,40609,11.2336958422,114388,25524,-55981
32,ACHILLION PHARMACEUTICALS IN,4.13001494595,4452042,4.20998441353,3725667,4.59003999785,3613694,4.4899063005,2706738,-726375,-111973
33,ACI WORLDWIDE INC,18.1499209915,476531,21.3878440862,333928,22.3686999518,533111,22.7788023734,538966,-142603,199183
34,ACORDA THERAPEUTICS INC,18.8009767797,344397,20.9984505549,302689,19.6988163513,534956,23.649123846,540316,-41708,232267
35,ACTIVISION BLIZZARD INC,36.1102580879,3963029,49.8599673583,5415166,57.5700340473,5405121,64.5100544542,4991718,1452137,-10045
36,ACTUA CORP,13.996772862,26649,14.0440343209,24708,14.0528304106,68029,15.3042275527,78083,-1941,43321
37,ACTUANT CORP,25.9489870097,94917,26.3425455218,54095,24.6009401317,161254,25.6035302959,270119,-40822,107159
38,ACUITY BRANDS INC,230.859396616,198779,204.000676429,348891,203.278709942,459266,171.28121782,465159,150112,110375
39,ACUSHNET HOLDINGS CORP,19.7231545951,36049,17.2878235073,58654,19.8345028095,71542,17.7610551442,49434,22605,12888
40,ACXIOM CORP,26.8008580765,249395,28.4692346588,241278,25.9804078357,343913,24.6384248693,296204,-8117,102635
41,ADAMAS PHARMACEUTICALS INC,16.905606084,19461,17.504967404,60897,17.4924041518,56939,21.1670988159,101431,41436,-3958
42,ADCARE HEALTH SYSTEMS INC,1.45997949871,779463,1.25953905715,743129,0.960486794695,720468,0.928135773005,15084,-36334,-22661
43,ADECOAGRO S A,10.3524653313,20768,11.4603433588,332189,9.98920729391,797761,10.7999090491,980749,311421,465572
44,ADIENT PLC,58.6036147561,201950,72.6710475454,191438,65.3785877233,266081,83.9889135914,437653,-10512,74643
45,ADOBE SYS INC,102.949625234,2704886,130.129918224,3505051,141.440405629,4047832,149.1797121,3934838,800165,542781
46,ADTRAN INC,22.3431124927,113234,20.7529877782,162579,20.6520892305,154028,24.0023482008,149902,49345,-8551
47,ADURO BIOTECH INC,11.4026951825,54987,10.7510529273,236721,11.3987949845,221076,10.651304474,193028,181734,-15645
48,ADVANCE AUTO PARTS INC,169.119920953,1060632,148.261054783,1143193,116.588753909,1155566,99.2002650845,736369,82561,12373
49,ADVANCED DISP SVCS INC DEL,22.2202000314,1571453,22.599711757,1563958,22.7298253496,1780700,25.189664319,1159285,-7495,216742
50,ADVANCED ENERGY INDS,54.7491134283,302288,68.5625375242,236514,64.6916146916,202020,80.7562781771,220924,-65774,-34494
51,ADVANCED MICRO DEVICES INC,11.3401437147,2689913,14.5499893355,6887359,12.480004067,8891183,12.7500022284,9984861,4197446,2003824
52,ADVANCED SEMICONDUCTOR ENGR,5.05096886766,32667,6.47901732433,269794,6.30920220224,58486,6.18537543636,75339,237127,-211308
53,ADVANSIX INC,22.1411753375,394559,27.3193762054,458356,31.2389641356,376613,39.7525280053,245846,63797,-81743
54,ADVANTAGE OIL & GAS LTD,6.76069471966,68632,6.59734221357,127324,6.7497610704,150672,6.30129903703,123784,58692,23348
55,ADVISORSHARES TR,29.2957746479,19525,29.9573560768,18760,36.8041852141,21791,32.1272991288,16528,-765,3031
56,ADVISORY BRD CO,33.2501328201,99759,46.8005849791,442409,51.5016319855,292282,53.6249816224,1537194,342650,-150127
57,AECOM,36.3594462966,650890,35.5880545295,476733,32.3301024126,510484,36.8103063809,950712,-174157,33751
58,AEGEAN MARINE PETROLEUM NETW,10.1487180789,118143,12.0498971193,77760,5.84251526423,56996,4.95271056479,67034,-40383,-20764
59,AEGION CORP,23.6973445702,286319,22.9093591122,177613,21.8748297838,91795,23.2855633215,107878,-108706,-85818
60,AEGON N V,5.5299192591,930755,5.1293760024,893481,5.10998239628,1040121,5.78960480038,1019586,-37274,146640
61,AERCAP HOLDINGS NV,41.6106930567,564254,45.970417961,226624,46.4311081838,774330,51.1097051161,684371,-337630,547706
62,AERIE PHARMACEUTICALS INC,37.8499827169,173580,45.3479666268,223053,52.5462703035,204829,48.60401007,167229,49473,-18224
63,AEROHIVE NETWORKS INC,5.71557155716,22220,4.22149539819,26294,5.0288476532,25652,4.07604653239,33611,4074,-642
64,AEROJET ROCKETDYNE HLDGS INC,17.9508482298,186565,21.6993208916,174199,20.7969136175,165890,35.0099395899,336533,-12366,-8309
65,AEROVIRONMENT INC,26.8298466734,1404257,28.029495778,1340124,38.2001586928,816672,54.1259601493,139822,-64133,-523452
66,AES CORP,11.6199434722,6740050,11.1799392176,11367772,11.1100187688,11148316,11.0199701827,10976164,4627722,-219456
67,AETNA INC NEW,124.009992312,3076365,127.549635125,3112161,151.82987636,3000312,159.010105416,2618299,35796,-111849
68,AEVI GENOMIC MEDICINE INC,5.17108592804,18178,1.86190845617,212685,1.33087139058,393727,1.25540048406,88418,194507,181042
69,AFFILIATED MANAGERS GROUP,145.299927649,1824440,163.939953091,1379255,165.859886469,1397324,189.830515477,1452227,-445185,18069
70,AFFIMED N V,1.80268422808,95968,2.2963126518,45290,2.05970604689,39326,2.24050294275,29904,-50678,-5964
71,AFLAC INC,69.6000717296,3089379,72.4201290988,3242013,77.6801643693,3696555,81.3898214666,4026474,152634,454542
72,AG MTG INVT TR INC,17.1123747821,56801,18.0566941364,46354,18.301111992,196764,19.2416146515,209234,-10447,150410
73,AGCO CORP,57.8591292077,795069,60.1799439909,721669,67.3898654281,885326,73.7700114229,1876928,-73400,163657
74,AGENUS INC,4.10915604257,18982,3.77079394594,673333,3.90979896424,613075,4.41062627587,362987,654351,-60258
75,AGILENT TECHNOLOGIES INC,45.5601329301,4952378,52.8699343614,5567758,59.309923808,5431806,64.1998060493,4885778,615380,-135952
76,AGIOS PHARMACEUTICALS INC,41.7270886407,76545,58.4002440212,649124,51.4496551866,681093,66.7495569411,932156,572579,31969
77,AGNC INVT CORP,18.129998265,4328627,19.8899768582,4701011,21.2899788248,6030161,21.6800611883,5224524,372384,1329150
78,AGNICO EAGLE MINES LTD,41.9999232177,625144,42.441884895,428374,45.1205891983,445894,45.2089423231,460462,-196770,17520
79,AGREE REALTY CORP,46.052960905,59931,47.9592589859,67745,45.8717955311,77782,49.0795435981,116301,7814,10037
80,AGRIUM INC,100.550544323,643000,95.5497348554,389033,90.4884139883,258674,107.21315778,182888,-253967,-130359
81,AIMMUNE THERAPEUTICS INC,20.4424862611,42216,21.7253677169,94774,20.5605668119,227377,24.7881767027,247376,52558,132603
82,AIR LEASE CORP,34.3306597442,450705,38.7487145859,402594,37.3586068732,324450,42.6199551466,325059,-48111,-78144
83,AIR PRODS & CHEMS INC,143.819729801,1007998,135.290355724,953830,143.059859012,1182512,151.220165748,1089729,-54168,228682
84,AIR TRANSPORT SERVICES GRP I,15.972380302,26358,16.0662122687,30810,21.7779124171,89127,24.3368529488,85426,4452,58317
85,AIRCASTLE LTD,20.850444343,230115,24.1285481643,194044,21.753290392,96721,22.2857088621,105359,-36071,-97323
86,AK STL HLDG CORP,10.209925686,6465669,7.19003549007,6346283,6.56990875403,5019400,5.58998907849,2832027,-119386,-1326883
87,AKAMAI TECHNOLOGIES INC,66.680170951,903417,59.6996989956,1364764,49.8101216283,1111501,48.719881338,1779171,461347,-253263
88,AKEBIA THERAPEUTICS INC,10.4173087592,48669,9.19292976439,49277,14.3718524102,291890,19.670404705,639997,608,242613
89,AKORN INC,21.8299356019,1210906,24.0799211272,1282064,33.5399894947,4058916,33.1899045763,4474463,71158,2776852
90,ALAMO GROUP INC,76.1003826108,33193,76.1909339999,20803,90.8072118395,30339,107.37547014,65406,-12390,9536
91,ALAMOS GOLD INC NEW,6.83982496079,875461,8.03082273023,716614,7.18061050572,812605,6.76084883057,1091431,-158847,95991
92,ALASKA AIR GROUP INC,88.7304710041,1498989,92.2205217932,1067051,89.760519274,860278,76.2702014537,739922,-431938,-206773
93,ALASKA COMMUNICATIONS SYS GR,1.64661553752,67411,1.84794086589,102276,2.20403842316,115243,2.25109338822,15548,34865,12967
94,ALBANY INTL CORP,46.2973852366,51018,46.0496170714,30554,53.393002899,35529,57.409008845,65913,-20464,4975
95,ALBEMARLE CORP,86.0813849793,412656,105.639179756,458400,105.539703169,483979,136.309506456,891794,45744,25579
96,ALCOA CORP,28.0803827142,754192,34.3997969597,1725766,32.6508147829,806718,46.6193320326,1154757,971574,-919048
97,ALCOBRA LTD,2.09342765013,59233,1.13373643962,44984,1.10322509469,27193,0.973192957622,11303,-14249,-17791
98,ALDER BIOPHARMACEUTICALS INC,20.7997707663,628180,20.8000478265,669085,11.450620764,718389,12.2499660401,1516494,40905,49304
99,ALERE INC,38.9704900213,651339,39.7295112361,763211,50.1899332686,2797035,50.9899716206,2720280,111872,2033824
100,ALEXANDER & BALDWIN INC NEW,44.8718738071,162418,44.5160721301,124719,41.3771911073,149696,46.3291839557,271125,-37699,24977
101,ALEXANDERS INC,427.025139665,2864,431.713722915,3046,421.429775755,11862,424.100156495,3834,182,8816
102,ALEXANDRIA REAL ESTATE EQ IN,111.130285894,1332769,110.519593132,1711416,120.470406024,2094531,118.969801516,2118815,378647,383115
103,ALEXCO RESOURCE CORP,1.35435914665,95248,1.51960784314,20400,1.32632509702,20357,1.44861014808,307191,-74848,-43
104,ALEXION PHARMACEUTICALS INC,122.35011498,1129766,121.239956277,1564410,121.669998005,4801874,140.29009663,3458227,434644,3237464
105,ALGONQUIN PWR UTILS CORP,8.48148148148,81000,9.58010151392,136533,10.5432098765,81000,10.5649313107,145292,55533,-55533
106,ALIBABA GROUP HLDG LTD,87.8099352504,11083928,107.829950412,15716051,140.899920246,15388497,172.70999818,15046309,4632123,-327554
107,ALIGN TECHNOLOGY INC,96.1297231904,1210146,114.710000712,1501883,150.119528873,1556946,186.269442795,1484033,291737,55063
108,ALIMERA SCIENCES INC,1.08041535149,813576,1.40050245235,509103,1.38896660227,303823,1.34613281283,118859,-304473,-205280
109,ALKERMES PLC,55.580486684,2036722,58.4996484169,2857077,57.9700363986,3096824,50.8401661712,3426346,820355,239747
110,ALLEGHANY CORP DEL,608.110964763,61497,614.667776491,55264,594.797687861,44980,554.006197432,54216,-6233,-10284
111,ALLEGHENY TECHNOLOGIES INC,15.9302590644,1245868,17.9612900702,613486,17.0092262943,819614,23.900413722,1638298,-632382,206128
112,ALLEGIANT TRAVEL CO,166.387300335,40568,160.25686511,28186,135.606740453,70203,131.707688018,78902,-12382,42017
113,ALLEGION PUB LTD CO,64.0002535771,536326,75.7014833916,783340,81.1189042729,906065,86.4697102982,505865,247014,122725
114,ALLERGAN PLC,212.361053169,4616694,241.243791027,5915431,246.749785056,4490703,210.066546798,3209621,1298737,-1424728
115,ALLETE INC,64.1944829608,177414,67.7107509738,99098,71.6698701147,68676,77.2923831251,176214,-78316,-30422
116,ALLIANCE DATA SYSTEMS CORP,228.501882808,428084,249.00057659,416240,256.693585931,259913,221.548320995,497765,-11844,-156327
117,ALLIANCE HOLDINGS GP LP,28.0985574722,152926,27.4300949158,156033,23.6996828709,170593,27.8104974964,439762,3107,14560
118,ALLIANCE RES PARTNER L P,22.4500304128,685567,21.6497831499,766428,18.9006046664,967641,19.3497189696,1324412,80861,201213
119,ALLIANCEBERNSTEIN HOLDING LP,23.4499548079,660513,22.8503824029,607736,23.650187036,592934,24.299000974,696078,-52777,-14802
120,ALLIANT ENERGY CORP,37.889915072,1359623,39.6099218125,1513030,40.1701937135,1447292,41.5700819039,1481859,153407,-65738
121,ALLISON TRANSMISSION HLDGS I,33.6889432481,757103,36.0600441666,429284,37.5095345953,1030458,37.530096258,2996635,-327819,601174
122,ALLSCRIPTS HEALTHCARE SOLUTN,10.2100105178,1215082,12.6799614042,2457263,12.7599659533,7287637,14.2299478348,9012331,1242181,4830374
123,ALLSTATE CORP,74.120192099,2580336,81.4897694921,2624943,88.4400522238,2623325,91.9101100284,2988409,44607,-1618
124,ALLY FINL INC,19.0199704452,5727664,20.3300094185,6196308,20.8998935759,5533521,24.2600397491,5923156,468644,-662787
125,ALMOST FAMILY INC,44.0971819552,34492,48.6002247409,576664,61.6504937156,586370,53.7004736729,588803,542172,9706
126,ALNYLAM PHARMACEUTICALS INC,37.4405235134,914437,51.250222183,1383994,79.7605628585,1511712,117.490108716,1793751,469557,127718
127,ALON USA PARTNERS LP,9.600031265,358228,9.1546966547,84656,10.4768664031,59178,11.5322580645,49600,-273572,-25478
128,ALPHA & OMEGA SEMICONDUCTOR,21.2628140137,35508,17.194043096,36059,16.6697883499,42712,16.4759317807,22457,551,6653
129,ALPHABET INC,785.376374966,4652116,841.359375445,5061648,920.44985337,4257654,967.306505322,4134584,409532,-803994
130,ALPINE GLOBAL PREMIER PPTYS,5.13869487128,20044,5.74162679426,15675,6.32911392405,10112,6.64242424242,20625,-4369,-5563
131,ALPINE TOTAL DYNAMIC DIVID F,7.57265656979,24430,8.25539225043,20956,8.7047876332,26652,9.00606456767,27537,-3474,5696
132,ALPS ETF TR,12.6389088651,40937632,12.7228357962,50907833,12.0433013733,42434959,11.2697464315,70614721,9970201,-8472874
133,ALTISOURCE PORTFOLIO SOLNS S,26.58729295,91886,36.8007526864,242332,21.8179292228,158356,25.872342692,150199,150446,-83976
134,ALTISOURCE RESIDENTIAL CORP,11.042165437,266071,15.2481810135,185268,12.93891203,370433,11.1093063705,295518,-80803,185165
135,ALTRA INDL MOTION CORP,36.9294256358,23748,38.9694041868,9315,39.7078104514,5339,48.089827324,22354,-14433,-3976
136,ALTRIA GROUP INC,67.619990628,8459244,71.419869486,10572352,74.470093206,10436458,63.4201164402,9197681,2113108,-135894
137,AMAG PHARMACEUTICALS INC,34.7997118715,231841,22.5500838843,607980,18.3991851177,559590,18.4505701766,631471,376139,-48390
138,AMARIN CORP PLC,3.07995123079,752934,3.19962891878,422549,4.02974120488,291582,3.50031897391,238264,-330385,-130967
139,AMAZON COM INC,749.86990675,3384111,886.540140855,3505319,968.000392955,3664545,961.350207273,3652180,121208,159226
140,AMBAC FINL GROUP INC,22.4996798661,1350997,18.8601710189,1842136,17.3498632875,1821340,17.2597433107,1826099,491139,-20796
141,AMBARELLA INC,54.1305664134,315441,54.7084457356,120475,48.5525125982,220071,49.0091229809,306698,-194966,99596
142,AMBEV SA,4.90998622411,11371315,5.75998701173,10963740,5.48997407527,15382222,6.59005882437,17881024,-407575,4418482
143,AMC ENTMT HLDGS INC,33.6451451124,91722,31.447804682,179154,22.7459038792,91489,14.7012357815,227872,87432,-87665
144,AMC NETWORKS INC,52.3397787961,1134338,58.679484207,560690,53.4111658023,439234,58.4714896704,397014,-573648,-121456
145,AMDOCS LTD,58.2503100325,1508713,60.9898717644,1324515,64.4597131739,1516389,64.3199368669,2260621,-184198,191874
146,AMEC FOSTER WHEELER PLC,5.71106988765,95954,6.58552975435,66965,6.01634977496,65322,6.7586414058,46607,-28989,-1643
147,AMEDISYS INC,42.632212525,146204,51.0920413752,169087,62.7949388031,53189,55.969362269,90085,22883,-115898
148,AMERCO,369.590369411,72602,381.181040762,74138,366.059852354,75586,374.90228108,85705,1536,1448
149,AMEREN CORP,52.4601271679,3208513,54.5900075363,3313317,54.6700832999,3205885,57.8400349106,3645883,104804,-107432
150,AMERICA MOVIL SAB DE CV,12.5699795624,2296742,14.170037142,2421518,15.9198363437,5560924,17.7499010196,6354796,124776,3139406
151,AMERICAN AIRLS GROUP INC,46.6899567077,2742517,42.300037852,2644513,50.3199918382,2607254,47.4895970889,3126769,-98004,-37259
152,AMERICAN ASSETS TR INC,43.0822255047,81240,41.8384220395,126391,39.3895980004,292463,39.7678376776,313746,45151,166072
153,AMERICAN AXLE & MFG HLDGS IN,19.3005539586,357969,18.7804712362,382738,15.6003425932,615307,17.5799984786,2155916,24769,232569
154,AMERICAN CAMPUS CMNTYS INC,49.7707244147,915056,47.5899612201,877517,47.2997977147,880934,44.1505902322,768257,-37539,3417
155,AMERICAN EAGLE OUTFITTERS NE,15.1698464069,2792052,14.0303611984,2281267,12.0501109163,2462218,14.3000021116,5209230,-510785,180951
156,AMERICAN ELEC PWR INC,62.9599527191,2976257,67.1299156926,3180147,69.4698037735,3749442,70.2400310221,2841841,203890,569295
157,AMERICAN EQTY INVT LIFE HLD,22.5396116938,667669,23.6300836916,494793,26.2794206937,614321,29.0800607639,819565,-172876,119528
158,AMERICAN EXPRESS CO,74.0799284941,8059754,79.1102273307,5974335,84.2396970621,3654346,90.4599521724,4024875,-2085419,-2319989
159,AMERICAN FINL GROUP INC OHIO,88.1206312245,702571,95.4211163273,676737,99.3695373398,913932,103.449227563,724655,-25834,237195
160,AMERICAN HOMES 4 RENT,20.980150665,1448512,22.9602811831,3863106,22.5700369898,5886211,21.7101121883,6087624,2414594,2023105
161,AMERICAN INTL GROUP INC,64.8657343383,3891762,61.1577232929,5239093,62.0827797782,8033677,61.0602782163,9807407,1347331,2794584
162,AMERICAN MIDSTREAM PARTNERS,18.1707646582,14804,14.8410456372,25133,12.8212633921,17081,13.649605706,79636,10329,-8052
163,AMERICAN NATL INS CO,124.579293716,19907,118.039697875,17079,116.484981197,21007,118.089149965,11576,-2828,3928
164,AMERICAN PUBLIC EDUCATION IN,24.5457588946,65714,22.9088036514,45572,23.6526367753,46591,21.0558276458,75751,-20142,1019
165,AMERICAN RAILCAR INDS INC,45.3048509123,22470,41.0776966132,21082,38.2999889466,18094,38.5360315234,14973,-1388,-2988
166,AMERICAN RENAL ASSOCIATES HO,21.2799407081,712408,16.8794160238,709207,18.5496845156,701144,14.9707355749,673514,-3201,-8063
167,AMERICAN STS WTR CO,45.5618033939,79672,44.3072746663,61886,47.4216013848,49682,49.2428317822,148712,-17786,-12204
168,AMERICAN TOWER CORP NEW,105.670718005,7209140,121.471229524,8049050,132.21130233,8093181,136.540107314,8289286,839910,44131
169,AMERICAN VANGUARD CORP,19.1341951083,43012,16.6153567548,44176,17.2662964935,13147,22.8900951793,67977,1164,-31029
170,AMERICAN WOODMARK CORP,75.2648344322,26998,91.796875,17408,95.5606223176,44736,96.2513117968,245846,-9590,27328
171,AMERICAN WTR WKS CO INC NEW,72.3602226919,1844881,77.76981761,1740611,77.949875467,822272,80.9101060292,885699,-104270,-918339
172,AMERICAS CAR MART INC,43.7536954135,35517,36.4744015308,25607,38.9131314949,22229,41.1095972068,46972,-9910,-3378
173,AMERIGAS PARTNERS L P,47.9205642115,1416490,47.0895931879,1498038,45.1698431655,1712315,44.9400128583,1752959,81548,214277
174,AMERIPRISE FINL INC,110.940565692,2378643,129.680127096,1771266,127.289462832,1755652,148.509326657,1652307,-607377,-15614
175,AMERIS BANCORP,43.600658028,1031567,46.0997548362,1092739,48.2001350481,1030744,47.9996410352,1092029,61172,-61995
176,AMERISAFE INC,62.3503655728,527118,64.9005872093,494202,56.9500158274,559157,58.1990690711,593171,-32916,64955
177,AMERISOURCEBERGEN CORP,78.1898469604,1664014,88.5002048832,1393477,94.5298455333,1342814,82.7497328782,1343956,-270537,-50663
178,AMETEK INC NEW,48.5999983296,4429959,54.0802097657,4124984,60.5698718451,2435881,66.0400965534,1830282,-304975,-1689103
179,AMGEN INC,146.209999509,4032638,164.07014447,5016903,172.229869382,5895435,186.450124091,6890100,984265,878532
180,AMICUS THERAPEUTICS INC,4.96984777717,735435,7.129934401,777146,10.0704410211,921906,15.0800186781,1177850,41711,144760
181,AMIRA NATURE FOODS LTD,6.15223368438,139299,5.35914945112,161966,5.55097142,39993,6.04838709677,15872,22667,-121973
182,AMKOR TECHNOLOGY INC,10.5497132368,327971,11.5905845304,1023762,9.77052302032,1239340,10.5504322009,951525,695791,215578
183,AMN HEALTHCARE SERVICES INC,38.4494305974,508252,40.6004823301,802355,39.0500362134,810473,45.7008005624,964447,294103,8118
184,AMPHASTAR PHARMACEUTICALS IN,18.4200629733,271226,14.4982560582,197541,17.8597066967,195020,17.8723195205,203555,-73685,-2521
185,AMPHENOL CORP NEW,67.1999622164,4361684,71.1698668478,4013679,73.8199921837,4173341,84.640158888,3958511,-348005,159662
186,AMTRUST FINL SVCS INC,27.3804258004,1458195,18.459945046,6540377,15.1400260777,5205209,13.4600630807,5161640,5082182,-1335168
187,ANADARKO PETE CORP,69.7299442895,5232587,61.9999990635,4271242,45.3399988224,3566630,48.8498632356,3913665,-961345,-704612
188,ANALOG DEVICES INC,72.620085942,2756276,81.9501126819,2473334,77.8001810652,4459167,86.1697756943,3300496,-282942,1985833
189,ANALOGIC CORP,82.9276209023,30810,75.901017652,36653,72.6584442545,16378,83.7380136564,40567,5843,-20275
190,ANDERSONS INC,44.7090567809,85240,37.905950493,58012,34.1214168182,11547,34.2377622378,53625,-27228,-46465
191,ANGIODYNAMICS INC,16.8699760259,283640,17.3502088806,339189,16.2071952557,330162,17.091231178,282250,55549,-9027
192,ANGLOGOLD ASHANTI LTD,10.5105487444,1335230,10.7700100354,1368151,9.71976849525,1329044,9.29020830375,2204041,32921,-39107
193,ANHEUSER BUSCH INBEV SA/NV,105.441039429,448554,109.760450219,916177,110.359587897,898028,119.300224686,969797,467623,-18149
194,ANI PHARMACEUTICALS INC,60.6111982368,23593,49.5164974003,20579,46.7893861971,16243,52.4777987392,43466,-3014,-4336
195,ANIKA THERAPEUTICS INC,48.9589195273,44425,43.4305953786,35574,49.3391505197,31172,57.99971085,159087,-8851,-4402
196,ANIXTER INTL INC,81.0496602081,729417,79.2990829779,726591,78.2001325634,734743,85.0003586265,850467,-2826,8152
197,ANNALY CAP MGMT INC,9.96962847546,2250134,11.110006214,4605758,12.0500552088,8416227,12.1899602308,9679605,2355624,3810469
198,ANSYS INC,92.4899732903,827041,106.870744281,829619,121.679585602,994793,122.730817604,887324,2578,165174
199,ANTARES PHARMA INC,2.33185218943,131655,2.84047556289,576664,3.21882194278,379642,3.24058988302,334507,445009,-197022
200,ANTERO MIDSTREAM PARTNERS LP,30.8799663088,10072647,33.1599315488,9969140,33.1799751389,9731683,31.5300029938,9259276,-103507,-237457
201,ANTERO RES CORP,23.6500507795,4775550,22.8100831247,4090121,21.6098094909,3861811,19.8999581869,4068099,-685429,-228310
202,ANTHEM INC,143.769894939,2184915,165.380245357,2213505,188.129978371,2221108,189.880020235,2478918,28590,7603
203,ANWORTH MORTGAGE ASSET CP,5.1696997837,883030,5.5507425026,949963,6.0102442877,915437,6.00906179372,466795,66933,-34526
204,AON PLC,111.529580391,798147,118.688442706,944953,132.949893112,1466026,146.100043174,1732532,146806,521073
205,APACHE CORP,63.4701362078,1344270,51.3899573694,1882216,47.9308136342,1445834,45.7996908892,1501080,537946,-436382
206,APARTMENT INVT & MGMT CO,45.327146451,1595203,44.3501766996,1588855,42.9695845075,1371505,43.8602277189,1273500,-6348,-217350
207,APOGEE ENTERPRISES INC,53.5540501861,104810,59.6157393986,75886,56.8151268035,22318,48.2588373364,98842,-28924,-53568
208,APOLLO COML REAL EST FIN INC,16.622884916,188054,18.8100149568,179851,18.5477266523,329690,18.1098468447,422643,-8203,149839
209,APOLLO GLOBAL MGMT LLC,19.3600161515,5913993,24.3200556151,5115161,26.4500153058,4971982,30.099961816,4433793,-798832,-143179
210,APOLLO INVT CORP,5.86013173189,165184,6.56089451937,282431,6.39190200668,505014,6.10930982265,538195,117247,222583
211,APPLE HOSPITALITY REIT INC,19.9792724356,819199,19.099854777,842153,18.7099157076,638966,18.9103326874,794169,22954,-203187
212,APPLE INC,115.819987927,50956360,143.660009531,51788887,144.019994437,50287587,154.120000164,31150824,832527,-1501300
213,APPLIED DNA SCIENCES INC,1.82775259541,13678,1.64680390033,23075,1.77347457221,20863,2.85424914833,10861,9397,-2212
214,APPLIED INDL TECHNOLOGIES IN,59.3976736151,138928,61.8542611928,109758,59.0557635037,73202,65.8014303452,144161,-29170,-36556
215,APPLIED MATLS INC,32.2699479676,9297288,38.8999543378,10750681,41.3099335742,10974358,52.0898556365,11053419,1453393,223677
216,APPLIED OPTOELECTRONICS INC,23.4243343445,11868,56.1886051081,12725,61.7900715187,171144,64.6706419584,143218,857,158419
217,APPROACH RESOURCES INC,3.34961618981,128970,2.51012971127,706338,3.37100262369,681103,2.51028303213,547747,577368,-25235
218,APTARGROUP INC,73.4483233005,268951,76.9887103583,222682,86.85801523,328824,86.3077095832,249352,-46269,106142
219,APTEVO THERAPEUTICS INC,2.44209594799,117522,2.06344449677,116795,2.07455429498,92550,2.31303006939,11673,-727,-24245
220,AQUA AMERICA INC,30.0404397293,853616,32.1500804778,755488,33.2993445852,692386,33.1890235424,747928,-98128,-63102
221,AQUAVENTURE HLDGS LTD,24.5338785306,44999,17.0645398861,55671,15.2355595,40563,13.4805679048,20919,10672,-15108
222,AQUINOX PHARMACEUTICALS INC,16.5097918187,968819,16.6898800618,967832,14.0700553331,962896,14.1899419299,963147,-987,-4936
223,ARALEZ PHARMACEUTICALS INC,4.40812283309,121140,2.14002337564,121494,1.34801399465,97180,2.28746843591,100985,354,-24314
224,ARAMARK,35.7204600422,1683237,36.8698946805,1854928,40.9799456031,1898636,40.610375346,1623329,171691,43708
225,ARATANA THERAPEUTICS INC,7.1867219917,60250,5.30459374761,65415,7.23431130505,34834,6.13557841229,50362,5165,-30581
226,ARBOR RLTY TR INC,7.46086626581,258281,8.37870538415,132240,8.36397721537,13869,8.18301803784,11365,-126041,-118371
227,ARC DOCUMENT SOLUTIONS INC,5.07801143522,103190,3.44827586207,127310,4.15352811729,104971,4.08815630674,91973,24120,-22339
228,ARC LOGISTICS PARTNERS LP,15.9301541924,686999,14.2506391272,908661,15.1907062456,686999,16.6996988618,1247268,221662,-221662
229,ARCBEST CORP,27.6485228871,147856,25.9951581537,125985,20.5991376703,115733,33.450780416,554576,-21871,-10252
230,ARCELORMITTAL SA LUXEMBOURG,7.30005739374,3003812,8.34995525742,2342288,22.7304078503,1602083,25.7603364537,1673930,-661524,-740205
231,ARCH CAP GROUP LTD,86.2906700796,1243912,94.76992532,1213845,93.2901059601,1609474,98.4998692558,1969495,-30067,395629
232,ARCH COAL INC,78.0584084399,57252,68.9390946776,210113,68.3003546611,249252,71.7408004338,331945,152861,39139
233,ARCHER DANIELS MIDLAND CO,45.6500591236,3891846,46.0400771807,3670867,41.3799876071,4765637,42.5100683531,8233720,-220979,1094770
234,ARCHROCK INC,13.2005321706,607324,12.4001174791,493705,11.3987964612,551374,12.5507368111,759557,-113619,57669
235,ARCHROCK PARTNERS L P,16.0398001368,3385516,17.1600393279,3560831,14.9099345602,4027516,14.2600005822,4431767,175315,466685
236,ARCONIC INC,18.5398682826,1942948,26.340043112,1956299,22.6497105286,1996052,24.8801044894,3569358,13351,39753
237,ARCOS DORADOS HOLDINGS INC,5.39709538139,61144,8.06414021349,21453,7.44827586207,137750,10.0489992526,72246,-39691,116297
238,ARDELYX INC,14.1933619849,55378,12.6540832049,51920,5.10312566447,61139,5.60350380008,62104,-3458,9219
239,ARDMORE SHIPPING CORP,7.40544479036,75485,8.04736192304,67227,8.1448472139,53408,8.24950545057,71277,-8258,-13819
240,ARENA PHARMACEUTICALS INC,1.41921537142,546781,1.4592046521,553041,16.8736580642,118765,25.4978482711,179623,6260,-434276
241,ARES CAP CORP,16.4901005031,1342745,17.3803831293,1553418,16.3799338376,2421011,16.3900730534,1347645,210673,867593
242,ARES COML REAL ESTATE CORP,13.7282941777,48950,13.3834849545,34296,13.0993194494,19543,13.2971996387,55350,-14654,-14753
243,ARGAN INC,70.5548058673,91149,66.1519493906,98954,59.9981533566,281592,67.2506409925,270674,7805,182638
244,ARGO GROUP INTL HLDGS LTD,65.9002207065,240591,67.7985667729,225226,60.5979853968,187630,61.4997375257,222879,-15365,-37596
245,ARISTA NETWORKS INC,96.770618507,415064,132.269324117,583015,149.78978031,696890,189.609868051,811751,167951,113875
246,ARLINGTON ASSET INVT CORP,14.8162912763,150510,14.1504299554,18374,13.6857242029,20167,12.7276124826,48163,-132136,1793
247,ARMADA HOFFLER PPTYS INC,14.5746370395,71151,13.8859937465,62365,12.9497478479,173903,13.8103263197,179793,-8786,111538
248,ARMOUR RESIDENTIAL REIT INC,21.6931654866,132899,22.7138522938,98222,24.9989376759,305933,26.9004738414,411108,-34677,207711
249,ARMSTRONG FLOORING INC,19.9167949684,30527,18.4283891698,21163,17.973629424,86460,15.7611150545,61988,-9364,65297
250,ARMSTRONG WORLD INDS INC NEW,41.799562614,363066,46.0500825873,588468,46.0008415896,715313,51.2487766134,460811,225402,126845
251,ARQULE INC,1.27023299702,27554,1.07146184664,21466,1.26555578992,18964,1.10712779418,18968,-6088,-2502
252,ARRAY BIOPHARMA INC,8.78940583617,435183,8.94001325674,1086240,8.36964973821,1446775,12.2996817811,1449631,651057,360535
253,ARRIS INTL INC,30.1304318612,1279902,26.4501779247,794437,28.0207478689,1222487,28.4900572884,1187151,-485465,428050
254,ARROW ELECTRS INC,71.3003285503,1264342,73.4101638208,1229026,78.4200696686,1373934,80.4104429043,1498089,-35316,144908
255,ARROWHEAD PHARMACEUTICALS IN,1.54912650286,218833,1.85697132166,71622,1.61916893224,315594,4.3358568479,43590,-147211,243972
256,ARTISAN PARTNERS ASSET MGMT,29.7494634786,750669,27.5992005272,1012167,30.700590773,1111933,32.5991586169,732841,261498,99766
257,ASANKO GOLD INC,3.05982768339,149028,2.61253158594,23349,1.5301756195,2480761,0.953255189945,2152624,-125679,2457412
258,ASBURY AUTOMOTIVE GROUP INC,61.7004996636,389462,60.1003131624,513791,56.5499968006,546985,61.0999060465,631163,124329,33194
259,ASCENA RETAIL GROUP INC,6.19001105399,901937,4.25977061788,2029452,2.15008119816,2784546,2.44979181312,2311625,1127515,755094
260,ASHFORD HOSPITALITY PRIME IN,13.6439304094,91909,10.6148509078,101179,10.2884271453,153765,9.50708940235,67213,9270,52586
261,ASHFORD HOSPITALITY TR INC,7.76288299929,191939,6.37175264186,402558,6.08314684653,95181,6.67135875653,100879,210619,-307377
262,ASHLAND GLOBAL HLDGS INC,109.289862547,2497432,123.809330331,2018192,65.9102230586,1535695,65.3893160443,955676,-479240,-482497
263,ASML HOLDING N V,112.20080363,230952,132.800088355,235414,130.309919273,431080,171.199458867,499692,4462,195666
264,ASPEN INSURANCE HOLDINGS LTD,54.99975254,565748,52.0491315999,546695,49.8502170499,701682,40.4002498897,938014,-19053,154987
265,ASPEN TECHNOLOGY INC,54.679934895,485370,58.9192193052,593830,55.2594860246,694469,62.8094702834,735733,108460,100639
266,ASSOCIATED BANC CORP,18.0535514905,1237762,17.3892716746,1052373,17.7845503085,1001431,17.6891857307,1129221,-185389,-50942
267,ASSURANT INC,92.8578528827,603600,95.6705107929,624069,103.689428768,605568,95.5209932581,569278,20469,-18501
268,ASSURED GUARANTY LTD,37.7703298535,1974301,37.1101421311,2304141,41.7402283123,3233116,37.7499006968,3340777,329840,928975
269,ASTEC INDS INC,67.4562064419,127416,61.4954394585,114789,55.5116182729,26553,56.0205391528,38950,-12627,-88236
270,ASTERIAS BIOTHERAPEUTICS INC,0.535801266439,20530,1.44643373726,31111,0.487092060399,20530,3.38382210764,12412,10581,-10581
271,ASTORIA FINL CORP,18.6487462206,265916,20.5096578689,582116,20.1494002895,687415,21.4990668525,490812,316200,105299
272,ASTRAZENECA PLC,27.3204616847,2039314,31.1398596946,2936879,34.0900332515,4190785,33.8798631045,2997031,897565,1253906
273,ASTRONICS CORP,33.848998124,36781,31.7526057845,14487,30.4829391299,31329,29.7658041271,24424,-22294,16842
274,AT&T INC,42.5299701436,22729454,41.549983547,25417844,37.7300175199,27294660,39.1700207966,33444838,2688390,1876816
275,ATARA BIOTHERAPEUTICS INC,14.1990724224,28030,20.5502599223,201214,13.9936891206,14578,16.5363800361,19956,173184,-186636
276,ATHENAHEALTH INC,105.168236205,200165,112.69011713,434732,140.549011217,635579,124.3588364,613338,234567,200847
277,ATHENE HLDG LTD,47.9979466119,27272,49.9908038847,277291,49.6100779844,333400,53.8407295496,293551,250019,56109
278,ATHERSYS INC,1.53054868391,56189,1.70793481521,240056,1.51243558145,17852,2.05128205128,21450,183867,-222204
279,ATKORE INTL GROUP INC,23.9134013829,72888,26.2611891636,33738,22.5476767464,28473,19.4894916733,13751,-39150,-5265
280,ATLANTIC PWR CORP,2.50372822919,219273,2.65370654683,196706,2.3979151246,259392,2.45330391667,174051,-22567,62686
281,ATLANTICA YIELD PLC,19.3567711258,53418,20.95740126,359682,21.3599874837,619991,19.6980344556,140877,306264,260309
282,ATLANTICUS HLDGS CORP,2.83822138127,51793,2.60372445803,35334,2.65819303981,32729,2.33549959383,29544,-16459,-2605
283,ATLAS AIR WORLDWIDE HLDGS IN,52.148441529,48477,55.4486951153,84222,52.1477254715,63090,65.7963910465,135053,35745,-21132
284,ATLASSIAN CORP PLC,24.0914271242,31588,29.9474712638,213407,35.179886739,556767,35.1496676616,801743,181819,343360
285,ATMOS ENERGY CORP,74.1500566555,1793296,78.9898520412,1613625,82.9504524433,1390119,83.8400007346,1306906,-179671,-223506
286,ATN INTL INC,80.1237737837,15189,70.421363504,24041,68.4119801767,9282,52.707123306,29958,8852,-14759
287,ATRICURE INC,19.5904356061,16896,19.1184961827,15587,24.289531212,12351,22.3762100425,143590,-1309,-3236
288,ATRION CORP,507.186858316,5357,468.058191018,4743,643.554185927,1947,672.140324687,5359,-614,-2796
289,ATWOOD OCEANICS INC,13.1306940361,288789,9.52823990761,245061,8.15006899494,750055,9.3898576551,1108856,-43728,504994
290,AU OPTRONICS CORP,3.53794090502,149522,3.81804553546,213460,4.54466002447,28605,4.04465936848,101121,63938,-184855
291,AUDENTES THERAPEUTICS INC,18.2858364968,18703,17.0191941711,18391,19.1031570481,14919,27.9906697767,15005,-312,-3472
292,AURINIA PHARMACEUTICALS INC,2.10010857491,1274696,7.33892022098,346645,6.13033551978,876461,6.2703520701,874911,-928051,529816
293,AUTODESK INC,74.0105161615,1683504,86.4695567022,1878985,100.819816822,1727825,112.260082674,2171894,195481,-151160
294,AUTOHOME INC,25.2840065841,74118,31.7754433249,65302,45.357988651,237731,60.0793356958,472675,-8816,172429
295,AUTOLIV INC,113.149007768,83801,102.254447866,123711,109.800002647,151102,123.598997688,154443,39910,27391
296,AUTOMATIC DATA PROCESSING IN,102.780524035,1829763,102.389911769,1896388,102.459777731,2088644,109.319807576,2637930,66625,192256
297,AUTONATION INC,48.6497025269,846295,42.2897970382,1053351,42.1597666998,1529017,47.4604422269,1463050,207056,475666
298,AUTOZONE INC,789.791428422,172267,723.045191762,130422,570.455282032,141934,595.110947049,121905,-41845,11512
299,AVALONBAY CMNTYS INC,177.149963548,2135699,183.599697381,2120156,192.169954131,1930921,178.420253448,2431428,-15543,-189235
300,AVANGRID INC,37.8795512562,476352,42.7411018139,523337,44.151676034,391967,47.4215170349,352688,46985,-131370
301,AVERY DENNISON CORP,70.2198426732,3480398,80.6000990559,3143681,88.3696972942,3044177,98.3400147566,2733699,-336717,-99504
302,AVEXIS INC,47.7268051841,34027,76.0305490852,227961,82.1614671449,147770,96.7310999816,184894,193934,-80191
303,AVIANCA HLDGS SA,9.64005527196,1905487,7.7100850053,1924233,6.49976892605,1919299,7.75997129452,1917404,18746,-4934
304,AVIS BUDGET GROUP,36.6799502935,1586916,29.5799224423,1322113,27.2700313334,2252546,38.060318821,1831435,-264803,930433
305,AVISTA CORP,39.9899834996,223631,39.0518294875,166932,42.4571434072,207786,51.770975131,671438,-56699,40854
306,AVNET INC,47.6101052809,2603985,45.7599448247,2105291,38.880293031,1900140,39.3000480781,2685213,-498694,-205151
307,AVON PRODS INC,5.04021586793,3315731,4.40006083808,3925173,3.80015389109,5878183,2.32995592599,1603893,609442,1953010
308,AVX CORP NEW,15.6260044633,217778,16.37794119,217854,16.3397418399,256430,18.2312229154,269757,76,38576
309,AXALTA COATING SYS LTD,27.2004236286,1061307,32.2000331226,1449160,32.0401152039,2347838,28.9200834709,2653381,387853,898678
310,AXCELIS TECHNOLOGIES INC,14.5599438653,39904,18.7834954992,19219,20.9463484996,31891,27.3491461658,68046,-20685,12672
311,AXIS CAPITAL HOLDINGS LTD,65.2699500084,879348,67.0291173688,851794,64.6601525369,624898,57.3100760944,712667,-27554,-226896
312,AXOVANT SCIENCES LTD,12.4174474817,180794,14.9435439593,125673,23.1945348081,92220,6.87914168507,47535,-55121,-33453
313,AZZ INC,63.8950052538,149417,59.4906874125,56429,55.7949159845,27852,48.6987421511,49529,-92988,-28577
314,B & G FOODS INC NEW,43.8005390836,179564,40.2498541191,226212,35.6014874197,207070,31.8486712155,294141,46648,-19142
315,B2GOLD CORP,2.37051191923,772407,2.82991169864,3205047,2.80898876404,639020,2.80024891101,398536,2432640,-2566027
316,BABCOCK & WILCOX ENTERPRIS I,16.5888877856,140998,9.34066748706,67447,11.7701072666,23959,3.33151333993,108059,-73551,-43488
317,BADGER METER INC,36.9492937841,710406,36.7493912992,954492,39.8505823884,622952,48.9998865266,678573,244086,-331540
318,BAIDU INC,164.410431894,1536557,172.519540015,1432829,178.860105894,1188549,247.691136086,1083325,-103728,-244280
319,BALCHEM CORP,83.905779807,48185,82.3911474621,24942,77.6898851886,40327,81.2915965772,54692,-23243,15385
320,BALDWIN & LYONS INC,25.2246571023,12686,24.4568809765,22693,24.4953066735,15554,22.5751120456,18073,10007,-7139
321,BALL CORP,75.0698444509,3042833,74.2602653002,3092798,42.2100232759,6644654,41.3001349661,7282567,49965,3551856
322,BANC OF CALIFORNIA INC,17.3495063374,234877,20.6989602476,249771,21.5011938459,334214,20.7505982198,514443,14894,84443
323,BANCO BILBAO VIZCAYA ARGENTA,6.77000955893,1853764,7.61015335791,2034913,8.35981973536,2333902,8.92020489452,2498261,181149,298989
324,BANCO BRADESCO S A,8.7101124132,15414382,10.2396685501,14559065,8.49940393658,5863470,11.0670959919,4499464,-855317,-8695595
325,BANCO DE CHILE,70.446125676,140902,72.1582389536,156725,77.9332671923,153208,91.1740010866,20247,15823,-3517
326,BANCO MACRO SA,64.3501173371,218601,86.7007399391,290159,92.1897887308,217779,117.346410641,154568,71558,-72380
327,BANCO SANTANDER BRASIL S A,8.89011370364,1175688,8.81976407561,1742677,7.52995375826,5862453,8.74009968253,6502443,566989,4119776
328,BANCO SANTANDER CHILE NEW,21.8732642662,165636,25.0793021412,141232,25.4113649375,162447,29.7105967795,136315,-24404,21215
329,BANCO SANTANDER SA,5.17992530178,4853931,6.06983817073,5138193,6.69004668992,6559446,6.9399620636,6469776,284262,1421253
330,BANCOLOMBIA S A,36.6835411779,161980,39.8715526424,128613,44.5458708365,133211,45.7913974397,288635,-33367,4598
331,BANCORP INC DEL,7.85113433597,19615,5.11307767945,30510,7.57863638067,186841,8.26934435913,250564,10895,156331
332,BANCORPSOUTH INC,31.0500914065,1814423,30.2499515457,1656201,30.4999100892,1662759,32.0497673159,1853586,-158222,6558
333,BANK AMER CORP,22.1220530788,61343131,23.6074167925,66215038,24.2787298416,63677631,25.3550762383,73242651,4871907,-2537407
334,BANK HAWAII CORP,88.6897075579,329125,82.3612857665,322858,82.9685694526,232799,83.3615885311,209401,-6267,-90059
335,BANK MONTREAL QUE,71.9196015491,926187,74.7904478444,1104379,73.4401120747,1000761,75.7101227993,1074110,178192,-103618
336,BANK MUTUAL CORP NEW,9.44906749656,133029,9.39953555236,72344,9.15453813256,88153,10.1513825324,309613,-60685,15809
337,BANK N S HALIFAX,55.6802725672,2151983,58.5702189564,1776244,60.130167178,1573054,64.2500270207,1720902,-375739,-203190
338,BANK NEW YORK MELLON CORP,47.3798219585,5729000,47.229973494,6578132,51.0197840392,5068328,53.01979281,5403831,849132,-1509804
339,BANK OF NT BUTTERFIELD&SON L,31.4434546278,26492,31.9063004847,49520,34.0976491863,138250,36.6376989925,130030,23028,88730
340,BANKRATE INC DEL,11.0516572414,394330,9.65384736527,63498,12.8551584796,39595,13.9510265267,258834,-330832,-23903
341,BANKUNITED INC,37.6882037291,453033,37.3107647047,391576,33.7099202274,284308,35.5681377797,304486,-61457,-107268
342,BANNER CORP,55.8099285808,1551964,55.6396819637,1559822,56.5100244849,1561776,61.2802348096,1561776,7858,1954
343,BAOZUN INC,12.0698604565,2648995,14.9400055493,2648995,22.1719171491,126782,32.7565452904,132920,0,-2522213
344,BARCLAYS BANK PLC,27.2885672162,74610,27.7592009911,91213,26.622296173,10217,26.560914876,10843,16603,-80996
345,BARCLAYS BK PLC,25.5851065128,2868153,16.2276956041,1583096,13.6752340574,1761213,23.7085452353,163401,-1285057,178117
346,BARCLAYS PLC,11.0000612852,1599082,11.2402484862,1617313,10.5897342978,1465287,10.3496148135,1637259,18231,-152026
347,BARD C R INC,224.659426325,935407,248.541019946,899087,316.110050547,972753,320.499890795,1149211,-36320,73666
348,BARNES & NOBLE ED INC,11.4707112083,165029,9.59468645556,141224,10.6248889033,123766,6.51289596676,231080,-23805,-17458
349,BARNES & NOBLE INC,11.1490236382,364875,9.24974965979,311576,7.60163339144,380313,7.59981486904,529355,-53299,68737
350,BARNES GROUP INC,47.4191832198,949215,51.3394462321,876071,58.5292575652,637066,70.4344401648,104111,-73144,-239005
351,BARRACUDA NETWORKS INC,21.4283489582,256856,23.1090722827,441212,23.0590971479,357733,24.2289896973,413678,184356,-83479
352,BARRETT BILL CORP,6.98960911569,438365,4.54986444704,551445,3.06939479136,589367,4.29096585263,609886,113080,37922
353,BARRETT BUSINESS SERVICES IN,64.085447263,17227,54.6161825726,19280,57.2918831304,48122,56.5422151611,35248,2053,28842
354,BARRICK GOLD CORP,15.9798747219,7248993,18.9898604897,5950386,15.9099099848,6254278,16.0899103212,5528620,-1298607,303892
355,BASIC ENERGY SVCS INC NEW,35.3501954689,1592325,33.3599938515,1184023,24.899402644,923235,19.3009118541,190820,-408302,-260788
356,BASSETT FURNITURE INDS INC,30.3762142435,18633,26.8988571873,25726,37.9352248111,18927,37.7189255535,21183,7093,-6799
357,BAXTER INTL INC,44.3400174408,5247472,51.8602376969,5739831,60.5400068654,6350660,62.7497211466,6065015,492359,610829
358,BAYTEX ENERGY CORP,4.88291566406,255585,3.42173217214,203698,2.42793757175,128916,3.00776061799,167899,-51887,-74782
359,BAZAARVOICE INC,4.85448222746,85694,4.29683277484,74008,4.95499105163,74874,4.94548540837,61268,-11686,866
360,BB&T CORP,47.0200393947,5595678,44.7001107222,5018869,45.4101322406,5369000,46.9398904635,5311836,-576809,350131
361,BBVA BANCO FRANCES S A,17.4308211474,555625,18.4197770238,612711,18.9293402161,191396,20.3926738171,100134,57086,-421315
362,BCE INC,43.2400282372,2563990,44.2703022728,1824180,45.038809512,889988,46.8299630575,1152873,-739810,-934192
363,BEACON ROOFING SUPPLY INC,46.0701395613,1476770,49.1599109061,1510316,49.0001268338,1490139,51.2498875848,2357332,33546,-20177
364,BEAZER HOMES USA INC,13.2969318037,141386,12.1319472267,284538,13.7214346066,557449,18.7375973134,183428,143152,272911
365,BECTON DICKINSON & CO,165.548395174,670976,183.44017842,799912,143.68956866,1282654,185.215385016,1036307,128936,482742
366,BED BATH & BEYOND INC,40.6398296199,1592674,39.4605859966,1567108,30.3998324056,1670700,23.4699748592,2878188,-25566,103592
367,BEIGENE LTD,30.3533190578,18680,36.5886759676,18421,44.9917898194,18270,103.461177657,184417,-259,-151
368,BEL FUSE INC,30.8943560897,68977,25.5595090216,47497,24.7209821429,17920,31.1842356993,36589,-21480,-29577
369,BELDEN INC,74.7704756471,269906,69.1918407615,218942,75.4274177474,155527,80.5285394278,141068,-50964,-63415
370,BELLICUM PHARMACEUTICALS INC,13.6106385195,28801,12.328895556,42664,11.6811594203,138000,11.5506585496,129603,13863,95336
371,BELMOND LTD,13.3512239735,149799,12.099703885,309677,13.2989989054,238439,13.6515765369,306558,159878,-71238
372,BEMIS INC,47.8201154727,1929460,48.8600801326,1614324,46.2500368153,1290226,45.5705981772,862069,-315136,-324098
373,BENCHMARK ELECTRS INC,30.4987378796,399328,31.7987208626,378380,32.3005419136,513366,34.1496183206,573125,-20948,134986
374,BENEFICIAL BANCORP INC,18.4015049199,207320,15.9986440231,212393,14.9983927148,227091,16.6038800826,233861,5073,14698
375,BENEFITFOCUS INC,29.7000021993,6274646,27.9499433115,6274646,36.3499391041,6274646,33.6500258341,6274646,0,0
376,BERKLEY W R CORP,66.5100396984,1329273,70.630457211,1198987,69.1696316928,931695,66.7409247994,875325,-130286,-267292
377,BERKSHIRE HATHAWAY INC DEL,166.946744097,5227721,170.020823002,6053882,173.076197965,6524190,186.971621919,7142731,826161,470308
378,BERKSHIRE HILLS BANCORP INC,36.8551002121,155121,36.04743083,63250,35.1437699681,85762,38.770821367,20892,-91871,22512
379,BEST BUY INC,42.669946492,4521379,49.1501479511,4917503,57.3300777028,5306499,56.9602280141,5173013,396124,388996
380,BGC PARTNERS INC,10.2309708758,436029,11.3607747596,659198,12.6397529456,1560790,14.4704652137,2253072,223169,901592
381,BHP BILLITON LTD,35.7803110846,1667649,36.3198276785,1812426,35.5901941184,3766515,40.5296953202,4065809,144777,1954089
382,BHP BILLITON PLC,31.4607158426,431268,31.1503665595,382339,30.7615922043,366561,35.4490518434,393184,-48929,-15778
383,BIG 5 SPORTING GOODS CORP,17.347770404,120246,15.0965692972,135395,13.0500036116,373793,7.65037946696,442331,15149,238398
384,BIG LOTS INC,50.2096555705,928666,48.6803803829,885634,48.2999239727,797082,53.5695652637,939190,-43032,-88552
385,BIGLARI HLDGS INC,473.270076371,4321,432.144511348,2159,399.590163934,1952,333.333333333,2283,-2162,-207
386,BIO PATH HOLDINGS INC,1.33455081829,14237,0.803957946815,16170,0.380820495067,28885,0.354327221189,11289,1933,12715
387,BIO RAD LABS INC,182.284821584,80654,199.340118827,82136,226.306628405,106285,222.225491927,101946,1482,24149
388,BIO TECHNE CORP,102.831520385,240860,101.647450906,259249,117.499991633,298783,120.887659952,198184,18389,39534
389,BIOCRYST PHARMACEUTICALS,6.32957488131,741440,8.3992540203,787689,5.55929828052,924757,5.23914145682,360937,46249,137068
390,BIOGEN INC,283.580560296,1298065,273.41989669,1738842,271.360195859,1733493,313.121230102,2116768,440777,-5349
391,BIOLASE INC,1.39675349188,26490,1.35864437483,26497,0.978508397381,56208,0.611714329408,45773,7,29711
392,BIOMARIN PHARMACEUTICAL INC,82.8397053584,1380932,87.7801877153,1539459,90.8201290281,1964069,93.0699616387,2359150,158527,424610
393,BIOSCRIP INC,1.03207162577,38757,1.69631324214,64257,2.70715997137,32137,2.74592149895,61910,25500,-32120
394,BIOSPECIFICS TECHNOLOGIES CO,55.7041991825,53820,54.8032417365,58117,49.5066168264,112894,46.515369473,105664,4297,54777
395,BIOSTAGE INC,0.862271693972,12757,0.395069532238,12656,0.410004100041,12195,0.326530612245,12250,-101,-461
396,BIOTELEMETRY INC,22.3534414442,103474,28.9553418522,75910,33.4441744469,62552,32.9965478833,126589,-27564,-13358
397,BIOTIME INC,3.62096477231,16294,3.45383375547,95546,3.15992292871,38925,2.849002849,40716,79252,-56621
398,BITAUTO HLDGS LTD,18.858393669,5939,25.6019892923,39411,28.7672510257,21448,44.6895579826,36899,33472,-17963
399,BJS RESTAURANTS INC,39.2994340948,121045,40.3985322018,88023,37.2503898385,132106,30.4483642599,235612,-33022,44083
400,BLACK BOX CORP DEL,15.2493389903,97578,8.95434402569,98388,8.54732594339,161571,3.25640662608,70630,810,63183
401,BLACK HILLS CORP,61.3404477389,1314516,66.469969277,2322688,67.4700118802,2494071,68.8697964708,2523864,1008172,171383
402,BLACK KNIGHT FINL SVCS INC,37.7999194225,4112813,38.3001272103,3932859,40.9501577324,4081596,43.0500922106,4221315,-179954,148737
403,BLACK STONE MINERALS L P,18.7796056469,642825,16.5095713921,995362,15.7600235164,1541051,17.3401073017,1672481,352537,545689
404,BLACKBAUD INC,64.0020868355,172510,76.6705034784,218063,85.748696665,176854,87.7983956702,206940,45553,-41209
405,BLACKBERRY LTD,6.88935122736,1312170,7.75097356389,932399,9.98944920922,1316489,11.1798826328,2180166,-379771,384090
406,BLACKHAWK NETWORK HLDGS INC,37.6727957955,67927,40.6017477167,228069,43.5992970123,142250,43.7999443171,168813,160142,-85819
407,BLACKROCK CAPITAL INVESTMENT,6.96475412307,33167,7.54959195525,32717,7.48531108309,74546,7.50358317174,106749,-450,41829
408,BLACKROCK CORPOR HI YLD FD I,10.7989607015,12316,10.9014675052,14310,10.9542869181,14241,11.3235196163,15013,1994,-69
409,BLACKROCK CR ALLCTN INC TR,12.9956999522,10465,13.1377061757,10428,13.4508701269,13159,13.5716333747,10463,-37,2731
410,BLACKROCK ENHANCED EQT DIV T,8.16215480887,14702,8.54831323462,19653,8.79971840901,25569,9.06175937544,28692,4951,5916
411,BLACKROCK INC,380.539988796,501603,383.510385286,441490,422.410981282,729678,447.087932465,706474,-60113,288188
412,BLACKROCK RES & COMM STRAT T,8.24480735691,18921,8.64113859709,11804,8.03106521931,22662,8.87832937352,15994,-7117,10858
413,BLACKSTONE GROUP L P,27.0299262274,6311153,29.7000492319,6599383,33.3499534313,8521811,33.3700349535,7419291,288230,1922428
414,BLACKSTONE MTG TR INC,30.0698432257,2480126,30.9599702916,2741314,31.600151933,2498469,31.0202693061,2480894,261188,-242845
415,BLDRS INDEX FDS TR,32.2489391796,21210,36.7598294647,21110,38.5138813283,22044,42.1009325288,21876,-100,934
416,BLOCK H & R INC,22.9899768455,3500395,23.2499225093,3319753,30.9098141202,2803155,26.4803298319,1070606,-180642,-516598
417,BLOOMIN BRANDS INC,18.0301492434,838429,19.7302412551,175416,21.2292384511,439394,17.5979615232,360269,-663013,263978
418,BLUCORA INC,14.7509011997,250222,17.3015134054,393087,21.2005269936,538147,25.299748047,631864,142865,145060
419,BLUE BUFFALO PET PRODS INC,24.0400689719,5174278,22.9999322715,3528793,22.809887493,4560873,28.3499509054,4834541,-1645485,1032080
420,BLUEBIRD BIO INC,61.7025127447,265208,90.8983278271,354748,105.049885576,485912,137.349682524,279076,89540,131164
421,BLUEKNIGHT ENERGY PARTNERS L,6.84899594651,85852,6.74249832724,58287,6.25855662038,35791,5.69202467265,46205,-27565,-22496
422,BLUEPRINT MEDICINES CORP,28.046597863,93309,39.9908359638,353556,50.6708034461,210792,69.6713131949,225473,260247,-142764
423,BMC STK HLDGS INC,19.4995829619,696579,22.6017255336,253255,21.8531325281,244084,21.3499131592,216488,-443324,-9171
424,BOARDWALK PIPELINE PARTNERS,17.3599998631,4674424,18.3099052602,3665830,18.0099142011,3806459,14.699931736,3561173,-1008594,140629
425,BOB EVANS FARMS INC,53.2058754955,171560,64.88293338,68508,71.8372536554,56628,77.5179196367,100867,-103052,-11880
426,BOEING CO,155.679965456,3325566,176.859705584,3216329,197.74993933,3852785,254.210065309,4345182,-109237,636456
427,BOFI HLDG INC,28.5503682739,177721,26.1275651265,155889,23.7197865327,279387,28.4713337827,218079,-21832,123498
428,BOINGO WIRELESS INC,12.1981936598,27791,12.987012987,30107,14.963921085,189723,21.3686686901,219761,2316,159616
429,BOISE CASCADE CO DEL,22.5021561299,76526,26.6989173002,43410,30.3983228512,116388,34.8995307772,172839,-33116,72978
430,BOK FINL CORP,83.0383634724,373767,78.2705791282,359126,84.1319758036,307814,89.0809564967,329745,-14641,-51312
431,BON-TON STORES INC,1.46601190797,111186,0.84243187562,119891,0.4341429295,82922,0.424609471026,44747,8705,-36969
432,BONANZA CREEK ENERGY INC,1.02714600147,27260,1.16127041359,123141,31.724137931,9425,32.9852957116,27679,95881,-113716
433,BOOT BARN HLDGS INC,12.5203022768,1475204,9.89026998522,1462043,7.08008335997,979367,8.90053232703,656927,-13161,-482676
434,BOOZ ALLEN HAMILTON HLDG COR,36.069729399,960972,35.3892916108,1276177,32.5395169713,1519537,37.3890169506,731418,315205,243360
435,BORGWARNER INC,39.4393988756,1623757,41.7903651914,1199152,42.3601053535,2496736,51.2298960571,3022044,-424605,1297584
436,BOSTON BEER INC,169.852083857,87482,144.644417829,123572,132.146972943,141441,156.194130373,122495,36090,17869
437,BOSTON PRIVATE FINL HLDGS IN,16.5500142783,2885496,16.4000149983,2773656,15.3504532161,2684481,16.5497989548,2855080,-111840,-89175
438,BOSTON PROPERTIES INC,125.779966269,2213397,132.410280378,1848648,123.019778915,2554134,122.879804906,2491516,-364749,705486
439,BOSTON SCIENTIFIC CORP,21.6300988852,5309592,24.8700006535,5585605,27.7199701119,7338031,29.1701163193,8444087,276013,1752426
440,BOTTOMLINE TECH DEL INC,25.020409199,1142867,23.650399393,1155879,25.6898988094,1231340,31.8296304977,1382454,13012,75461
441,BOULDER GROWTH & INCOME FD I,8.94063831999,336665,9.29866948592,328219,9.71058719885,251993,10.2127962423,28102,-8446,-76226
442,BOX INC,13.8564991962,44167,16.3098438695,324344,18.2399513638,717162,19.3211746173,566891,280177,392818
443,BOYD GAMING CORP,20.1697677659,495147,22.0087895862,287158,24.8099049003,1678765,26.0500231693,2211975,-207989,1391607
444,BP PLC,37.3799906801,7648156,34.5200256357,6461293,34.650070802,5980767,38.4300507395,5547950,-1186863,-480526
445,BRADY CORP,37.5514963821,523095,38.6497215128,487455,33.9006020386,487012,37.9503073285,749849,-35640,-443
446,BRANDYWINE RLTY TR,16.5098503126,985654,16.2300338568,1808499,17.5300231377,1530403,17.4905067636,975958,822845,-278096
447,BRASKEM S A,21.2102699489,366662,20.3494138392,1003223,20.7128256426,91972,26.7397975003,93531,636561,-911251
448,BRF SA,14.7575121977,266034,12.2504814397,376475,11.7898628675,1069987,14.4100899451,1769524,110441,693512
449,BRIDGEPOINT ED INC,10.1263846607,140919,10.6672770974,87370,14.7620860297,131350,9.59923966419,94695,-53549,43980
450,BRIGGS & STRATTON CORP,22.2582075851,96953,22.4520260997,83066,24.1019314688,108622,23.4944908258,170806,-13887,25556
451,BRIGHT HORIZONS FAM SOL IN D,70.0290319838,82323,72.4894566347,98166,77.2098176169,240099,86.2095257969,996746,15843,141933
452,BRIGHTCOVE INC,8.05590253263,55239,8.90522472742,40538,6.22146405098,19931,7.22746436459,14943,-14701,-20607
453,BRINKER INTL INC,49.5304086224,949336,43.9599623055,745997,38.1003374556,827368,31.8592911261,806829,-203339,81371
454,BRINKS CO,41.2490043732,266164,53.4443019753,127123,67.0082315954,111643,84.2532994896,181619,-139041,-15480
455,BRISTOL MYERS SQUIBB CO,58.4400419943,6722822,54.3801188709,10760918,55.7198793705,10326494,63.7399493127,12184117,4038096,-434424
456,BRISTOW GROUP INC,20.4842634171,101102,15.2059077669,112259,7.64643984567,128295,9.34777091617,165494,11157,16036
457,BRITISH AMERN TOB PLC,112.669929787,2048346,66.3199943435,13350936,68.5399640159,15532398,62.4499407084,13469028,11302590,2181462
458,BRIXMOR PPTY GROUP INC,24.4200255083,12341060,21.4599712973,13138135,17.8799869878,10298050,18.7999518818,10607208,797075,-2840085
459,BROADCOM LTD,176.770141447,2147512,218.959649553,2302205,233.049890686,2984966,242.539856856,3063212,154693,682761
460,BROADRIDGE FINL SOLUTIONS IN,66.2997995598,1566053,67.9499778436,1326932,75.560677044,1323400,80.820661334,1288668,-239121,-3532
461,BROADSOFT INC,41.2515878853,59828,40.1980685243,130056,43.0470732313,124933,50.3011427394,87334,70228,-5123
462,BROCADE COMMUNICATIONS SYS I,12.489981859,17395942,12.4799897775,13523088,12.6099922617,16763452,11.9499982137,13267366,-3872854,3240364
463,BROOKDALE SR LIVING INC,12.4200452035,2978089,13.4299719423,3707007,14.7098725962,4020837,10.599973452,4105765,728918,313830
464,BROOKFIELD ASSET MGMT INC,33.0097782712,1787228,36.4599393126,1242103,39.2103874169,947300,41.2999506908,993730,-545125,-294803
465,BROOKFIELD PPTY PARTNERS L P,21.9908840245,266565,22.2592728109,265103,23.6682093099,247843,23.3481254007,237064,-1462,-17260
466,BROOKFIELD RENEWABLE ENRGY P,29.6988622715,91586,29.7302920467,91321,31.9422751171,90914,33.5218574977,109093,-265,-407
467,BROOKLINE BANCORP INC DEL,16.4000937701,2376023,15.6502970522,2284110,14.6000709011,2341290,15.5001959312,2449840,-91913,57180
468,BROOKS AUTOMATION INC,17.070008643,189748,22.4009568554,197313,21.6897455585,188845,30.3587392704,297542,7565,-8468
469,BROWN & BROWN INC,44.8602965322,1132828,41.7204955616,913388,43.0696623395,849670,48.1904428972,1029810,-219440,-63718
470,BROWN FORMAN CORP,44.9392206431,3495677,46.1983235204,1513648,48.6200661331,1110488,54.3273382171,2216582,-1982029,-403160
471,BRUKER CORP,21.1799851589,1878566,23.3296936769,1588062,28.8401845316,1367571,29.7505224009,1082502,-290504,-220491
472,BRUNSWICK CORP,54.5402352167,1142606,61.2003669339,1378995,62.7298277191,1084508,55.96992262,1317136,236389,-294487
473,BRYN MAWR BK CORP,42.1681530868,23098,39.4820363082,15754,42.4863857136,40766,43.7997941524,367262,-7344,25012
474,BT GROUP PLC,23.0303414722,536032,20.0909641353,355085,19.4089695942,320728,19.2405179084,524726,-180947,-34357
475,BUCKEYE PARTNERS L P,66.1599459564,5146951,68.5598949487,5033730,63.9300155509,5146972,56.9999386,4869707,-113221,113242
476,BUCKLE INC,22.802737447,143053,18.5969434727,184654,17.8009796339,232740,16.8480877032,257596,41601,48086
477,BUFFALO WILD WINGS INC,154.393559283,60987,152.753281515,112829,126.69952167,68990,105.694678774,105502,51842,-43839
478,BUILDERS FIRSTSOURCE INC,10.971367407,67266,14.8991062379,325590,15.3180800639,190298,17.9876039432,285252,258324,-135292
479,BUNGE LIMITED,72.2399604787,686213,79.2596531047,2098962,74.6002036325,1148147,69.4602792178,1394610,1412749,-950815
480,BURLINGTON STORES INC,84.7500398492,3055267,97.290088219,2977477,91.9896462652,2987521,95.4601155147,2595859,-77790,10044
481,BWX TECHNOLOGIES INC,39.7000585528,794155,47.6003476358,621340,48.7483401609,407419,56.0182174996,336819,-172815,-213921
482,C H ROBINSON WORLDWIDE INC,73.2596207301,1181797,77.289968797,1188990,68.6803003689,1157377,76.099796998,1809834,7193,-31613
483,CA INC,31.7699550915,5512315,31.7201599009,5614978,34.4698917989,5644027,33.380113724,4410680,102663,29049
484,CABLE ONE INC,621.742438653,10514,624.483563858,11134,710.876276419,8422,722.073695223,8603,620,-2712
485,CABOT CORP,50.5399610327,919233,59.9104981293,1022325,53.4299023463,906571,55.799661906,918088,103092,-115754
486,CABOT MICROELECTRONICS CORP,63.1692112086,600894,76.6108181585,645914,73.8308104444,185898,79.9289975166,234358,45020,-460016
487,CABOT OIL & GAS CORP,23.3603641084,1759476,23.9100018659,3354914,25.0800130452,3060126,26.7497109451,2987322,1595438,-294788
488,CACI INTL INC,124.298871269,115528,117.311650885,48580,125.04637022,62001,139.348973301,114834,-66948,13421
489,CADENCE DESIGN SYSTEM INC,25.2201019459,3221121,31.4001642414,4771026,33.4898643288,4033280,39.4698738784,5887731,1549905,-737746
490,CAE INC,13.96904954,549071,15.2887118392,696854,17.2398908519,915087,17.5305902918,535464,147783,218233
491,CAESARS ACQUISITION CO,13.5001447281,1323171,15.4000487232,1358697,19.0501740086,1360565,21.4499973333,1387506,35526,1868
492,CAESARS ENTMT CORP,8.49993696514,4862389,9.54993168812,4733437,11.9999437439,3910685,13.3498301935,2914494,-128952,-822752
493,CAESARSTONE SDOT-YAM LTD,28.6526109692,83762,36.253360713,94474,35.0480887793,101375,29.7992721031,188763,10712,6901
494,CAL MAINE FOODS INC,44.176426683,143357,36.8028205232,295548,39.5992957921,241974,41.101937658,296750,152191,-53574
495,CALAMP CORP,14.497863691,96428,16.7947931329,83121,20.3348563184,66536,23.2505076779,131481,-13307,-16585
496,CALATLANTIC GROUP INC,34.0100944347,1675973,37.4496662282,895522,35.3503227815,517223,36.6290312347,725026,-780451,-378299
497,CALAVO GROWERS INC,61.3973851815,116031,60.5919871199,32298,69.0597483216,29641,73.2011416554,66570,-83733,-2657
498,CALERES INC,32.8216647947,264429,26.4227808211,244978,27.7780493289,204586,30.5206384918,229353,-19451,-40392
499,CALGON CARBON CORP,16.9963579233,98021,14.591773673,58252,15.1048395111,30189,21.4008278702,470122,-39769,-28063
500,CALIFORNIA RES CORP,21.2901030145,152794,15.0416802708,483922,8.55274579017,172810,10.4595187082,402791,331128,-311112
501,CALIFORNIA WTR SVC GROUP,33.8999826308,1030561,35.8460598656,81850,36.8138321428,51937,38.1523704819,125523,-948711,-29913
502,CALITHERA BIOSCIENCES INC,3.22001362313,16149,11.5464132974,133981,14.8553557467,129179,15.748315775,138491,117832,-4802
503,CALIX INC,7.70288858322,21810,7.25745582629,51671,6.83484528396,32188,5.04619758351,28140,29861,-19483
504,CALLAWAY GOLF CO,10.959560171,1023125,11.0702248892,743255,12.7804597317,778454,14.4298408819,1238891,-279870,35199
505,CALLIDUS SOFTWARE INC,16.7953062717,66983,21.3393937605,33881,24.1992404127,119012,24.6433918419,108873,-33102,85131
506,CALLON PETE CO DEL,15.3700027561,4691411,13.1599706174,7333603,10.6099659886,7426037,11.2400985319,8891737,2642192,92434
507,CALPINE CORP,11.429914407,2740178,11.0501161749,2351197,13.5302858374,3006884,14.7500956938,4793935,-388981,655687
508,CALUMET SPECIALTY PRODS PTNR,3.99995931095,884759,3.80023046559,856527,4.2501506618,537628,8.34950695309,586861,-28232,-318899
509,CAMBREX CORP,53.9532555302,159805,55.0510410112,106483,59.7363119013,84873,54.9989187631,249714,-53322,-21610
510,CAMDEN NATL CORP,44.4429036955,14423,44.078101251,8553,42.8890032596,5829,43.6731742589,6915,-5870,-2724
511,CAMDEN PPTY TR,84.069848088,909803,80.4600014896,993562,85.510317767,1312251,91.4503598727,1309213,83759,318689
512,CAMECO CORP,10.469860105,1437364,11.0694277539,1161668,9.10016575236,1079321,9.67080035836,1314886,-275696,-82347
513,CAMPBELL SOUP CO,60.4698426524,2204355,57.2402666648,1959914,52.1501749442,1302987,46.8208855752,961793,-244441,-656927
514,CAMPING WORLD HLDGS INC,32.6044703596,20580,32.2373276827,42001,30.8516499174,105278,40.7454526699,29083,21421,63277
515,CANADIAN NAT RES LTD,31.8800199714,2167094,32.7895446322,1214381,28.84017295,1252385,33.4900489351,1374677,-952713,38004
516,CANADIAN NATL RY CO,67.3998533897,2469130,73.9297271467,1596719,81.0500517372,1499888,82.8504146823,987744,-872411,-96831
517,CANADIAN PAC RY LTD,142.770857552,483446,146.922299407,155327,160.80932739,360744,168.032606162,158743,-328119,205417
518,CANADIAN SOLAR INC,12.1033693163,6114,12.2691881908,163499,15.9214287084,312786,16.8407858239,419636,157385,149287
519,CANON INC,28.1406100827,279667,31.2714227715,300498,34.021595543,348220,34.3215126557,368253,20831,47722
520,CANTEL MEDICAL CORP,78.7453199676,115918,80.1042803984,89758,77.9044273204,77993,94.1684164316,241461,-26160,-11765
521,CAPELLA EDUCATION COMPANY,87.8006430255,104817,85.0257667807,108473,85.5978802247,100388,70.1396855388,74095,3656,-8085
522,CAPITAL BK FINL CORP,39.2857142857,10920,43.3924626241,46621,38.1019868633,183455,41.0487641951,389220,35701,136834
523,CAPITAL ONE FINL CORP,87.2400729446,6124651,86.6598123396,4842683,82.6199488244,5093443,84.6602600229,5319686,-1281968,250760
524,CAPITAL PRODUCT PARTNERS L P,3.18046903413,852390,3.57026630909,1683908,3.40033958307,1552492,3.49987664369,2440086,831518,-131416
525,CAPITAL SR LIVING CORP,16.0526473049,133872,14.0602120531,130439,15.1801499726,16403,12.5625112972,33194,-3433,-114036
526,CAPITOL FED FINL INC,16.4571092832,170200,14.6306818182,267520,14.2103415016,224977,14.7010948091,273381,97320,-42543
527,CAPSTEAD MTG CORP,10.188402251,204350,10.5396838798,284259,10.4331818011,266170,9.64905646107,528860,79909,-18089
528,CARA THERAPEUTICS INC,9.2968054594,30333,18.3517417162,11770,15.3947865508,84704,13.7078927957,32536,-18563,72934
529,CARBO CERAMICS INC,10.4564718961,57572,13.0381757787,124634,6.84918064959,101910,8.63416997296,163073,67062,-22724
530,CARBONITE INC,16.3986590147,87995,20.3031986666,62995,21.7639315489,11395,22.0096733873,18401,-25000,-51600
531,CARDINAL HEALTH INC,71.969953331,1344575,81.5501597444,1565000,77.9197310199,2357349,66.9202192921,2342446,220425,792349
532,CARDIOVASCULAR SYS INC DEL,24.2103798525,143740,28.2729964293,157394,32.2340499014,130297,28.1575056419,77102,13654,-27097
533,CARDTRONICS PLC,54.5713552708,296236,46.7492830517,211661,32.8591650616,86186,23.0107871512,517931,-84575,-125475
534,CARE COM INC,8.57645642308,53985,12.5168842864,44420,15.0963625774,151096,15.8907587958,144927,-9565,106676
535,CAREER EDUCATION CORP,10.0906365535,228826,8.69821912997,196477,9.60322772572,107568,10.3910705704,220574,-32349,-88909
536,CARETRUST REIT INC,15.3212208384,205793,16.8205900235,1381640,18.5337219326,97444,19.0402369098,201258,1175847,-1284196
537,CARLISLE COS INC,110.290551149,905073,106.410780017,761483,95.4009751267,464555,100.288595412,295916,-143590,-296928
538,CARLYLE GROUP L P,15.2497554567,1805406,15.9500458361,1533726,19.7499742668,1981876,23.5995949715,209368,-271680,448150
539,CARMAX INC,64.3901778678,2068390,59.2199950253,1748835,63.0595438629,2263004,75.8102181673,2754721,-319555,514169
540,CARNIVAL CORP,52.0599585395,3661797,58.9102374966,4077237,65.5700403333,3366446,64.5701649651,4975781,415440,-710791
541,CARNIVAL PLC,51.1907354802,431582,57.8903226718,778593,66.1200785955,1456063,64.4800763871,1824393,347011,677470
542,CARPENTER TECHNOLOGY CORP,36.1692759649,138543,37.3009606527,151980,37.4296388543,301125,48.0292809405,576211,13437,149145
543,CARRIZO OIL & GAS INC,37.3497526453,1370906,28.6599945976,1603001,17.4195718322,1269549,17.1300369275,2130118,232095,-333452
544,CARROLS RESTAURANT GROUP INC,15.2539802881,65950,14.1467436109,60650,12.2459007914,77332,10.895526939,98389,-5300,16682
545,CARTER INC,86.3891630828,746633,89.8013177178,546551,88.9485053306,287020,98.7496743944,345510,-200082,-259531
546,CARVER BANCORP INC,3.22593118382,181033,3.6623157104,181033,3.40269453636,181033,2.29239972823,181033,0,0
547,CASCADIAN THERAPEUTICS INC,4.329004329,20097,4.13787053193,205178,3.72652290569,20126,4.07224543191,47394,185081,-185052
548,CASELLA WASTE SYS INC,12.4111896579,112318,14.1158603185,96133,16.402369125,104680,18.8061572752,71785,-16185,8547
549,CASEYS GEN STORES INC,118.879771295,472225,112.250163884,358485,107.110730682,321275,109.450376992,293110,-113740,-37210
550,CASS INFORMATION SYS INC,73.5865254896,24461,66.0889284847,12347,65.6522964215,14196,63.4412797503,25630,-12114,1849
551,CASTLE BRANDS INC,0.76129774709,112965,1.55071688669,390787,1.72365273674,28428,1.33817625693,20924,277822,-362359
552,CATALENT INC,26.9602186523,2725423,28.3202935409,2884504,35.1005394918,2531642,39.9199695789,1427957,159081,-352862
553,CATALYST PHARMACEUTICALS INC,1.0470229647,42979,1.92988099067,18654,2.75832802886,18852,2.5237008427,45568,-24325,198
554,CATCHMARK TIMBER TR INC,11.2681624988,30351,11.5163365999,87962,11.3690194221,116105,12.6075500594,165853,57611,28143
555,CATERPILLAR INC DEL,92.7401169786,2871465,92.76009429,2974652,107.460225153,3320503,124.710017898,4346820,103187,345851
556,CATHAY GEN BANCORP,38.0289774138,386784,37.6792723791,261125,37.9517896559,308523,40.1993172718,345379,-125659,47398
557,CATO CORP NEW,30.0772997594,327556,21.9618661258,308125,17.5898095082,206938,13.2322833906,212964,-19431,-101187
558,CAVCO INDS INC DEL,99.8252087784,15447,116.390446783,15869,129.659908437,12232,147.544762929,13013,422,-3637
559,CAVIUM INC,62.440054955,1543080,71.6600507705,1051004,62.1294995316,1195680,65.9404473458,1448231,-492076,144676
560,CBIZ INC,13.7024019695,61741,13.5446607734,73756,14.9980479288,227963,16.2508930698,335920,12015,154207
561,CBL & ASSOC PPTYS INC,11.4999881289,2611394,9.53993435857,2275697,8.42992669124,2325643,8.38992227155,2484290,-335697,49946
562,CBOE HLDGS INC,73.8905047516,769111,81.0695998396,878048,91.3996369124,1371570,107.629729631,1254802,108937,493522
563,CBRE GROUP INC,31.489575156,1104429,34.7902679776,1979979,36.3999457907,4102616,37.8801194694,4431929,875550,2122637
564,CBS CORP NEW,63.6197225647,3061975,69.3614445492,1737954,63.7798158633,1805289,57.999699288,1908803,-1324021,67335
565,CDK GLOBAL INC,59.6896027927,1064507,65.0099947422,1641363,62.0603893481,1104102,63.0899683706,1297845,576856,-537261
566,CDN IMPERIAL BK COMM TORONTO,81.5998848615,889364,86.2098029947,1150832,81.1600276827,1813405,87.5204960415,937986,261468,662573
567,CDW CORP,52.08920305,560788,57.7110887356,660445,62.5304241273,834042,65.9998431093,879593,99657,173597
568,CECO ENVIRONMENTAL CORP,13.9531763601,44721,10.5148506556,71613,9.17694636212,167158,8.45654225495,108082,26892,95545
569,CEDAR FAIR L P,64.2006435314,393454,67.8105440595,434254,72.0999138461,486339,64.1197642332,695433,40800,52085
570,CEDAR REALTY TRUST INC,6.5325794609,203748,5.01919385797,312600,4.84949799417,501289,5.62015880103,206044,108852,188689
571,CELANESE CORP DEL,78.7401779307,2695206,89.850262974,1988219,94.9403304649,1719638,104.27002011,1615613,-706987,-268581
572,CELESTICA INC,11.849606697,484995,14.5301997328,979959,13.579777563,1136322,12.3801529848,1516621,494964,156363
573,CELGENE CORP,115.750245253,5442347,124.429902378,5848779,129.86994198,6151716,145.819924581,6092103,406432,302937
574,CELLDEX THERAPEUTICS INC NEW,3.53992488452,277972,3.6088080592,280425,2.46839806941,217550,2.85933486425,381907,2453,-62875
575,CEMEX SAB DE CV,8.02995240713,2044844,9.07018793802,1761485,9.41936486441,1351365,9.07975255253,1796745,-283359,-410120
576,CEMPRA INC,2.80038648609,61063,3.74708786106,122762,4.59440288883,62032,3.24999195547,62154,61699,-60730
577,CENOVUS ENERGY INC,15.129752543,1377815,11.300288887,1210854,7.37012920584,1564016,10.0195919553,1556251,-166961,353162
578,CENTENE CORP DEL,56.5096781391,1873449,71.2595816028,1662822,79.8798027889,2446313,96.7704154833,2834699,-210627,783491
579,CENTENNIAL RESOURCE DEV INC,13.65478541,48115,17.380276543,552753,15.8190551965,470066,17.9699395166,976631,504638,-82687
580,CENTERPOINT ENERGY INC,24.6400631201,6651444,27.5699120682,8158713,27.3801376635,7813109,29.2098578014,6754569,1507269,-345604
581,CENTRAIS ELETRICAS BRASILEIR,6.95533746505,4973878,5.59399456677,5498754,3.90795953273,5324006,6.2705802197,4868449,524876,-174748
582,CENTRAL EUROPEAN MEDIA ENTRP,2.57684520523,27165,3.09997416688,46452,4.01069518717,11220,4.04429151514,61321,19287,-35232
583,CENTRAL FD CDA LTD,11.2938497948,100143,12.8616079007,100143,12.3323647185,100143,12.6718792127,100143,0,0
584,CENTRAL GARDEN & PET CO,31.138702698,254667,34.8592808097,324476,30.1307757185,318943,37.2946214353,362197,69809,-5533
585,CENTRAL PAC FINL CORP,31.4209561256,264505,30.535918434,214305,31.4720121157,235066,32.1803127283,310749,-50200,20761
586,CENTURY ALUM CO,8.56133552777,394331,12.6900208444,910558,15.5803720959,1313640,16.5804219086,1129344,516227,403082
587,CENTURY CASINOS INC,8.24901720693,15517,7.54046395466,20821,7.38258844909,35218,8.21215268761,61616,5304,14397
588,CENTURYLINK INC,23.779794464,4177370,23.5700804163,5345930,23.8798946727,11364958,18.8999938739,12536512,1168560,6019028
589,CERNER CORP,47.3698080873,3923554,58.8500729434,4013385,66.4700714542,3267967,71.3200698893,5328430,89831,-745418
590,CERUS CORP,4.35151772447,113064,4.45093327656,98631,2.50715996056,106495,2.72860503683,103716,-14433,7864
591,CEVA INC,33.5558844834,63506,35.5009470157,102955,45.4535502376,45673,42.8002556413,101705,39449,-57282
592,CF INDS HLDGS INC,31.4797138946,3693045,29.3501497129,4763451,27.9600194248,5185118,35.1602400215,5782981,1070406,421667
593,CHANGYOU COM LTD,21.2125887072,38892,28.0316042597,29110,38.7564909385,29079,39.6245148479,22158,-9782,-31
594,CHANNELADVISOR CORP,14.3725361367,12176,11.1519681717,33178,11.5621722559,39093,11.5280289331,30968,21002,5915
595,CHARLES & COLVARD LTD,1.09416672365,14623,0.96239774524,14547,0.891632373114,14580,0.886244223587,15797,-76,33
596,CHARLES RIV LABS INTL INC,76.1886573521,691179,89.9490934809,678695,101.149514542,746924,108.01973444,1021767,-12484,68229
597,CHART INDS INC,36.0158522465,212462,34.938939749,177939,34.7325312061,173123,39.2310563643,187530,-34523,-4816
598,CHARTER COMMUNICATIONS INC N,287.919659941,1316006,327.319777002,1184047,336.849721036,1078095,363.419322173,1269971,-131959,-105952
599,CHARTER FINL CORP MD,16.6930450623,33487,19.6725139371,34261,17.9946735766,41679,18.5250219491,34170,774,7418
600,CHASE CORP,83.5726755646,17757,95.3928612156,17538,106.700689916,31743,111.405663197,76953,-219,14205
601,CHATHAM LODGING TR,20.5515173246,61358,19.7455265474,109088,20.0895736956,217028,21.3121354109,116741,47730,107940
602,CHECK POINT SOFTWARE TECH LT,84.459657711,2113068,102.660841579,1107394,109.079654943,967724,114.019795514,912631,-1005674,-139670
603,CHEESECAKE FACTORY INC,59.8790559097,622271,63.3607037808,557901,50.2993025739,704304,42.1206388314,1136450,-64370,146403
604,CHEETAH MOBILE INC,9.51862931738,11031,10.7287083358,16591,10.781013708,20499,8.40278726602,29276,5560,3908
605,CHEGG INC,7.38182256316,124495,8.44068224399,412052,12.2901743738,598771,14.8383593434,565359,287557,186719
606,CHEMED CORP NEW,160.407271702,28384,182.647853497,16655,204.563675609,16215,202.034883721,42656,-11729,-440
607,CHEMICAL FINL CORP,54.1683076583,352937,51.1505804176,195032,48.4158087014,150550,52.2608609989,223322,-157905,-44482
608,CHEMOCENTRYX INC,7.40436034554,58344,7.27625821259,79299,9.36171372506,73384,7.42152059517,220440,20955,-5915
609,CHEMOURS CO,22.0901069648,948162,38.4992356753,915187,37.9204210332,1800903,50.6103240883,1857210,-32975,885716
610,CHENIERE ENERGY INC,41.430141721,5903359,47.2700143837,6478166,48.7098962415,5921733,45.0399550889,6672742,574807,-556433
611,CHENIERE ENERGY PARTNERS LP,28.820196746,1114635,32.3097678044,1044421,32.3999433639,1899849,28.8200341178,1310165,-70214,855428
612,CHENIERE ENERGY PTNRS LP HLD,22.3716381418,16360,24.4060943028,13849,26.9110764431,15384,25.0922728896,33596,-2511,1535
613,CHERRY HILL MTG INVT CORP,18.1801055011,42464,17.0950037254,95291,18.471980082,171503,18.096345347,178047,52827,76212
614,CHESAPEAKE ENERGY CORP,7.02012234194,7600010,5.94007997202,7730704,4.97005610455,5883837,4.30005724228,6462007,130694,-1846867
615,CHESAPEAKE LODGING TR,25.8599798317,8756310,23.9600412898,8732414,24.4700157734,8640493,26.9699841094,8576757,-23896,-91921
616,CHEVRON CORP NEW,117.699983014,7041148,107.370025867,7758236,104.330136091,8766930,117.500083379,11453694,717088,1008694
617,CHICAGO BRIDGE & IRON CO N V,31.7500077205,582866,30.7494069052,830390,19.7303268689,1236979,16.7995815116,982584,247524,406589
618,CHICOS FAS INC,14.3900395237,1415354,14.1999328955,1555782,9.42022484986,2062265,8.95013866093,2650350,140428,506483
619,CHILDRENS PL INC,100.950536877,193154,120.051085568,344520,102.100879456,633687,118.151450887,621482,151366,289167
620,CHIMERA INVT CORP,17.0203433141,1960595,20.180048434,1687657,18.6298877249,1516810,18.9199088444,1599902,-272938,-170847
621,CHINA LIFE INS CO LTD,12.8692528954,657070,15.330509572,532859,15.3408318278,514770,15.0500885465,531359,-124211,-18089
622,CHINA LODGING GROUP LTD,51.8389483958,161886,62.0532570892,187468,80.6797727446,341114,118.821237003,323831,25582,153646
623,CHINA MOBILE LIMITED,52.4290847337,416906,55.2302062842,486998,53.0904777088,426536,50.5689492659,411636,70092,-60462
624,CHINA PETE & CHEM CORP,71.0179373108,98454,81.5115992537,113628,78.6018864453,124997,75.7595193808,93546,15174,11369
625,CHINA UNICOM (HONG KONG) LTD,11.5595982566,15831,13.4739632227,18109,14.9495210976,15452,14.0310614754,88019,2278,-2657
626,CHIPOTLE MEXICAN GRILL INC,377.32168591,696692,445.521500892,873987,416.096935452,145829,307.828673816,262867,177295,-728158
627,CHOICE HOTELS INTL INC,56.0526802684,118906,62.6017481904,159708,64.2512051448,186907,63.8951433726,134126,40802,27199
628,CHRISTOPHER & BANKS CORP,2.34165345601,96513,1.47584574867,78599,1.30476179281,85073,1.36932707355,10224,-17914,6474
629,CHUBB LIMITED,132.119703287,1080505,136.249696267,1275790,145.379849457,1817549,142.550362512,2002829,195285,541759
630,CHUNGHWA TELECOM CO LTD,31.5461308146,129588,33.9746081099,123504,35.2252237618,123122,34.115808605,117746,-6084,-382
631,CHURCH & DWIGHT INC,44.1902502456,2050226,49.8698524275,1853665,51.8801243356,2223337,48.4497452601,1881723,-196561,369672
632,CHURCHILL DOWNS INC,150.455731953,23369,158.836787908,22627,183.307915433,33441,206.192692255,21703,-742,10814
633,CHUYS HLDGS INC,32.4584964888,30901,29.8035943135,33553,23.4122712594,29728,21.0541741976,61413,2652,-3825
634,CIENA CORP,24.4102154266,1221251,23.6099795854,1167303,25.0197105329,1125033,21.9695549698,1253735,-53948,-42270
635,CIGNA CORPORATION,133.389560612,1397898,146.490026838,1600696,167.390124502,1842540,186.939961759,1961250,202798,241844
636,CIMAREX ENERGY CO,135.898912325,817983,119.491421871,466477,94.0098196452,406532,113.669488567,458320,-351506,-59945
637,CIMPRESS N V,91.6162673904,46793,86.178748343,71665,94.5289230287,44653,97.677524362,47923,24872,-27012
638,CINCINNATI BELL INC NEW,22.3466275759,237396,17.6986828887,143344,19.550209648,118055,19.8489279013,187063,-94052,-25289
639,CINCINNATI FINL CORP,75.7495104427,830342,72.2703931914,693479,72.4497145106,673405,76.5696675186,984476,-136863,-20074
640,CINEMARK HOLDINGS INC,38.3602700071,1046343,44.3402596112,1026381,38.8494574809,860707,36.2099073966,1259241,-19962,-165674
641,CINTAS CORP,115.560251363,1375222,126.540669902,1268604,126.039569594,1224425,144.279799682,942703,-106618,-44179
642,CIRCOR INTL INC,64.8904528507,23871,59.4396522293,659055,59.3803900318,605284,54.4301995604,765733,635184,-53771
643,CIRRUS LOGIC INC,56.5397663023,570395,60.6889941362,886800,62.7199832215,1335045,53.3199423798,1364105,316405,448245
644,CISCO SYS INC,30.2200354493,30967601,33.7999748163,31409195,31.3000318556,37371815,33.6300150347,39635070,441594,5962620
645,CIT GROUP INC,42.679947844,4277934,42.929760938,3857953,48.6998341498,2352123,49.0500107593,1909969,-419981,-1505830
646,CITIGROUP INC,59.3439103653,12421443,59.748536939,15051833,66.7890750357,14354683,72.6212393982,14211655,2630390,-697150
647,CITIZENS FINL GROUP INC,35.629973193,8801438,34.5499848432,7059540,35.6800742484,7848246,37.8700652401,11451393,-1741898,788706
648,CITRIX SYS INC,89.3100272592,3141327,83.3901995449,3780804,79.5798754015,3497153,76.8197900256,3845897,639477,-283651
649,CITY HLDG CO,67.6006870067,51819,64.4883920894,36053,65.8747811273,21131,71.9130375208,43789,-15766,-14922
650,CIVEO CORP CDA,2.20084375838,164028,2.99202596853,141710,2.09959540643,195752,2.85139307002,182367,-22318,54042
651,CIVITAS SOLUTIONS INC,19.9099026627,49724,18.3364497256,16579,17.5167182354,20038,18.4283395398,10473,-33145,3459
652,CLAYMORE EXCHANGE TRD FD TR,19.5843688593,957243,15.5374954909,612647,26.7894331621,316916,34.8646985547,199887,-344596,-295731
653,CLEAN ENERGY FUELS CORP,2.85980989548,521713,2.54977491642,966752,2.540297494,1160494,2.48058822703,1068295,445039,193742
654,CLEAN HARBORS INC,55.652183278,185707,55.6190144018,344055,55.8310579991,478318,56.7000660969,341922,158348,134263
655,CLEAR CHANNEL OUTDOOR HLDGS,5.05319952085,99343,6.05245460659,90707,4.84831029186,83328,4.64780749214,97035,-8636,-7379
656,CLEARSIDE BIOMEDICAL INC,8.94160583942,32880,7.93578400073,43852,9.11488190782,34888,8.75351094871,36671,10972,-8964
657,CLEARWATER PAPER CORP,65.5484535198,46622,56.0064935065,30800,46.7284851011,19196,49.2602674873,42245,-15822,-11604
658,CLOROX CO DEL,120.019579378,896862,134.829995072,1034970,133.239669546,1193631,131.910600786,1154820,138108,158661
659,CLOUD PEAK ENERGY INC,5.60880844793,328412,4.57951527105,694615,3.53360108558,109803,3.66043939204,287124,366203,-584812
660,CLOVIS ONCOLOGY INC,44.4211307069,709167,63.6695311808,620815,93.6320952461,381664,82.3986733475,336486,-88352,-239151
661,CME GROUP INC,115.349988381,2155943,118.80054968,1945858,125.239665858,1920382,135.680830021,1822026,-210085,-25476
662,CMS ENERGY CORP,41.6202210954,1269407,44.7401290417,1971921,46.2498328073,3297093,46.3199191404,4507564,702514,1325172
663,CNA FINL CORP,41.5045282426,114614,44.1693406805,254611,48.7500947616,211056,50.2487897366,311709,139997,-43555
664,CNH INDL N V,8.68982137022,1762752,9.63988229049,1427922,11.3798683955,1010908,12.0101109686,674515,-334830,-417014
665,CNO FINL GROUP INC,19.1498848336,4866870,20.5001169626,5052898,20.8799209841,4969128,23.3398529985,4498186,186028,-83770
666,CNOOC LTD,123.958719773,59302,119.797718244,90369,109.401761683,65392,129.702044134,65211,31067,-24977
667,CNX COAL RES LP,18.2476051645,76832,16.9511974422,149193,14.9514962125,141123,14.8002049976,128782,72361,-8070
668,COACH INC,35.0201006651,1452937,41.3298985165,3818156,47.3398685794,3586195,40.2801009698,3849469,2365219,-231961
669,COBALT INTL ENERGY INC,1.21985521176,1329666,0.533473599513,1471488,2.46096903117,50793,1.42573981987,28757,141822,-1420695
670,COBIZ FINANCIAL INC,16.8898801399,1556731,16.8002630773,1684676,17.40006139,1821143,19.6402759854,1807052,127945,136467
671,COCA COLA BOTTLING CO CONS,178.674351585,2429,206.035919274,27005,228.848100227,36557,215.762795496,44586,24576,9552
672,COCA COLA CO,41.4599893489,15354249,42.4400495238,14092632,44.8500135439,15641779,45.0100097495,16463449,-1261617,1549147
673,COCA COLA EUROPEAN PARTNERS,31.3998395354,5400569,37.6901176173,3080330,40.6710466448,800004,41.6198393164,2045635,-2320239,-2280326
674,COCA COLA FEMSA S A B DE C V,63.5484622554,34336,71.6942600831,27422,84.6442488094,13858,77.0989573806,10934,-6914,-13564
675,CODEXIS INC,4.57579672696,18576,4.80192076831,17493,5.44554455446,16160,6.66214995483,26568,-1083,-1333
676,COEUR MNG INC,9.08956283288,391658,8.07993934387,441835,8.58043164406,732131,9.19049047657,409989,50177,290296
677,COGENT COMMUNICATIONS HLDGS,41.3516760852,173947,43.0501344063,174471,40.0983063882,299065,48.8999424664,549244,524,124594
678,COGNEX CORP,63.6211462812,476131,83.9496254991,888783,84.9006027588,828192,110.280746499,747329,412652,-60591
679,COGNIZANT TECHNOLOGY SOLUTIO,56.0300665217,4459445,59.5200044624,4517792,66.3998999625,4334374,72.5400823016,5273774,58347,-183418
680,COHEN & STEERS INC,33.6157896572,28677,39.9293880296,11896,40.5569007264,18172,39.4829282001,28468,-16781,6276
681,COHERENT INC,137.371635551,51903,205.638868659,67283,224.990397792,210889,235.172349757,366174,15380,143606
682,COHERUS BIOSCIENCES INC,28.1608780417,41547,21.1488713278,141095,14.3482611071,140923,13.3495228415,146597,99548,-172
683,COHU INC,13.9097541205,92525,18.4553677958,118177,15.7425448727,77497,23.8428865438,91348,25652,-40680
684,COLFAX CORP,35.9299682144,676093,39.2600431035,747503,39.3706017458,858153,41.6403063694,1022687,71410,110650
685,COLGATE PALMOLIVE CO,65.4399856784,4457611,73.1899172054,5447458,74.1298542505,5777308,72.8500837606,7310122,989847,329850
686,COLLEGIUM PHARMACEUTICAL INC,15.5697693991,35646,10.0647016535,65377,12.502587456,48310,10.4840619819,80217,29731,-17067
687,COLLIERS INTL GROUP INC,36.7454640614,45856,47.1991358215,45361,56.4695346446,60298,49.7011369634,70099,-495,14937
688,COLUMBIA BKG SYS INC,44.6798206159,1955357,38.9899731173,2087588,39.8498299779,2114137,42.1094645601,2194756,132231,26549
689,COLUMBIA PPTY TR INC,21.6000051758,6646341,22.2500637768,6044522,22.3800194104,6867465,21.7700222078,8555113,-601819,822943
690,COLUMBIA SPORTSWEAR CO,58.2992568999,612838,58.7503245134,485342,58.0607679968,425158,61.5806966046,499767,-127496,-60184
691,COLUMBUS MCKINNON CORP N Y,27.0618882622,39539,24.8221767514,41052,25.4301351637,33071,37.8807138862,39334,1513,-7981
692,COMCAST CORP NEW,69.0500268325,14057576,37.5900138299,26001560,38.9199842209,32848446,38.4799715276,30999893,11943984,6846886
693,COMERICA INC,68.110181643,2856592,68.5803410912,2822354,73.2401912184,1810495,76.2602565679,2919227,-34238,-1011859
694,COMFORT SYS USA INC,33.2996166951,112704,36.6491687772,114109,37.0879120879,69160,35.698435593,108156,1405,-44949
695,COMMERCE BANCSHARES INC,57.8099428377,1227557,56.1597562745,1288663,56.8301067769,1284548,57.7699668991,1142566,61106,-4115
696,COMMERCEHUB INC,15.0227620663,495781,15.5112398814,442131,17.4313495554,81864,21.3474220435,237921,-53650,-360267
697,COMMERCIAL METALS CO,21.779944865,2784075,19.129975354,3986048,19.4300693249,4512233,19.0300928512,3481591,1201973,526185
698,COMMSCOPE HLDG CO INC,37.200344964,1850628,41.7089385299,1110865,38.0301023213,1084036,33.2099814452,1441675,-739763,-26829
699,COMMUNITY BANKERS TR CORP,7.23796894856,18099,8.00199848502,124094,8.24411134904,56040,9.1836088416,15789,105995,-68054
700,COMMUNITY BK SYS INC,61.7903329661,1214478,54.9804497847,1117379,55.7693812355,1201394,55.2505308211,1196260,-97099,84015
701,COMMUNITY HEALTH SYS INC NEW,5.0645300747,2190529,8.03668211866,2185479,8.74534684406,1681923,5.96775910808,920446,-5050,-503556
702,COMMUNITY HEALTHCARE TR INC,23.030385119,221490,23.9007444169,201500,25.5892255892,179685,26.9559187087,188901,-19990,-21815
703,COMMUNITY TR BANCORP INC,49.5970756833,12037,45.7351006779,9883,43.7034230138,7917,46.456924434,10203,-2154,-1966
704,COMMVAULT SYSTEMS INC,51.3997973724,1091658,50.7999645918,1570257,56.4498987985,1350277,60.8000450506,1207532,478599,-219980
705,COMPANHIA BRASILEIRA DE DIST,16.5655622958,17144,19.2034382973,116802,19.5500618865,362761,23.6718284693,335800,99658,245959
706,COMPANHIA DE SANEAMENTO BASI,8.67963357832,1116637,10.4102898965,1176144,9.52030010692,1489869,10.4599752861,2268361,59507,313725
707,COMPANHIA ENERGETICA DE MINA,2.28007057295,9365061,3.29002205382,9417870,2.40005453985,7964819,2.47998260649,7671828,52809,-1453051
708,COMPANHIA PARANAENSE ENERG C,8.48213049857,180615,10.315942946,72703,7.33826100074,112697,8.86296665728,131333,-107912,39994
709,COMPANHIA SIDERURGICA NACION,3.23263231275,162097,2.91749328977,188518,2.15063083365,184597,2.95976874374,796346,26421,-3921
710,COMPANIA CERVECERIAS UNIDAS,20.9846776075,64285,25.2763201965,44785,26.2388539687,13682,26.9358713731,43288,-19500,-31103
711,COMPANIA DE MINAS BUENAVENTU,11.2798264642,1113315,12.0401318695,1050736,11.4995806938,1029081,12.7896113376,1238427,-62579,-21655
712,COMPASS MINERALS INTL INC,78.3512267534,95659,67.846579156,206908,65.2983010925,307374,64.9012724182,314755,111249,100466
713,COMPUGEN LTD,5.10428992367,43101,4.29787447531,59797,3.78247216671,28024,3.78957662687,24541,16696,-31773
714,COMPUTER PROGRAMS & SYS INC,23.5995130598,46823,28.0030236394,29104,32.8127904815,21516,29.5545802596,42836,-17719,-7588
715,COMPUTER TASK GROUP INC,4.19874037789,41441,5.51397205589,80160,5.58954896342,77466,5.37417707913,14886,38719,-2694
716,COMSTOCK MNG INC,0.283194433207,24718,0.242522231205,24740,0.200240288346,24970,0.161394448031,24784,22,230
717,COMTECH TELECOMMUNICATIONS C,11.8532818533,129500,14.7374815781,88889,18.9759685651,41737,20.5330952685,172502,-40611,-47152
718,CONAGRA BRANDS INC,39.549921153,5267166,40.3400813319,5888709,35.7599630756,5676460,33.7399474893,7920285,621543,-212249
719,CONATUS PHARMACEUTICALS INC,5.27607753124,62736,5.77685228723,14887,5.76400908268,62977,5.48484340981,71652,-47849,48090
720,CONCERT PHARMACEUTICALS INC,10.2984289258,13303,17.0638968747,32349,13.9603667554,16905,14.7477744807,33700,19046,-15444
721,CONCHO RES INC,132.600589055,1944471,128.340082777,1569759,121.529431037,1306342,131.720355118,1147112,-374712,-263417
722,CONCORDIA INTERNATIONAL CORP,2.11898062762,371405,1.62864830145,502871,1.55879870395,440724,1.17869264524,422502,131466,-62147
723,CONE MIDSTREAM PARTNERS LP,23.551611881,485954,23.609686732,1001411,18.9500985901,903742,15.8399727191,645140,515457,-97669
724,CONFORMIS INC,8.1106870229,10480,5.21779043788,148147,4.29140132882,144941,3.51981108105,133814,137667,-3206
725,CONMED CORP,44.1693509337,1044978,44.4100242265,1007160,50.9398873117,977564,52.4698171029,1005702,-37818,-29596
726,CONNECTICUT WTR SVC INC,55.862344938,12495,53.144807411,12306,55.5280935904,12138,59.2848709732,11858,-189,-168
727,CONNECTONE BANCORP INC NEW,25.9495116073,1182450,24.2501645903,1263744,22.5500371736,1358490,24.5995869909,1409170,81294,94746
728,CONNS INC,12.6646062886,29768,8.75428841831,25359,19.0934844193,17650,28.1506638755,136622,-4409,-7709
729,CONOCOPHILLIPS,50.1399995892,9882529,49.8700081324,9754841,43.9600756893,8893729,50.0500760296,9748177,-127688,-861112
730,CONSOL ENERGY INC,18.2301919399,2296136,16.7799621293,1863711,14.9398369128,4071932,16.9400819566,4708832,-432425,2208221
731,CONSOLIDATED COMM HLDGS INC,26.8515968776,177941,23.4123106986,81880,21.4713069858,296675,19.0807330708,915164,-96061,214795
732,CONSOLIDATED EDISON INC,73.6798385405,2583434,77.6599137708,2276258,80.8200699217,2999354,80.6798643528,2628289,-307176,723096
733,CONSTELLATION BRANDS INC,153.309655036,728656,162.070665093,756781,193.729419033,794727,199.449979754,1079233,28125,37946
734,CONSTELLIUM NV,5.90466557087,79090,6.5049958368,19216,6.89447990988,66575,10.2518086479,89155,-59874,47359
735,CONSUMER PORTFOLIO SVCS INC,5.11974759788,69730,4.70574814266,70127,4.54190271537,40952,4.58897064641,12639,397,-29175
736,CONTAINER STORE GROUP INC,6.35618043351,34140,4.27191679049,10768,5.88235294118,11730,4.1823147832,11716,-23372,962
737,CONTANGO OIL & GAS COMPANY,9.34170194132,130169,7.32180568807,93283,6.64430642878,78413,5.03495579969,121153,-36886,-14870
738,CONTINENTAL BLDG PRODS INC,23.0986575696,153602,24.5027013392,170471,23.3022248808,377818,25.9986959269,495371,16869,207347
739,CONTINENTAL RESOURCES INC,51.5400464983,1247787,45.4199212941,1042362,32.329362957,676846,38.6099388422,967497,-205425,-365516
740,CONTRAFECT CORP,1.74848959724,198457,1.8041087121,103098,1.45542567371,65273,1.10945971405,47771,-95359,-37825
741,CONTROL4 CORP,10.1950113379,55125,15.7910514877,133430,19.6158153403,140193,29.4628174676,109460,78305,6763
742,CONVERGYS CORP,24.5602168801,2915528,21.1499980209,3056927,23.7801989066,3699927,25.8900161497,3268789,141399,643000
743,COOPER COS INC,174.928473412,222994,199.891611427,199283,239.420519532,307931,237.110915068,567903,-23711,108648
744,COOPER STD HLDGS INC,103.380133768,144728,110.934931131,136855,100.871807466,130304,115.96706042,162115,-7873,-6551
745,COOPER TIRE & RUBR CO,38.8515888051,448167,44.3497191424,306383,36.1003562582,278169,37.4011228159,396325,-141784,-28214
746,COPA HOLDINGS SA,90.8222101876,94173,112.246455141,157270,117.001140125,180682,124.52907296,156606,63097,23412
747,COPART INC,55.4089591288,668123,61.9302966115,628836,31.7903036281,1457803,34.3704491208,1538851,-39287,828967
748,CORCEPT THERAPEUTICS INC,7.2581010993,132266,10.957211601,215292,11.7992045892,272815,19.2997373184,631563,83026,57523
749,CORE LABORATORIES N V,120.031263957,26868,115.528239106,68823,101.259058879,89829,98.7087824138,112452,41955,21006
750,CORE MARK HOLDING CO INC,43.0691499698,879957,31.1770515353,44552,33.0759993138,29145,32.1381235558,85257,-835405,-15407
751,CORECIVIC INC,24.4599338437,1855606,31.4203268201,1543173,27.5790131085,602052,26.7704699741,612055,-312433,-941121
752,CORELOGIC INC,36.8300313269,942003,40.7194212957,772899,43.3796728972,856000,46.2198198198,832500,-169104,83101
753,CORENERGY INFRASTRUCTURE TR,34.8793796669,557120,33.7811350092,607114,33.5903770807,520923,35.3503506843,464663,49994,-86191
754,CORESITE RLTY CORP,79.3694718264,296323,90.0494415164,330896,103.528878465,507385,111.899329088,293630,34573,176489
755,CORINDUS VASCULAR ROBOTICS I,0.689134643783,30473,1.30592299267,23738,1.85298517612,58824,1.52211828127,94605,-6735,35086
756,CORNERSTONE ONDEMAND INC,42.3104458084,1296252,38.8904450124,1713660,35.7500624421,1869731,40.6096714111,2355892,417408,156071
757,CORNING INC,24.2700414605,12332447,27.0000084959,11299552,30.0499347044,9392666,29.9199304564,8554064,-1032895,-1906886
758,CORPORATE OFFICE PPTYS TR,31.2190944077,716901,33.1004247157,1240830,35.0296509349,933866,32.8291749554,843518,523929,-306964
759,CORVEL CORP,36.5951178451,47520,43.5025831715,30389,47.4373484236,30925,54.3963105769,52908,-17131,536
760,COSAN LTD,7.50984702027,815729,8.5404844366,826651,6.40943925374,533432,8.13045190653,548432,10922,-293219
761,COSTAMARE INC,5.60003362121,190356,6.66334537302,144522,7.30752552067,170646,6.18387528609,115785,-45834,26124
762,COSTAR GROUP INC,188.489152528,205163,207.220773497,190589,263.596988681,131371,268.252243215,215316,-14574,-59218
763,COSTCO WHSL CORP NEW,160.110148148,4107922,167.69005552,4000923,159.929902827,3678893,164.289736771,2274713,-106999,-322030
764,COTIVITI HLDGS INC,34.4627859832,6906,41.6355571171,22769,37.1408369223,77785,35.9803750763,3461109,15863,55016
765,COTT CORP QUE,11.3307377458,180306,12.3618199196,110906,14.4422131716,194707,15.0102525386,223847,-69400,83801
766,COTY INC,18.3099522617,3660796,18.1300207153,9617529,18.7600319469,9012458,16.5299270879,9242630,5956733,-605071
767,COUSINS PPTYS INC,8.51014773782,2368114,8.27035438687,1280719,8.79031616441,2878281,9.34015140251,2320305,-1087395,1597562
768,COVANTA HLDG CORP,15.6006129937,1555644,15.7000475582,2731393,13.1998819281,2788131,14.8496189879,1222927,1175749,56738
769,CPFL ENERGIA S A,15.4002869911,1402831,16.3899681189,783223,15.9497813549,1936014,17.1601621968,1952196,-619608,1152791
770,CPI CARD GROUP INC,4.15509285829,43561,4.1986513423,23579,2.83697301577,30314,1.16009280742,13792,-19982,6735
771,CRA INTL INC,36.591284092,20606,35.3161114888,29420,36.3129914907,58877,41.0523884676,51958,8814,29457
772,CRACKER BARREL OLD CTRY STOR,166.979594213,137412,159.246626844,166239,167.250752998,158367,151.621274193,166474,28827,-7872
773,CRANE CO,72.1201984125,521338,74.8300391658,571161,79.3812911514,596274,79.9923971109,499810,49823,25113
774,CRAY INC,20.6984696079,120492,21.896092325,118971,18.3885737036,40188,19.4533762058,80860,-1521,-78783
775,CREDICORP LTD,157.859955668,700621,163.299312919,754351,179.390454493,769032,205.019581872,803294,53730,14681
776,CREDIT ACCEP CORP MICH,217.525585902,16513,199.431271693,23913,257.143888267,138545,280.167730285,196029,7400,114632
777,CREDIT SUISSE GROUP,14.3101120857,1050446,14.8396016269,1121863,14.6005339645,1101946,15.7997100705,1106476,71417,-19917
778,CREDIT SUISSE NASSAU BRH,46.7487241069,1165850,37.5524662876,67186,47.4548707107,61490,66.6219453761,104350,-1098664,-5696
779,CREE INC,26.3873475145,226169,26.7288285818,503202,24.6502624727,2137746,28.1902263335,2907568,277033,1634544
780,CRESCENT PT ENERGY CORP,13.589920038,248493,10.8184908916,394140,7.64826802982,384793,8.05054239729,327804,145647,-9347
781,CRESTWOOD EQUITY PARTNERS LP,25.5497091034,561024,26.2497836277,589262,23.501011018,823922,24.3998448432,1392140,28238,234660
782,CRESUD S A C I F Y A,15.7717716108,74627,20.0669323523,78288,19.4531844892,69603,18.6793294331,38117,3661,-8685
783,CRH PLC,34.3793698585,317516,35.1680450151,334821,35.4671359706,326725,37.8608644362,305170,17305,-8096
784,CRITEO S A,41.0859314958,48143,49.9922642531,155124,49.0493186971,222735,41.5032679739,82620,106981,67611
785,CROCS INC,6.86181719849,177504,7.07091713955,201954,7.70620192341,143391,9.70035443092,376378,24450,-58563
786,CROSS CTRY HEALTHCARE INC,15.6079066699,119747,14.3651785418,90427,12.9114712195,61031,14.2342307369,154557,-29320,-29396
787,CROSSAMERICA PARTNERS LP,25.1901357401,1074627,26.1802546742,1059157,25.500317458,1089908,27.2504064658,1060975,-15470,30751
788,CROWN CASTLE INTL CORP NEW,86.7701051514,1722183,94.4503179387,2207658,100.180374228,2538611,101.375880258,3331976,485475,330953
789,CROWN HOLDINGS INC,52.5704811883,1277504,52.9496656772,634716,59.6597301414,653305,59.7194053979,814057,-642788,18589
790,CRYOLIFE INC,19.1410455796,33436,16.6428698911,44824,19.9660953099,21236,22.6944298476,60896,11388,-23588
791,CSG SYS INTL INC,48.4015957318,205799,37.8064427663,102099,40.5796272281,314616,40.1004161987,333014,-103700,212517
792,CSI COMPRESSCO LP,9.7299707742,3538654,9.80013624062,3395463,4.85010902252,2835194,5.21002757373,2818987,-143191,-560269
793,CSRA INC,31.84084793,690057,29.2913041492,612844,31.7504395378,597787,32.2697423671,613237,-77213,-15057
794,CSS INDS INC,27.0681493726,53236,25.907823323,33349,26.1605189122,51184,28.8208525524,32303,-19887,17835
795,CSX CORP,35.9300381969,7130691,46.5499842478,5843611,54.5600365473,5910150,54.2600535437,6067189,-1287080,66539
796,CTRIP COM INTL LTD,40.0001832914,2837012,49.1502707822,2889038,53.8600660146,2976918,52.7397729149,2980028,52026,87880
797,CTS CORP,22.3999655186,1624065,21.2998150391,1603582,21.5997816815,1469413,24.0998904698,1536563,-20483,-134169
798,CU BANCORP CALIF,35.8004067533,556111,39.6498904411,584617,36.1506714951,751383,38.7750792706,577768,28506,166766
799,CUBESMART,26.7700252282,3886922,25.9596672738,1941897,24.0403127956,2132127,25.9599363525,2986448,-1945025,190230
800,CUBIC CORP,47.9443966463,59277,52.8171753053,38567,46.2970265794,25358,50.9905110704,60070,-20710,-13209
801,CULLEN FROST BANKERS INC,88.2288884943,596902,88.9686544312,495062,93.9108446667,523603,94.9209935934,308899,-101840,28541
802,CULP INC,37.1366629195,24908,31.1936780812,21639,32.4887055588,25455,32.7387571727,22481,-3269,3816
803,CUMMINS INC,136.670120937,1243871,151.200421052,1276802,162.220190947,1288736,168.030698493,1350164,32931,11934
804,CUMULUS MEDIA INC,1.02231195849,117381,0.319458576871,84518,0.439305047757,70566,0.310180569403,45135,-32863,-13952
805,CURIS INC,3.07808796418,121504,2.77688140084,117758,1.88903191294,119638,1.48904986444,213559,-3746,1880
806,CURRENCYSHARES AUSTRALIAN DL,72.1807322219,224686,76.4498687546,222865,76.9120319476,222865,78.4301404417,222797,-1821,0
807,CURRENCYSHARES CDN DLR TR,73.580974643,39358,74.2399494178,37958,76.0923697937,38151,79.0821715251,37872,-1400,193
808,CURRENCYSHARES EURO TR,102.258790654,386490,103.410865803,236890,110.481921768,101365,114.101890756,106624,-149600,-135525
809,CURRENCYSHARES SWISS FRANC T,93.7271279115,23227,95.0617815473,23227,98.9718162416,123227,97.7132669592,122839,0,100000
810,CURRENCYSHS JAPANESE YEN TR,82.5205412412,261547,86.520983166,253060,85.5347875288,102508,85.3733739221,102163,-8487,-150552
811,CURTISS WRIGHT CORP,98.3605929518,1044402,91.2592130316,1038339,91.7792117447,875427,104.539235189,792248,-6063,-162912
812,CUSTOMERS BANCORP INC,35.8225947336,101891,31.5302254153,93117,28.2812464015,86842,32.6228342496,172977,-8774,-6275
813,CUTERA INC,17.3477827498,47153,20.6947867739,43006,25.8950113141,66731,41.3760896638,32120,-4147,23725
814,CVB FINL CORP,22.9300397749,3668899,22.0899355768,3504175,22.4301840377,3778792,24.1699771407,3909561,-164724,274617
815,CVR ENERGY INC,25.3899511,84049,20.0813216108,148546,21.7577449633,304811,25.9008136981,322847,64497,156265
816,CVR PARTNERS LP,6.01039457636,273027,4.65078807055,409608,3.48992008101,3270562,3.23002001121,3634962,136581,2860954
817,CVR REFNG LP,10.4003456456,1226690,9.45019346827,1547799,9.50053705693,931000,9.85020685533,2034272,321109,-616799
818,CVS HEALTH CORP,78.9098944662,4968363,78.4997815808,4788956,80.4598493731,6671054,81.3198774124,7052261,-179407,1882098
819,CYBERARK SOFTWARE LTD,45.4706675179,14097,50.8765445137,37876,49.9481894306,71414,40.9917266861,37349,23779,33538
820,CYPRESS SEMICONDUCTOR CORP,11.4400166461,6949378,13.7600603425,8962170,13.6500362825,10988762,15.0200137283,11551321,2012792,2026592
821,CYRUSONE INC,44.7299574573,6075302,51.4700826571,5177532,55.7500094708,4091515,58.9302042102,3673617,-897770,-1086017
822,CYS INVTS INC,7.73003252877,280982,7.94854407995,355411,8.40954385442,536890,8.64003675169,531132,74429,181479
823,CYTOKINETICS INC,12.1553762012,71491,12.8524207661,51430,12.1006370228,286018,14.4993992443,344566,-20061,234588
824,CYTRX CORP,0.369666244191,18936,0.445281290552,78602,0.62689686054,703465,0.420380023541,35682,59666,624863
825,D R HORTON INC,27.3298242825,4076316,33.3098541748,3916949,34.5699129359,3867496,39.9300017601,4812121,-159367,-49453
826,DAKTRONICS INC,10.7027119222,140712,9.44891333213,116733,9.63149569395,85345,10.5673694474,253327,-23979,-31388
827,DANA INCORPORATED,18.9796440497,2286555,19.3101263479,3402826,22.3301343283,3884437,27.9599910722,3951718,1116271,481611
828,DANAHER CORP DEL,77.8400502013,4637330,85.5298828065,4852573,84.3900083414,5164628,85.7802962337,5045949,215243,312055
829,DARDEN RESTAURANTS INC,72.7199739892,1703906,83.6696818645,1821771,90.4398958819,2010794,78.7800972722,2064722,117865,189023
830,DARLING INGREDIENTS INC,12.910128845,624316,14.5185450995,479318,15.7412809409,730182,17.5200692508,911469,-144998,250864
831,DAVE & BUSTERS ENTMT INC,56.2978659859,140627,61.0918363082,95692,66.5092972212,169029,52.4804728731,236850,-44935,73337
832,DAVITA INC,64.2003391265,770214,67.9703923258,1117413,64.7598291392,1420572,59.3900042077,1387944,347199,303159
833,DAWSON GEOPHYSICAL CO NEW,8.02990162857,48693,5.53786515298,14446,3.92592450734,52217,4.51656072265,11956,-34247,37771
834,DBV TECHNOLOGIES S A,35.1333283815,53852,35.2258599254,55499,35.7006533893,44537,42.4424322583,58974,1647,-10962
835,DBX ETF TR,27.8436920376,53424201,29.4340486619,60204222,29.8474659498,58762945,30.8543903016,59081511,6780021,-1441277
836,DCT INDUSTRIAL TRUST INC,47.8804633881,963253,48.1199989487,837074,53.4390441121,837253,57.9201994737,906385,-126179,179
837,DDR CORP,15.2700303162,18822294,12.5299610975,23170463,9.06997088903,29389951,9.1599925762,29375788,4348169,6219488
838,DEAN FOODS CO NEW,21.7803092305,1985509,19.6600333084,1412256,17.0000513391,1616701,10.8801539374,912579,-573253,204445
839,DECKERS OUTDOOR CORP,55.3891818832,301864,59.7257491112,59070,68.2592219504,271011,68.4102314151,582676,-242794,211941
840,DEERE & CO,103.039670273,1176246,108.860294045,1011682,123.590862939,1302038,125.590204261,1634180,-164564,290356
841,DEL FRISCOS RESTAURANT GROUP,16.9858870968,19840,18.0450631742,30313,16.1142130186,28298,14.5476819417,26121,10473,-2015
842,DEL TACO RESTAURANTS INC,11.5220310021,40965,10.615235105,40131,13.322051391,263548,15.2536636647,1335548,-834,223417
843,DELEK LOGISTICS PARTNERS LP,28.5496102699,1024042,33.3001400868,1007233,32.7499042846,919392,31.2509261856,877254,-16809,-87841
844,DELL TECHNOLOGIES INC,54.9698413503,1223198,64.0797246194,1101893,61.1103788853,842181,77.2098349257,871547,-121305,-259712
845,DELPHI AUTOMOTIVE PLC,67.3497310859,1204474,80.4904105989,1750370,87.6498124561,2526075,98.4000995068,3529407,545896,775705
846,DELTA AIR LINES INC DEL,49.1899100779,5260774,45.9600980939,6969241,53.7402166163,3931283,48.2196153469,3181672,1708467,-3037958
847,DELTIC TIMBER CORP,77.0957726296,20935,78.165601517,14239,74.645500758,22426,88.4194607878,42321,-6696,8187
848,DELUXE CORP,71.6094049412,428966,72.1693882806,450468,69.2208291133,429495,72.9587815638,390796,21502,-20973
849,DENBURY RES INC,3.68002246446,4907307,2.58003793055,4889463,1.53024525582,3240657,1.33981299539,4146101,-17844,-1648806
850,DENISON MINES CORP,0.511398810325,37153,0.619061717762,37153,0.428021115708,35045,0.456821576034,56915,0,-2108
851,DENNYS CORP,12.8337901163,174773,12.3706466355,152296,11.7668216736,116769,12.4488378981,205963,-22477,-35527
852,DENTSPLY SIRONA INC,57.7298827609,4079014,62.4402682637,2884773,64.8400021561,2782850,59.8101785948,2871752,-1194241,-101923
853,DEPOMED INC,18.0186251685,326440,12.5503300556,365090,10.7421624167,350395,5.78878227867,370717,38650,-14695
854,DERMIRA INC,30.3301522661,178766,34.1072487274,146743,29.1428363265,137255,27.0018942655,174210,-32023,-9488
855,DESTINATION XL GROUP INC,4.25162837367,58801,2.82574568289,12740,2.35146783552,300238,1.90154738418,42071,-46061,287498
856,DEUTSCHE BANK AG,18.0999973834,36611718,17.1600041559,40973067,17.7900151562,29407170,17.2799835498,34256109,4361349,-11565897
857,DEVON ENERGY CORP NEW,45.6699051105,3427881,41.719902543,3641811,31.9700095948,4073036,36.70984473,5319445,213930,431225
858,DEXCOM INC,59.7002442766,1494617,84.7303451206,1402756,73.1500072974,1808872,48.9251668398,1837541,-91861,406116
859,DHI GROUP INC,6.25120564146,689467,3.94981746838,695222,2.85063549882,886469,2.59950945937,674358,5755,191247
860,DHT HOLDINGS INC,4.13911883994,251986,4.4713254212,289176,4.15092882517,569752,3.9800398004,299997,37190,280576
861,DHX MEDIA LTD,5.2688172043,18600,4.13978494624,18600,4.40860215054,18600,4.27807486631,18700,0,0
862,DIAGEO P L C,103.939769726,192727,115.579408874,211664,119.829955587,210298,132.129761216,227988,18937,-1366
863,DIAMOND HILL INVESTMENT GROU,210.498960499,1924,194.539249147,6153,199.596774194,2480,212.36333053,2378,4229,-3673
864,DIAMOND OFFSHORE DRILLING IN,17.6996123506,1993038,16.7100330761,1133750,10.8295868699,538063,14.5001392791,1389297,-859288,-595687
865,DIAMONDBACK ENERGY INC,101.060241862,1073340,103.715437746,688721,88.8101229206,1078582,97.9600435378,1395569,-384619,389861
866,DIAMONDROCK HOSPITALITY CO,11.5305072652,856337,11.1495980418,1655396,10.9500718487,1858070,10.9503366455,2684575,799059,202674
867,DIANA SHIPPING INC,3.06596775789,10111,4.62602482481,21833,4.0606350437,706786,3.63437328955,91350,11722,684953
868,DICKS SPORTING GOODS INC,53.0997898739,2095884,48.6605857296,1069572,39.8298243268,1009545,27.0097118828,833515,-1026312,-60027
869,DIEBOLD NXDF INC,25.1502677364,1085396,30.7008032385,705519,27.9998262955,1197436,22.8498113313,858913,-379877,491917
870,DIFFERENTIAL BRANDS GROUP IN,2.33789695542,56461,1.94376952447,14405,1.89368321385,14786,1.39573834558,10747,-42056,381
871,DIGI INTL INC,13.7474012474,76960,11.8989058325,75217,10.1586031365,89973,10.5978587754,83130,-1743,14756
872,DIGITAL RLTY TR INC,98.2598037544,1612979,106.389903446,1410303,112.949909217,936300,118.329249554,1444740,-202676,-474003
873,DIGITAL TURBINE INC,0.677281104967,90066,0.938633944209,87361,1.04129380756,30731,1.51581829739,20451,-2705,-56630
874,DIGITALGLOBE INC,28.6504009555,146525,32.7498953296,355879,33.3001942572,1092366,35.2499171791,1337223,209354,736487
875,DILLARDS INC,62.6887908972,416135,52.2400783909,486791,57.6883967046,260607,56.0710390033,501471,70656,-226184
876,DIME CMNTY BANCSHARES,20.0997458952,1075934,20.2991230755,673034,19.5957064569,198717,21.5042777327,185963,-402900,-474317
877,DINEEQUITY INC,77.012015416,44110,54.4203454448,43017,44.0391861341,66350,42.9794012041,74082,-1093,23333
878,DIODES INC,25.6829935052,57431,24.0569668976,93528,24.0315182278,353827,29.9293546285,426638,36097,260299
879,DIPLOMAT PHARMACY INC,12.6029413807,144014,15.9452908587,115520,14.7981593809,133868,20.7109373401,195404,-28494,18348
880,DIREXION SHS ETF TR,29.2422252949,2641933,25.5144115611,1194423,29.6312327378,1534057,25.1890787351,1244984,-1447510,339634
881,DISCOVER FINL SVCS,72.0904234907,2097685,68.3902643599,2231882,62.1901718998,2337990,64.4797481538,2167037,134197,106108
882,DISCOVERY COMMUNICATNS NEW,27.2371331701,4667525,28.8453865513,4097813,25.5923809564,3780422,20.7688492861,5039037,-569712,-317391
883,DISH NETWORK CORP,57.9298459064,4775345,63.4900900436,4375549,62.7591913475,2246651,54.2300803723,2788895,-399796,-2128898
884,DISNEY WALT CO,104.220036164,26984437,113.389994978,27014394,106.249977605,15907561,98.5700884192,8737813,29957,-11106833
885,DOCUMENT SEC SYS INC,0.666814847744,67485,1.2023927616,66534,0.785457809695,53472,0.820776159609,47516,-951,-13062
886,DOLBY LABORATORIES INC,45.1904578376,625309,52.4108207306,597224,48.9599631562,486377,57.5204627462,418199,-28085,-110847
887,DOLLAR GEN CORP NEW,74.0698639272,2172881,69.7297095617,1876130,72.0900942323,1618128,81.050105103,1556568,-296751,-258002
888,DOLLAR TREE INC,77.1799075617,1186954,78.4605040473,1262699,69.9202248226,1107362,86.819913774,1021966,75745,-155337
889,DOMINION DIAMOND CORP,9.68257728296,101316,12.6331589151,95938,12.5619465432,98472,14.179988656,1250001,-5378,2534
890,DOMINOS PIZZA INC,159.241086782,436150,184.30294236,328036,211.528144263,365332,198.549616573,1572136,-108114,37296
891,DOMTAR CORP,39.0285369474,681117,36.518654532,575651,38.4201762879,596978,43.3895636852,553912,-105466,21327
892,DONALDSON INC,42.0806924612,725297,45.5206460699,611327,45.5389936118,419838,45.9404689723,433757,-113970,-191489
893,DONNELLEY FINL SOLUTIONS INC,22.9799108655,369105,19.2910193624,308330,22.9560418739,168888,21.5634556173,95161,-60775,-139442
894,DONNELLEY R R & SONS CO,16.3200107895,1186335,12.1101441004,876125,12.5395924375,1069333,10.2994532595,897135,-310210,193208
895,DORIAN LPG LTD,8.1711734479,11871,10.5309819332,83468,8.1839335766,75636,6.8237291733,94230,71597,-7832
896,DORMAN PRODUCTS INC,73.0541584461,71974,82.1090328566,46353,82.7577010268,74990,71.62874699,96344,-25621,28637
897,DOUGLAS DYNAMICS INC,33.6694050286,16068,30.6316240887,16323,32.9489291598,9712,39.3908629442,9850,255,-6611
898,DOUGLAS EMMETT INC,36.5599189892,847294,38.4004128941,953271,38.2096061804,1353691,39.4198901813,1180673,105977,400420
899,DOVER CORP,74.9304865114,1325642,80.3501293888,1340533,80.2194888817,1682272,91.3902294253,1937450,14891,341739
900,DR PEPPER SNAPPLE GROUP INC,90.6694559805,1452209,97.9203854995,1273361,91.1104588404,1870389,88.4703121397,1903859,-178848,597028
901,DR REDDYS LABS LTD,45.2864815265,37053,40.1360148803,34408,42.1413276231,58375,35.6727823362,56794,-2645,23967
902,DRDGOLD LIMITED,5.29901589705,15852,4.90839704024,81493,3.14933402942,294983,3.8437664136,41886,65641,213490
903,DRIL-QUIP INC,60.049719516,1201138,54.5501316785,948522,48.7989245464,919426,44.1487690434,385107,-252616,-29096
904,DRIVE SHACK INC,3.76006016096,124998,4.14950794951,381973,3.15037493899,338055,3.60416666667,48000,256975,-43918
905,DSP GROUP INC,13.0435951914,74366,11.9993642721,62920,11.5926327194,55380,12.9978276611,110480,-11446,-7540
906,DST SYS INC DEL,107.151499215,714941,122.500508591,693091,61.6995410822,1326817,54.8802483117,596025,-21850,633726
907,DSW INC,22.6501543038,475361,20.6795049559,1126526,17.6990904827,360301,21.4792972423,470034,651165,-766225
908,DTE ENERGY CO,98.0432508563,1462630,102.10980376,1549528,105.790105893,2122051,107.360175209,2093048,86898,572523
909,DUCOMMUN INC DEL,25.5863539446,38927,28.7572401179,9841,31.5785604,27202,32.03789947,37362,-29086,17361
910,DUKE ENERGY CORP NEW,77.6202301076,3256651,82.0102258772,3513635,83.5901343528,4099802,83.9198161915,4221351,256984,586167
911,DUKE REALTY CORP,26.5599326998,5325390,26.2698967139,4683688,27.9500713563,5011472,28.8200117525,5580081,-641702,327784
912,DUN & BRADSTREET CORP DEL NE,121.320319019,257665,107.942156838,199505,108.152539544,197693,116.412188424,150766,-58160,-1812
913,DUNKIN BRANDS GROUP INC,52.4395545195,913261,54.6800739883,954205,55.1198161931,2335494,53.0798761335,3696561,40944,1381289
914,DURECT CORP,1.34530090598,47573,1.01874490628,14724,1.56151618184,39705,1.76345577042,66347,-32849,24981
915,DXP ENTERPRISES INC NEW,34.7422289613,52760,37.8635080128,54538,34.495363423,51978,31.4840097638,72513,1778,-2560
916,DYCOM INDS INC,80.2895381261,630107,92.9503110696,790659,89.5190981151,612495,85.8798810031,636319,160552,-178164
917,DYNAVAX TECHNOLOGIES CORP,3.95015118941,400491,5.94300443935,55864,9.65151072015,44449,21.500294901,545946,-344627,-11415
918,DYNEGY INC NEW DEL,6.49498222209,2332108,2.70990470168,863499,2.62790329316,833364,9.787862555,322951,-1468609,-30135
919,DYNEX CAP INC,6.81754642432,296881,7.09183145253,309088,7.1018060031,173477,7.27139543401,204775,12207,-135611
920,E TRADE FINANCIAL CORP,34.6499154041,4097124,34.8899747108,3146004,38.0299388964,5002322,43.6100625885,4378118,-951120,1856318
921,EAGLE BANCORP INC MD,60.9501567161,2778910,59.7001957357,1853009,63.2999351965,1793114,67.0501188162,1777536,-925901,-59895
922,EAGLE MATERIALS INC,98.5303263915,882713,97.1407605849,975749,92.4200957414,744297,106.700648718,913031,93036,-231452
923,EAGLE PHARMACEUTICALS INC,79.3560652823,40501,82.9411034976,137037,78.8883480784,104781,59.6445778757,82606,96536,-32256
924,EAST WEST BANCORP INC,50.8295528106,755407,51.6098804109,578397,58.5792044559,544357,59.7794171138,948487,-177010,-34040
925,EASTERLY GOVT PPTYS INC,20.0123411775,71306,19.7852261634,46095,20.9569991361,35883,20.6742020614,100415,-25211,-10212
926,EASTGROUP PPTY INC,73.8396966545,863438,73.5297133929,828835,83.8001153374,797660,88.1201367894,706195,-34603,-31175
927,EASTMAN CHEM CO,75.2095495646,1248392,80.7995387664,992122,83.9903535832,1515174,90.4898215025,1671956,-256270,523052
928,EATON CORP PLC,67.0901323308,3437823,74.1499309992,3038371,77.8300792559,2737335,76.7901303533,2649416,-399452,-301036
929,EATON VANCE CORP,41.8802622568,794336,44.9603802174,603865,47.3200804382,590764,49.3703747344,526186,-190471,-13101
930,EATON VANCE RISK MNGD DIV EQ,8.99773100696,12781,9.10089439824,12746,9.33429811867,13820,9.42938362338,14423,-35,1074
931,EATON VANCE TAX ADVT DIV INC,20.5577040505,14739,21.1077034097,11086,21.9006049468,13059,22.0974461148,11042,-3653,1973
932,EATON VANCE TAX MNGD GBL DV,8.04995486007,13292,8.52422212088,28507,9.17510354349,34768,9.36259456221,13351,15215,6261
933,EATON VANCE TX MNG BY WRT OP,14.8436083865,49651,15.1957746894,33891,15.2173913043,13800,15.2924758693,17198,-15760,-20091
934,EATON VANCE TXMGD GL BUYWR O,10.0704934542,14895,10.9377801685,11154,11.3860498476,11154,11.853655411,15607,-3741,0
935,EBAY INC,29.6899027363,10687034,33.5699181324,8226085,34.92004627,11719028,38.4599654331,12078612,-2460949,3492943
936,EBIX INC,57.052514557,109741,61.2414033761,68777,53.9057737525,103347,65.2512865256,123783,-40964,34570
937,ECHOSTAR CORP,51.3954342371,65356,56.9560172978,66367,60.7043040805,116285,57.2325490139,68807,1011,49918
938,ECLIPSE RES CORP,2.66360000338,118261,2.53867244356,147715,2.86075101157,155204,2.5038015035,163751,29454,7489
939,ECOLAB INC,117.218743967,761397,125.339837326,804429,132.749929791,975654,128.61110253,1003537,43032,171225
940,ECOPETROL S A,9.04991731723,1040120,9.319968882,777685,9.08878412468,329417,9.49009060109,327921,-262435,-448268
941,EDGEWELL PERS CARE CO,72.9903389588,370871,73.1392366873,331450,76.0203671138,783027,72.7709056172,515041,-39421,451577
942,EDISON INTL,71.9898009056,1452678,79.6101705638,1675502,78.1901272803,3309625,77.1693992404,2098876,222824,1634123
943,EDITAS MEDICINE INC,16.2423178227,29614,22.3096733123,34559,16.7785234899,273266,24.0086841809,338086,4945,238707
944,EDUCATION RLTY TR INC,42.2997587092,365534,40.851028218,262882,38.7499836233,534297,35.9306302341,561109,-102652,271415
945,EDWARDS LIFESCIENCES CORP,93.7004385598,2304589,94.0700823029,2619834,118.239709047,2651698,109.309750416,2145847,315245,31864
946,EGALET CORP,7.66938596063,20471,5.08677438659,20052,2.37335363779,123454,1.30039011704,22301,-419,103402
947,EHEALTH INC,10.6569078881,49733,12.0354481559,42541,18.8002608129,36808,23.8929381602,74499,-7192,-5733
948,EL PASO ELEC CO,46.4971881708,112738,50.4978982624,88974,51.7007105785,89786,55.2519160699,159180,-23764,812
949,EL POLLO LOCO HLDGS INC,12.2958220471,60915,11.9472047334,26366,13.8574366858,48133,12.1429533818,59376,-34549,21767
950,ELBIT SYS LTD,101.887749556,27599,113.618130766,9972,123.729046441,29112,147.073290703,32528,-17627,19140
951,ELDORADO GOLD CORP NEW,3.21959346097,2199346,3.40939822532,1919107,2.64002424104,9392338,2.19980402683,2911623,-280239,7473231
952,ELECTRO SCIENTIFIC INDS,5.92480879026,83547,6.96148868758,44818,8.23329438011,56478,13.9227796523,171302,-38729,11660
953,ELECTRONIC ARTS INC,78.7601456749,4412841,89.5199780257,4088417,105.720016811,4587504,118.060244292,4952768,-324424,499087
954,ELECTRONICS FOR IMAGING INC,43.8602716206,2466013,48.8302395152,2566893,47.3801129005,2582096,42.6800006286,1654522,100880,15203
955,ELLIE MAE INC,83.6801993879,117961,100.275106862,111593,109.9079275,138152,82.1249930858,126551,-6368,26559
956,ELLINGTON RESIDENTIAL MTG RE,13.0160051459,26429,14.674237896,33460,14.6417740713,42208,14.5139263823,31487,7031,8748
957,ELLIS PERRY INTL INC,24.9133834742,174043,21.4799109384,169321,19.4592855994,167889,23.6599891716,166230,-4722,-1432
958,EMBRAER S A,19.2500979256,599945,22.0799386102,667212,18.2300377255,965659,22.610136036,1039578,67267,298447
959,EMCOR GROUP INC,70.7601067843,1545546,62.9503592689,1570968,65.3798395921,1518878,69.3801121822,1185037,25422,-52090
960,EMCORE CORP,8.69412487925,22774,9.00171942955,39548,10.6582208758,36310,8.2036566972,27183,16774,-3238
961,EMERGE ENERGY SVCS LP,12.3104773544,1751110,13.8502724575,1200554,9.01051712217,412185,8.23960551207,126341,-550556,-788369
962,EMERGENT BIOSOLUTIONS INC,32.8400622434,554597,29.0360755869,130975,33.9092796976,171428,40.4463308302,208276,-423622,40453
963,EMERSON ELEC CO,55.7495588395,2390853,59.8600471658,3962192,59.6199205922,6835098,62.8400880028,6917511,1571339,2872906
964,EMPIRE ST RLTY TR INC,20.1901478617,966511,20.6400790445,815743,20.7700302026,984351,20.5403121407,1188054,-150768,168608
965,EMPLOYERS HOLDINGS INC,39.6066055536,59889,37.9493683235,41002,42.3071183405,26804,45.4463954864,83659,-18887,-14198
966,EMPRESA DIST Y COMERCIAL NOR,27.851484387,104016,34.8028506282,104819,31.9039311112,98013,39.7486682147,51247,803,-6806
967,ENABLE MIDSTREAM PARTNERS LP,15.7296955023,1253934,16.6897964342,1677492,15.9397070693,1987364,15.9798758864,2153834,423558,309872
968,ENANTA PHARMACEUTICALS INC,33.5037462507,82349,30.7941929974,58550,35.9839434197,83704,46.8019277682,84035,-23799,25154
969,ENBRIDGE ENERGY MANAGEMENT L,25.8997299572,525102,18.4181014579,75795,15.4067329579,83470,15.4615692713,327069,-449307,7675
970,ENBRIDGE ENERGY PARTNERS L P,25.4800536704,3137670,19.000105498,2293882,15.9999957386,3754626,15.9799359814,4531495,-843788,1460744
971,ENBRIDGE INC,42.120032601,4904151,41.8399623285,9220754,39.8100512851,8444174,41.8400731299,8071114,4316603,-776580
972,ENCANA CORP,11.7401419849,8665994,11.7100499163,7045999,8.79985405835,4774511,11.7800322783,1102289,-1619995,-2271488
973,ENCORE WIRE CORP,43.3359013867,41536,46.0125009413,26558,42.667724388,17648,44.7750816937,43149,-14978,-8910
974,ENDO INTL PLC,16.4700747967,2149292,11.1601600681,2098357,11.1697854708,2832015,8.56514244641,3606128,-50935,733658
975,ENDOCYTE INC,2.5527325024,83440,2.56624976363,37019,1.498860773,430994,1.42083296332,11261,-46421,393975
976,ENDOLOGIX INC,5.71678656418,73118,7.24162708775,285295,4.86030916348,493590,4.45899588763,530837,212177,208295
977,ENDURANCE INTL GROUP HLDGS I,9.29998404918,15378521,7.84997464971,15378521,8.35002273626,15378521,8.20000831029,15378521,0,0
978,ENEL AMERICAS S A,8.20957713996,1047557,10.3894822641,1277157,9.43000274644,1227041,10.2200405331,1244907,229600,-50116
979,ENEL GENERACION CHILE S A,19.4401049803,320060,22.2407282001,327822,22.6356941655,158334,26.3598118458,120752,7762,-169488
980,ENERGEN CORP,57.6702401505,773848,54.439892903,1214973,49.3705000973,1027800,54.6801735421,1261481,441125,-187173
981,ENERGIZER HLDGS INC NEW,44.6086088595,446842,55.7517553288,358195,48.0188165564,224058,46.0500514082,188686,-88647,-134137
982,ENERGOUS CORP,16.8600932103,43772,15.6037281391,28647,16.2589214152,26201,12.6621284702,71394,-15125,-2446
983,ENERGY FOCUS INC,4.24052243236,23582,3.30050860297,18482,2.63085776925,18245,2.72600481806,15774,-5100,-237
984,ENERGY RECOVERY INC,10.3424812883,22045,8.31865390065,359914,8.28926153126,593539,7.90057244524,700329,337869,233625
985,ENERGY TRANSFER EQUITY L P,19.3099785192,40730703,19.7300059877,35664865,17.959997946,36299336,17.3799854465,35899167,-5065838,634471
986,ENERPLUS CORP,9.48501105425,129362,8.05033639944,344085,8.11662124415,353349,9.87032185743,489751,214723,9264
987,ENERSYS,78.0992469001,197185,78.9407282178,237786,72.4501413786,292477,69.1704864705,405780,40601,54691
988,ENGILITY HLDGS INC NEW,33.6925730744,63189,28.9576097418,23897,28.4056625667,21545,34.6782402171,70736,-39292,-2352
989,ENI S P A,32.2405794104,280423,32.7295704805,311767,30.0602022009,366764,33.0694111155,389635,31344,54997
990,ENLINK MIDSTREAM LLC,19.0507873796,339671,19.4002245035,563911,17.598845518,713740,17.2493788553,862118,224240,149829
991,ENLINK MIDSTREAM PARTNERS LP,18.4191472864,389486,18.2996930559,453177,16.960063747,476885,16.7603981014,476361,63691,23708
992,ENNIS INC,17.3505962067,269789,16.9974985879,247860,19.1017052658,322589,19.650537272,296684,-21929,74729
993,ENOVA INTL INC,12.5546903967,134850,14.8509272933,168609,14.8479310001,410899,13.4487490763,615745,33759,242290
994,ENPRO INDS INC,67.3689175379,38163,71.1612903226,15500,71.407598802,17029,80.5318956144,88288,-22663,1529
995,ENSCO PLC,9.71992115873,2329237,8.94989417302,1899799,5.16015524917,6096522,5.97032324679,1441128,-429438,4196723
996,ENSIGN GROUP INC,22.2023861908,79541,18.807778132,34507,21.7766006642,23787,22.582075777,83429,-45034,-10720
997,ENSTAR GROUP LIMITED,197.698798261,449765,191.301760321,127704,198.649944328,129328,222.347691018,202795,-322061,1624
998,ENSYNC INC,0.722916451513,48415,0.598864223025,48425,0.355480868666,30944,0.501846076639,27897,10,-17481
999,ENTEGRIS INC,17.9001054283,4449471,23.3998121722,4347599,21.9500358662,3766782,28.8500881467,3556003,-101872,-580817
1000,ENTERCOM COMMUNICATIONS CORP,15.300156569,252285,14.3022580092,239193,10.3513778895,217942,11.4537029496,233287,-13092,-21251
1001,ENTERGY CORP NEW,73.4698708262,2298221,75.9596404127,2026879,76.7701908728,1916460,76.3599910617,1611040,-271342,-110419
1002,ENTERPRISE FINL SVCS CORP,42.9839688318,15657,42.3981803966,56276,40.7945276423,92684,42.331824319,25182,40619,36408
1003,ENTERPRISE PRODS PARTNERS L,27.0399897959,34135183,27.6099945891,37182079,27.0799879778,38681738,26.0699981182,45833375,3046896,1499659
1004,ENTRAVISION COMMUNICATIONS C,7.00567701413,41395,6.19017361182,48787,6.6045970323,34370,5.70179606576,94707,7392,-14417
1005,ENVESTNET INC,35.2495583494,145477,32.2996241057,65976,39.5985042315,25405,50.9988373322,75688,-79501,-40571
1006,ENVISION HEALTHCARE CORP,63.2900549218,1622672,61.320264795,1935233,62.6701683135,1783161,44.950237625,2498474,312561,-152072
1007,ENVIVA PARTNERS LP,26.8007148229,971989,28.099307447,1148071,27.5003801264,1203547,29.5502235042,1170448,176082,55476
1008,ENZO BIOCHEM INC,6.93939489741,126524,8.36683690101,119639,11.0408565028,206234,10.4751688017,142623,-6885,86595
1009,EOG RES INC,101.100160826,2965930,97.5503587869,2903813,90.5200103019,2702408,96.7401157158,3267662,-62117,-201405
1010,EP ENERGY CORP,6.54995280096,518019,4.74834513304,538714,3.65634106052,269395,3.26121689442,319206,20695,-269319
1011,EPAM SYS INC,64.3035956707,80291,75.5183463848,94242,84.0925111611,148955,87.9330069956,106638,13951,54713
1012,EPIZYME INC,12.1014574201,53382,17.1465941836,48931,15.0980141439,101669,19.051669901,225702,-4451,52738
1013,EPLUS INC,115.21009166,22038,135.067024129,18650,74.1073675884,27811,92.4451665313,43085,-3388,9161
1014,EPR PPTYS,71.769572744,615205,73.6294018391,600942,71.8691248006,773378,69.7407076255,681123,-14263,172436
1015,EQT CORP,65.3996998184,1714962,61.0998339556,1461657,58.5898776612,4114721,65.2399590027,3944653,-253305,2653064
1016,EQT GP HLDGS LP,25.2099585499,3683227,27.3801883037,3610019,30.1500004831,3208723,28.9601662176,3080300,-73208,-401296
1017,EQT MIDSTREAM PARTNERS LP,76.6800715243,4199970,76.8999794909,4003109,74.6298870606,3828426,74.969854809,3460751,-196861,-174683
1018,EQUIFAX INC,118.230052658,750689,136.740634834,678445,137.420028929,637418,105.989785448,688038,-72244,-41027
1019,EQUINIX INC,357.40931996,1442710,400.369968259,1446070,429.159747635,1566934,446.301611603,1335068,3360,120864
1020,EQUITY COMWLTH,30.2399444961,2294614,31.219734723,2227181,31.5999726735,1478419,30.3998743364,1400565,-67433,-748762
1021,EQUITY LIFESTYLE PPTYS INC,72.1000316003,389237,77.0603455968,369853,86.3391145392,493438,85.0799659129,1009180,-19384,123585
1022,EQUITY RESIDENTIAL,64.3600656322,6121995,62.2200088924,6088363,65.8299646576,5620161,65.9300716051,5477546,-33632,-468202
1023,ERA GROUP INC,16.9802889628,40282,13.2600513394,63499,9.45898161245,67872,11.1951057455,79767,23217,4373
1024,ERICSSON,5.82992004205,1259537,6.64013993297,1497860,7.17018581921,1809716,5.74972057433,2047056,238323,311856
1025,ERIE INDTY CO,112.478559177,23320,122.712594187,26941,125.071996314,34724,120.587852777,38445,3621,7783
1026,ERIN ENERGY CORP,3.04760383812,75141,2.39870838779,65035,1.45101161553,134389,2.74811867145,101524,-10106,69354
1027,EROS INTL PLC,13.0437015355,38946,10.3024059148,16501,11.4496862451,137209,14.2984529883,192888,-22445,120708
1028,ESCO TECHNOLOGIES INC,56.6402814424,45480,58.0822224712,17854,59.6826399305,12667,59.956227922,52088,-27626,-5187
1029,ESPERION THERAPEUTICS INC NE,12.5269364655,42229,35.3085661652,61883,46.2800116982,249611,50.1204186865,259096,19654,187728
1030,ESSENDANT INC,20.8983628775,138719,15.144485684,90528,14.8306156131,217523,13.1702379777,243048,-48191,126995
1031,ESSENT GROUP LTD,32.3707530021,597422,36.1709067189,183960,37.1385083714,183960,40.4979343336,183960,-413462,0
1032,ESSEX PPTY TR INC,232.501412212,272622,231.528907452,363920,257.271901929,394326,254.029948762,392871,91298,30406
1033,ESTERLINE TECHNOLOGIES CORP,89.2004570582,809525,86.0504544011,834615,94.8000230977,935158,90.1503958973,998365,25090,100543
1034,ETF MANAGERS TR,26.4412800774,301763,29.5184066308,300897,30.0209580273,105926,30.0988111063,107579,-866,-194971
1035,ETFIS SER TR I,18.4093939524,116245,23.188507481,114022,24.023916507,111722,29.1517994603,110422,-2223,-2300
1036,ETHAN ALLEN INTERIORS INC,36.8524291374,179961,30.6654302433,31273,32.2825995098,23666,32.3979033586,95963,-148688,-7607
1037,ETSY INC,11.7788769027,93812,10.6303229322,273463,15.0007261876,605904,16.8791664983,766981,179651,332441
1038,EURONAV NV ANTWERPEN,7.94960146173,992251,7.8997754791,1095221,7.89916133589,402068,8.10019070837,50863,102970,-693153
1039,EURONET WORLDWIDE INC,72.4301909453,246458,85.5191325298,279341,87.3734219742,253006,94.7881238559,350181,32883,-26335
1040,EVEREST RE GROUP LTD,216.399910334,669150,233.809307197,573771,254.590033893,762685,228.390044749,846508,-95379,188914
1041,EVERI HLDGS INC,2.17442033136,94278,4.79084273818,466515,7.28030338499,170872,7.59097729064,235938,372237,-295643
1042,EVERSOURCE ENERGY,55.2303047027,873343,58.780487579,1079661,60.7102714521,1298940,60.4403053806,1283382,206318,219279
1043,EVERTEC INC,17.7512835989,241898,15.8990309846,417950,17.2991829893,397302,15.8512886708,422994,176052,-20648
1044,EVOLENT HEALTH INC,14.7998669346,682371,22.2997066206,835437,25.3494858525,595160,17.7998670542,1170402,153066,-240277
1045,EVOLUTION PETROLEUM CORP,9.98251238706,13724,7.98292760038,12652,8.10054851248,27529,7.20844674423,33433,-1072,14877
1046,EXACT SCIENCES CORP,13.3600424629,608531,23.6202471675,966713,35.3702018748,1122131,47.1192678139,959756,358182,155418
1047,EXACTECH INC,27.2901043964,34005,25.2068711254,36617,29.7990011969,24229,32.9662670756,14348,2612,-12388
1048,EXCO RESOURCES INC,0.873679789616,1483381,0.617312387709,108535,2.64533894372,64642,1.35569033179,14015,-1374846,-43893
1049,EXELIXIS INC,14.9099952109,7283168,21.6700718698,6240450,24.6300164097,7059232,24.2300014354,14225546,-1042718,818782
1050,EXELON CORP,35.7438729412,5593630,36.2575301702,5305491,36.0700524757,5825747,37.6699119953,7396991,-288139,520256
1051,EXFO INC,4.40241771208,179674,5.19830359429,179674,4.70191574396,174397,4.00236242596,174397,0,-5277
1052,EXLSERVICE HOLDINGS INC,50.4412806803,77615,47.3612990528,90897,55.5831319061,92672,58.3210641214,157576,13282,1775
1053,EXONE CO,9.31286181727,15892,10.2165205782,17227,11.4155251142,7884,11.3763105064,8966,1335,-9343
1054,EXPEDIA INC DEL,113.27990487,2358044,126.170293641,2136216,148.950320884,1574243,143.940418467,1870781,-221828,-561973
1055,EXPEDITORS INTL WASH INC,52.9599987233,1629173,56.4899713762,1457179,56.4794916023,1810551,59.8599283979,2062231,-171994,353372
1056,EXPONENT INC,60.2929335532,52162,59.5401903451,34884,58.2994247229,57016,73.9063578356,82591,-17278,22132
1057,EXPRESS INC,10.7604181453,1091965,9.11033303563,379569,6.74985613196,879278,6.76088479991,890416,-712396,499709
1058,EXPRESS SCRIPTS HLDG CO,68.7899663089,2921836,65.9097794012,3083154,63.8402025796,2894665,63.3201538007,4777610,161318,-188489
1059,EXTENDED STAY AMER INC,16.1499907184,1842354,15.9401400246,2300168,19.3599159925,3382556,19.9998266086,3460380,457814,1082388
1060,EXTERRAN CORP,23.898101152,144614,31.4500499207,136216,26.6991607699,276563,31.6093966689,428322,-8398,140347
1061,EXTRA SPACE STORAGE INC,77.2390447842,751537,74.3901320173,828376,78.0000276723,1084115,79.9201686367,855804,76839,255739
1062,EXTRACTION OIL AND GAS INC,20.0421657625,148936,18.5481614662,436054,13.4501443939,1039171,15.3900835259,1181670,287118,603117
1063,EXTREME NETWORKS INC,5.0298102981,230625,7.5102264611,277222,9.21995249168,1593826,11.8899107548,2468143,46597,1316604
1064,EXXON MOBIL CORP,90.2600468077,17071119,82.0100117789,19670830,80.7300343168,23852139,81.9799564051,25755759,2599711,4181309
1065,EZCORP INC,10.647201534,188782,8.14955683424,204551,7.6989793737,327446,9.50321968818,150791,15769,122895
1066,F M C CORP,56.5601300308,1900473,69.5899287289,685832,73.0504396305,576848,89.3098782138,1101110,-1214641,-108984
1067,F5 NETWORKS INC,144.72123792,560747,142.570848197,1211040,127.060294107,1643212,120.560193696,1533541,650293,432172
1068,FABRINET,40.2971777658,125716,42.0251799404,85306,42.6677264352,83037,37.0600979171,117242,-40410,-2269
1069,FACEBOOK INC,115.050038141,13851234,142.049981198,15799101,150.979923213,16035185,170.869987309,17029076,1947867,236084
1070,FACTSET RESH SYS INC,163.430474722,569239,164.910753339,475536,166.178141875,439077,180.109869105,402843,-93703,-36459
1071,FAIR ISAAC CORP,119.219478932,240506,128.948377623,213822,139.412250576,230030,140.499969406,294178,-26684,16208
1072,FAIRMOUNT SANTROL HLDGS INC,11.7905309745,1098339,7.32989523642,4584513,3.90032809714,494061,4.78026732532,1190310,3486174,-4090452
1073,FANG HLDGS LTD,3.27999818108,10599701,3.2599682592,9500706,3.71003625692,10741674,4.04998112746,13297099,-1098995,1240968
1074,FASTENAL CO,46.9800284463,2062834,51.5000069488,2590388,43.5297823511,2733347,45.5800158392,3516585,527554,142959
1075,FATE THERAPEUTICS INC,2.49466865167,24853,4.54693758547,144053,3.2386490718,111775,3.96114905012,126226,119200,-32278
1076,FBL FINL GROUP INC,78.1361597577,35003,65.4476460531,47962,61.5037230182,74402,74.5037295807,91029,12959,26440
1077,FCB FINL HLDGS INC,47.696938463,133887,49.545929681,165503,47.7519379845,193500,48.3012689316,153909,31616,27997
1078,FEDERAL AGRIC MTG CORP,58.2649443384,80666,57.3202088149,77006,64.5234321938,83923,72.9495237121,127129,-3660,6917
1079,FEDERAL REALTY INVT TR,142.10972358,1951668,133.499831238,1943568,126.390049555,1605878,124.210448627,1463331,-8100,-337690
1080,FEDERAL SIGNAL CORP,15.6097001087,1672806,13.8100029278,2394279,17.3599541537,2517979,21.2798017304,2667882,721473,123700
1081,FEDERATED INVS INC PA,28.2805965065,845456,26.339934052,789106,28.2502704941,748630,29.7010120362,839298,-56350,-40476
1082,FEDEX CORP,186.200219524,1854015,195.149405586,1973119,217.329868637,1753689,225.579328142,1975478,119104,-219430
1083,FERRARI N V,58.1399712506,1225766,74.3612368206,580262,86.0138517516,213547,110.480395724,442531,-645504,-366715
1084,FERRELLGAS PARTNERS L.P.,6.7703985378,543838,6.00091917799,152310,4.58913950147,71691,5.14004103113,89688,-391528,-80619
1085,FERRO CORP,14.3309859155,142000,15.1869822261,158491,18.2886187427,465098,22.2996981733,343906,16491,306607
1086,FERROGLOBE PLC,10.8260860913,150747,10.3254591085,125515,11.9501424684,546437,13.1598347017,237389,-25232,420922
1087,FIAT CHRYSLER AUTOMOBILES N,9.12024474316,3054304,10.9298628803,2674233,10.6300274477,4790204,17.9100242104,8076706,-380071,2115971
1088,FIBRIA CELULOSE S A,9.61080959804,517022,9.13989901865,1159422,10.1595573732,1154381,13.5407945875,734595,642400,-5041
1089,FIBROGEN INC,21.4008535181,206674,24.6520782217,300786,32.3002041744,413372,53.8006071806,663394,94112,112586
1090,FIDELITY,30.6562167383,811744,33.4235482364,605591,33.7974148972,722215,34.178930642,692883,-206153,116624
1091,FIDELITY & GTY LIFE,23.6999152351,350381,27.7992063541,324074,31.0507546558,83283,31.0532808925,94837,-26307,-240791
1092,FIDELITY NATIONAL FINANCIAL,32.5938673677,653129,37.5153160244,894488,36.5519694252,795689,43.2571505175,1163692,241359,-98799
1093,FIDELITY NATL INFORMATION SV,75.6401163203,5075640,79.6199905095,3279076,85.400007181,3119344,93.38981963,2539613,-1796564,-159732
1094,FIDELITY SOUTHERN CORP NEW,23.6706751666,55216,22.389425056,43726,22.8584361209,88370,23.648684702,93705,-11490,44644
1095,FIESTA RESTAURANT GROUP INC,29.8512557497,117181,24.1952150068,62905,20.6626954579,26860,18.9956413683,80071,-54276,-36045
1096,FIFTH STREET FINANCE CORP,5.37017546887,927344,4.63606861382,30198,4.87123464307,27919,5.43003975565,10313,-897146,-2279
1097,FIFTH THIRD BANCORP,26.970005177,10100443,25.4001162038,8299214,25.9599874845,6999310,27.9800674725,15891813,-1801229,-1299904
1098,FINANCIAL ENGINES INC,36.7463284655,96826,43.5478980228,128617,36.598803652,114348,34.7507325517,250153,31791,-14269
1099,FINANCIAL INSTNS INC,34.2052313883,18389,32.9510579874,30955,29.7788595992,19309,28.8174310315,17073,12566,-11646
1100,FINISAR CORP,30.269554364,327689,27.341544676,503044,25.9795901743,1608147,22.1701628348,1466701,175355,1105103
1101,FINISH LINE INC,18.8098147456,580229,14.2288688082,775536,14.1695607624,586539,12.0318884735,264547,195307,-188997
1102,FIREEYE INC,11.9000586679,2108477,12.610018561,6913947,15.2099121517,6365520,16.7698575573,6664994,4805470,-548427
1103,FIRST AMERN FINL CORP,36.6294878564,1515200,39.279885964,1356063,44.690134995,1129153,49.9692883882,1136378,-159137,-226910
1104,FIRST BANCORP N C,27.1100529913,13021,29.286222433,8434,31.239359891,11748,34.3600691268,9837,-4587,3314
1105,FIRST BANCORP P R,6.61078863682,845890,5.64957052114,807141,5.78969417679,1193500,5.11965334167,949869,-38749,386359
1106,FIRST BUSEY CORP,30.7818798003,49867,29.3992968107,40103,29.3176776843,218196,31.3604154868,361985,-9764,178093
1107,FIRST COMWLTH FINL CORP PA,14.1806316022,271215,13.2635486383,254306,12.6769119783,210698,14.1281184163,329414,-16909,-43608
1108,FIRST CTZNS BANCSHARES INC N,354.982586913,16367,335.356474745,24055,372.697620875,31272,373.889532638,49191,7688,7217
1109,FIRST DATA CORP NEW,14.1897391874,2879616,15.4998556463,4184168,18.1999366439,5284414,18.039930521,3063371,1304552,1100246
1110,FIRST DEFIANCE FINL CORP,50.7633230308,10677,49.5457016386,12877,52.6781405823,24868,52.4854668407,42145,2200,11991
1111,FIRST FINANCIAL NORTHWEST IN,19.7475202885,11090,17.6706164072,24221,16.1095988219,22409,16.9622663969,16802,13131,-1812
1112,FIRST FINL BANCORP OH,28.4488992607,377519,27.4476184428,283449,27.6991165742,289215,26.1495821499,379203,-94070,5766
1113,FIRST FINL BANKSHARES,45.1998002839,1604277,40.1001569125,1497650,44.1996557188,1459853,45.2003612484,1534678,-106627,-37797
1114,FIRST FINL CORP IND,52.8227637354,19821,47.5154646183,14711,47.3035439137,12980,47.6207500626,27971,-5110,-1731
1115,FIRST FNDTN INC,28.5212219519,7398,15.5231662519,33756,16.4163722026,27168,17.8857983418,59824,26358,-6588
1116,FIRST HAWAIIAN INC,34.8153730219,33175,29.9247606019,169592,30.6203983791,70084,30.28486613,105102,136417,-99508
1117,FIRST HORIZON NATL CORP,20.0099108816,2641541,18.5003544307,2044123,17.4201257913,4862020,19.1499787641,3950866,-597418,2817897
1118,FIRST INDUSTRIAL REALTY TRUS,28.0499587328,1022604,26.6311173911,713376,28.6206547076,740025,30.0903409804,1043491,-309228,26649
1119,FIRST INTST BANCSYSTEM INC,42.5413910686,48682,39.6514622359,28347,37.1923850797,64610,38.2454232373,88272,-20335,36263
1120,FIRST LONG IS CORP,28.5489205042,641040,27.0495511584,629955,28.6002628234,741182,30.4503476042,721798,-11085,111227
1121,FIRST MAJESTIC SILVER CORP,7.62993220618,279819,8.11885897621,214439,8.31393821663,163701,6.83976165882,171351,-65380,-50738
1122,FIRST MERCHANTS CORP,37.6504289532,1693075,39.3200145861,1697507,40.1398991835,1633462,42.9296133429,1655058,4432,-64045
1123,FIRST MIDWEST BANCORP DEL,25.2303469278,2490374,23.6802895093,2181899,23.309961261,2404294,23.4201772279,2670347,-308475,222395
1124,FIRST POTOMAC RLTY TR,10.971149939,123050,10.2801234409,201554,11.110247844,476227,11.1410316152,446368,78504,274673
1125,FIRST REP BK SAN FRANCISCO C,92.1398954517,2834288,93.8099797736,1858960,100.099995349,1806084,104.460034104,1825569,-975328,-52876
1126,FIRST SOLAR INC,32.0902023524,905697,27.0997451996,932887,39.8803512792,913006,45.8798709357,725220,27190,-19881
1127,FIRST SOUTH BANCORP INC VA,11.9578435347,19736,12.1335896204,16648,16.5426683295,69759,18.5278078933,61799,-3088,53111
1128,FIRST TR EXCH TRD ALPHA FD I,23.2163645435,30065,23.5648911176,28517,33.5593589093,55156,30.0515697704,59531,-1548,26639
1129,FIRST TR EXCHANG TRADED FD I,51.1889553778,44619,51.7852649878,43719,52.7829068847,37910,53.248195447,18010,-900,-5809
1130,FIRST TR EXCHANGE TRADED FD,35.6444296633,2633988,37.160484336,2601500,36.973692857,3423975,41.7978488496,2948190,-32488,822475
1131,FIRST TR EXCNGE TRD ALPHADEX,31.007751938,39345,31.7589797972,36777,32.2093462287,34431,33.9339614013,32799,-2568,-2346
1132,FIRST TR LRG CP GRWTH ALPHAD,49.0393488421,434549,52.6407838932,434549,54.944321584,434549,57.4595730286,434549,0,0
1133,FIRST TR MULTI CAP VALUE ALP,52.2663516905,6773,56.2793121417,5757,58.36373111,5757,61.5544041451,4825,-1016,0
1134,FIRST TR MULTI CP VAL ALPHA,50.4789328319,34034,51.9051819812,35141,52.3155612387,35974,53.6758677234,36590,1107,833
1135,FIRST TR NAS100 EQ WEIGHTED,46.2076896155,100005,51.5948405159,50005,53.4746525347,50005,55.5388892222,50001,-50000,0
1136,FIRST TR NASDAQ100 TECH INDE,52.6596187464,300325,60.1492544734,201133,62.4051534578,32289,68.1524978869,44958,-99192,-168844
1137,FIRST TR SML CP CORE ALPHA F,53.875476493,11805,54.4395031437,6521,55.5271674331,5871,58.9337421223,5871,-5284,-650
1138,FIRSTCASH INC,47.00001524,131234,49.1505742528,102481,58.2974880813,102989,63.150880238,193584,-28753,508
1139,FIRSTENERGY CORP,30.9699245436,8458658,31.81992163,6907748,29.1599763712,6126411,30.8299955371,9776161,-1550910,-781337
1140,FIRSTSERVICE CORP NEW,47.4780111291,33426,60.293040293,27300,64.0012397335,38718,65.7159087512,33447,-6126,11418
1141,FISERV INC,106.279859116,1344648,115.309880542,1884097,122.340449645,1985345,128.960394259,1806733,539449,101248
1142,FITBIT INC,7.3201310866,1032905,5.91988125394,573998,5.31006735657,1483597,6.95995115521,927018,-458907,909599
1143,FIVE BELOW INC,39.9602122829,2284122,43.3101210398,2000664,49.3702824756,1680039,54.8802460114,1393106,-283458,-320625
1144,FIVE PRIME THERAPEUTICS INC,50.1063841638,89769,36.1488443958,217462,30.1116177311,206598,40.9025444071,62490,127693,-10864
1145,FIVE9 INC,14.1870427416,83104,16.4621963905,121126,21.5204519868,191864,23.9025229076,203535,38022,70738
1146,FLAGSTAR BANCORP INC,26.9443027408,64689,28.2,25000,30.8212682557,31634,35.4872523162,59148,-39689,6634
1147,FLEETCOR TECHNOLOGIES INC,141.519492123,1401284,151.430271398,914302,144.20784346,340564,154.769869453,641223,-486982,-573738
1148,FLEX LTD,14.3700741668,7317290,16.799981772,10226023,16.3100430476,11364409,16.5700607894,11755841,2908733,1138386
1149,FLEXION THERAPEUTICS INC,19.0281821183,33319,26.8975681651,65136,20.2111846804,51803,24.1736556487,56756,31817,-13333
1150,FLEXSHARES TR,39.4683110095,48976,39.2947459635,56547,41.0882288317,50063,56.2098501071,3736,7571,-6484
1151,FLEXSTEEL INDS INC,61.6690693577,6243,50.3875968992,6450,54.079547241,6361,50.6695069994,6572,207,-89
1152,FLIR SYS INC,36.1897251953,311967,36.2815010271,479032,34.6601965071,1040675,38.9104924187,869971,167065,561643
1153,FLOTEK INDS INC DEL,9.38927254375,200122,12.7881788299,224817,8.93772059661,140528,4.64875128305,285453,24695,-84289
1154,FLOWERS FOODS INC,19.9708569929,785094,19.4100665535,1206848,17.3089291341,695017,18.8100382079,775756,421754,-511831
1155,FLOWSERVE CORP,48.0500149472,963392,48.4193691059,1177979,46.4299817519,1202865,42.5898459783,1051800,214587,24886
1156,FLUIDIGM CORP DEL,7.27692117584,145666,5.68718418894,145063,4.03863883423,145346,5.03824823984,216742,-603,283
1157,FLUOR CORP NEW,52.5200186939,1598381,52.6200135626,1692892,45.7798832544,1943714,42.100433878,1730671,94511,250822
1158,FLUSHING FINL CORP,29.3898218856,1171494,26.8707794056,1170007,28.1899697777,1160732,29.7202133679,1159312,-1487,-9275
1159,FNB CORP PA,16.0303479627,2252540,14.8698870421,2592824,14.1598557737,4018685,14.0299277427,2310632,340284,1425861
1160,FOAMIX PHARMACEUTICALS LTD,11.1145703611,32120,4.94693954263,148981,4.64048146975,126280,5.54864632163,125436,116861,-22701
1161,FOMENTO ECONOMICO MEXICANO S,76.2107882721,469343,88.5194009458,471343,98.3390559488,637529,95.5298158305,570670,2000,166186
1162,FOOT LOCKER INC,70.890195138,2151708,74.8097270404,2308657,49.2798112097,2535724,35.2199340895,2532827,156949,227067
1163,FORD MTR CO DEL,12.1300540766,13316676,11.6399700412,17458636,11.1900115608,17632064,11.9700146062,20337235,4141960,173428
1164,FORESIGHT ENERGY LP,6.48488755736,26369,6.30028108946,10317,4.89396411093,19003,4.21237791048,21603,-16052,8686
1165,FOREST CITY RLTY TR INC,20.8392939315,1758073,21.7802166808,1765639,24.170440479,1570472,25.5098437332,1458339,7566,-195167
1166,FORESTAR GROUP INC,13.303647256,217835,13.648908886,225366,17.1502490908,368741,17.1972296535,174563,7531,143375
1167,FORM HLDGS CORP,2.14621059691,14910,2.14621059691,14910,1.65289256198,16335,1.4245014245,13338,0,1425
1168,FORMFACTOR INC,11.2104226632,46207,11.8443316413,48462,12.3993409183,204527,16.8498933674,411694,2255,156065
1169,FORRESTER RESH INC,42.946240129,42169,39.7674352968,35431,39.1455402291,29071,41.8683292825,47315,-6738,-6360
1170,FORTERRA INC,21.6616084977,52720,19.501097656,225936,8.23116844045,425456,4.5011515592,114193,173216,199520
1171,FORTINET INC,30.1199091123,1009598,38.3502429905,558458,37.4417640315,532961,35.8406399016,578589,-451140,-25497
1172,FORTIS INC,30.8790571128,963339,33.1604308687,857709,35.1500800891,1076925,35.7694070724,1058055,-105630,219216
1173,FORTIVE CORP,53.6298848972,3169949,60.2200987746,2957036,63.3500516145,2849974,70.7901243867,2761388,-212913,-107062
1174,FORTRESS INVESTMENT GROUP LL,4.85996705107,1007620,7.94998888581,9802781,7.98999652556,9903759,7.97001327866,6392963,8795161,100978
1175,FORTUNA SILVER MINES INC,5.64893232976,590023,5.1983339818,156781,4.8908696149,656325,4.38145459138,387999,-433242,499544
1176,FORTUNE BRANDS HOME & SEC IN,53.460104475,2672217,60.849733658,2296296,65.2400724164,1929397,67.2297712442,1855428,-375921,-366899
1177,FORUM ENERGY TECHNOLOGIES IN,22.0069395074,94243,20.7014324774,110089,15.6040897168,186810,15.8997799673,299501,15846,76721
1178,FORWARD AIR CORP,47.38032327,803477,47.5688411632,589945,53.2798977628,552441,57.2286856241,549934,-213532,-37504
1179,FOSSIL GROUP INC,25.8599978419,1677417,17.4498449009,312381,10.3501326162,544051,9.32922338307,659862,-1365036,231670
1180,FOUNDATION MEDICINE INC,17.6943699732,50355,32.2602431337,44420,39.7367440705,40265,40.213034941,37177,-5935,-4155
1181,FOUR CORNERS PPTY TR INC,20.5207740957,290145,22.830059316,317958,25.1084482507,322043,24.9207091622,585818,27813,4085
1182,FOX FACTORY HLDG CORP,27.7499205049,81766,28.6978545594,101471,35.588661287,38664,43.103666512,118505,19705,-62807
1183,FRANCESCAS HLDGS CORP,18.0290036546,274724,15.3518233747,271173,10.9386273186,300769,7.35961492679,537664,-3551,29596
1184,FRANCO NEVADA CORP,59.7589161896,562460,65.5128009624,354114,72.161188859,241307,77.479925605,179582,-208346,-112807
1185,FRANKLIN COVEY CO,20.1557762055,33638,20.1915070774,33628,19.3133720019,31895,20.2904187735,30852,-10,-1733
1186,FRANKLIN ELEC INC,38.907961419,42819,43.0249439092,15154,41.392639519,37253,44.8474005792,65957,-27665,22099
1187,FRANKLIN RES INC,39.5800959772,3356005,42.1400917779,3130819,44.7900527922,3294995,44.5100349866,4094425,-225186,164176
1188,FRANKLIN STREET PPTYS CORP,12.9577577899,249040,12.1415200687,193386,11.0789664015,121672,10.6203707332,229653,-55654,-71714
1189,FRANKS INTL N V,12.3040769725,45107,10.5628188776,125440,8.2889304492,283390,7.72750381291,29505,80333,157950
1190,FREDS INC,18.5596560373,167460,13.0990885458,346589,9.22962345619,451156,6.44015056462,498125,179129,104567
1191,FREEPORT-MCMORAN INC,13.1899571521,12503983,13.3600984829,9817742,12.0100002722,10213322,14.0400278323,8703544,-2686241,395580
1192,FRESENIUS MED CARE AG&CO KGA,42.2095269409,194648,42.1316239568,204051,48.3309727395,228756,48.8941952357,228657,9403,24705
1193,FRESH DEL MONTE PRODUCE INC,60.6297382437,202211,59.2312920736,214802,50.9092953313,177885,45.4602712024,293729,12591,-36917
1194,FRONTIER COMMUNICATIONS CORP,3.7050346668,12850622,2.52640452389,7520965,1.1882833975,13104618,11.8867124142,1001875,-5329657,5583653
1195,FRONTLINE LTD,7.10899358307,212407,6.73674232807,118158,5.72684918599,95515,6.03786857377,136472,-94249,-22643
1196,FS INVT CORP,10.2973318724,174317,9.80175592954,267095,9.15051907132,258346,8.4506731284,181169,92778,-8749
1197,FTD COS INC,23.8357584989,185142,20.1378159751,170227,20.001100257,127243,13.0409473584,115099,-14915,-42984
1198,FTI CONSULTING INC,45.0787662255,370019,41.1702737882,362616,34.9602946456,398309,35.4790069568,346853,-7403,35693
1199,FUELCELL ENERGY INC,1.74842347209,101806,1.37799887004,72569,1.23948072281,137961,1.72458394412,11597,-29237,65392
1200,FULLER H B CO,48.3076192737,210650,51.5684371556,60793,51.1087599594,46313,58.0604287029,132586,-149857,-14480
1201,FULTON FINL CORP PA,18.7996045923,1014649,17.8499147078,830088,19.0001968609,640046,18.7501473385,805967,-184561,-190042
1202,FUTUREFUEL CORPORATION,13.9081232936,50546,14.1823739175,49075,15.0830002626,68554,15.7453390865,122830,-1471,19479
1203,G-III APPAREL GROUP LTD,29.5597005456,197025,21.8865196964,69175,24.9340823111,34892,29.0227424113,115599,-127850,-34283
1204,GAIN CAP HLDGS INC,6.58597365611,39326,8.32762635255,73010,6.22250157134,47730,6.39770565039,36263,33684,-25280
1205,GALAPAGOS NV,64.1908227407,244038,86.1907653107,200938,76.5235713968,202173,101.745145952,121136,-43100,1235
1206,GALECTIN THERAPEUTICS INC,0.977517106549,15345,2.30268838869,17371,2.45556594949,17104,2.1353833013,14049,2026,-267
1207,GALENA BIOPHARMA INC,1.89016066366,9523,0.611917918919,214081,0.577490045895,131604,0.354849318862,115542,204558,-82477
1208,GALLAGHER ARTHUR J & CO,51.9603399495,1840038,56.5398321301,1866684,57.2514294597,1067886,61.5501228369,1564676,26646,-798798
1209,GAMCO INVESTORS INC,30.9167728523,14911,29.5626157572,14038,29.6171927468,14890,29.7773528207,14642,-873,852
1210,GAMESTOP CORP NEW,25.260006212,2591765,22.5499157777,1607057,21.609712047,1472810,20.660291688,2029497,-984708,-134247
1211,GAMING & LEISURE PPTYS INC,30.620151853,4380024,33.4200242615,4244581,37.6699933371,6978950,36.8900252094,6764132,-135443,2734369
1212,GANNETT CO INC,9.71148858639,688257,8.38042387124,620613,8.71946867496,568842,9.00043614448,1034061,-67644,-51771
1213,GAP INC DEL,22.4402279796,2230726,24.2899113992,3034058,21.9900435851,2420550,29.5298749858,2118160,803332,-613508
1214,GARMIN LTD,48.4902261112,1148417,51.1101474633,1192229,51.0298311838,1322207,53.9701180324,1089955,43812,129978
1215,GARTNER INC,101.06967434,903733,107.99128564,661896,123.509935624,716412,124.409794775,987792,-241837,54516
1216,GASLOG LTD,16.0421545667,8540,15.3493140653,102415,15.2482681218,103356,17.4502712477,88480,93875,941
1217,GASLOG PARTNERS LP,20.5513235052,36494,24.5012392832,73833,22.6590048322,15314,23.2422671404,17167,37339,-58519
1218,GATX CORP,61.5779577668,138280,60.9591970215,159008,64.2707666434,209302,61.5608064844,320155,20728,50294
1219,GAZIT GLOBE LTD,8.63985045536,350932,10.4844251946,62569,9.78233779181,48148,9.56554717458,23731,-288363,-14421
1220,GCP APPLIED TECHNOLOGIES INC,26.7492403545,267559,32.650325137,234209,30.4975653439,357340,30.7001369719,75928,-33350,123131
1221,GENCOR INDS INC,15.6824307768,12243,14.9253731343,14338,16.2354134957,13797,17.6598356785,10589,2095,-541
1222,GENER8 MARITIME INC,4.48021565161,1197487,5.67706153202,38224,5.6943423953,32664,4.51536833079,74634,-1159263,-5560
1223,GENERAC HLDGS INC,40.7505783566,58355,37.2802014415,118347,36.1291773437,168977,45.9289970957,192471,59992,50630
1224,GENERAL CABLE CORP DEL NEW,19.0499499135,351392,17.9487438234,297291,16.3466643072,135624,18.8479344362,242573,-54101,-161667
1225,GENERAL COMMUNICATION INC,19.452008741,148725,20.7976551179,121456,36.6393310822,310950,40.7885728801,322811,-27269,189494
1226,GENERAL DYNAMICS CORP,172.660055469,1161363,187.199375348,1390854,198.099731586,1661239,205.579964452,1764384,229491,270385
1227,GENERAL ELECTRIC CO,31.6000106577,38244639,29.799982646,45511201,27.0100055112,45376592,24.1799672413,53548501,7266562,-134609
1228,GENERAL FIN CORP DEL,5.54807748581,85435,5.097242855,73373,5.147747025,14958,5.07800550627,16345,-12062,-58415
1229,GENERAL MLS INC,61.7696591818,3094788,59.0100733517,2789439,55.3995048518,2473199,51.7599461555,3500448,-305349,-316240
1230,GENERAL MOLY INC,0.251144100904,107508,0.502102554447,95598,0.374255616586,90847,0.367376928729,29942,-11910,-4751
1231,GENERAL MTRS CO,34.8400459559,32273551,35.3599672539,30151951,34.9299323546,16546296,40.3800005032,23650495,-2121600,-13605655
1232,GENESCO INC,62.1073579335,76883,55.4603769074,50198,33.9024957822,68756,26.6028994171,66910,-26685,18558
1233,GENESEE & WYO INC,69.4090683011,697661,67.860894401,606417,68.3896089676,584504,74.0102566291,562368,-91244,-21913
1234,GENESIS ENERGY L P,36.0197637079,3177339,32.420166975,3277497,31.7300472756,3271032,26.3496128586,2508386,100158,-6465
1235,GENESIS HEALTHCARE INC,4.2407322331,28297,2.63583327476,85362,1.74369840639,90612,1.14774624374,28752,57065,5250
1236,GENMARK DIAGNOSTICS INC,12.212575136,10481,12.8129401608,66027,11.8308878965,68972,9.62800875274,82260,55546,2945
1237,GENOMIC HEALTH INC,29.3900471727,212623,31.4880563717,294048,32.5507138504,370806,32.0885102144,449756,81425,76758
1238,GENPACT LIMITED,24.339691869,1436337,24.7598939863,1383972,27.8302174804,1605018,28.7501160143,1820897,-52365,221046
1239,GENTEX CORP,19.6901974386,3056140,21.3298038889,2925484,18.9696738993,2143632,19.8001892673,2648106,-130656,-781852
1240,GENTHERM INC,33.8462088315,55959,39.2506019262,39872,38.7879749346,12607,37.1418251866,49836,-16087,-27265
1241,GENUINE PARTS CO,95.5398768895,940131,92.4093151944,844298,92.7608380004,891885,95.6497269297,732046,-95833,47587
1242,GENWORTH FINL INC,3.81006994318,2901784,4.11990571057,1902228,3.77015306204,1555905,3.85011036142,3170039,-999556,-346323
1243,GEO GROUP INC NEW,35.9279113328,386524,46.3691576446,246155,29.5700774795,552146,26.9000683341,500482,-140369,305991
1244,GERDAU S A,3.14015171738,412082,3.44972069663,532217,3.04979320092,1393865,3.43015611841,4621364,120135,861648
1245,GERMAN AMERN BANCORP INC,52.7009222661,4554,47.4281897128,4491,34.0393343419,9254,37.9657425393,5663,-63,4763
1246,GERON CORP,2.07108872096,214380,2.27312467215,177289,2.77160964066,123394,2.17920885604,120686,-37091,-53895
1247,GETTY RLTY CORP NEW,25.4900608589,116006,25.2589453861,84960,25.10303853,101661,28.6082555252,95427,-31046,16701
1248,GIBRALTAR INDS INC,41.650232363,1153583,41.1996719647,1331564,35.6495947278,1337126,31.1504538106,1374362,177981,5562
1249,GIGAMON INC,45.5475092347,191668,35.5437035276,134623,39.3523080244,213126,42.1517484149,188628,-57045,78503
1250,GILDAN ACTIVEWEAR INC,25.3695285899,1108101,27.0402418064,674920,30.7313317937,357225,31.2802467429,354377,-433181,-317695
1251,GILEAD SCIENCES INC,71.6101220468,7680660,67.9199502801,9053923,70.7800841454,9848194,81.0200349747,11265300,1373263,794271
1252,GLACIER BANCORP INC NEW,36.2295961348,2156883,33.9300137021,1937665,36.6106022793,1937772,37.7601945592,2004942,-219218,107
1253,GLADSTONE COML CORP,20.1144856098,12578,20.6850533808,13488,21.8071489523,21094,22.2886534488,22747,910,7606
1254,GLATFELTER,23.8925389979,99236,21.7394142762,76589,19.5494422181,36932,19.4490784066,98308,-22647,-39657
1255,GLAUKOS CORP,34.2961864037,11459,51.2915493653,40494,41.4787774676,55884,32.9967100055,113678,29035,15390
1256,GLAXOSMITHKLINE PLC,38.5099489386,3316987,42.1599557042,3256289,43.1200255106,2794131,40.6001057692,2569747,-60698,-462158
1257,GLOBAL BLOOD THERAPEUTICS IN,14.4514501892,39650,36.8469096299,101881,27.351363947,317571,31.0503343408,275617,62231,215690
1258,GLOBAL BRASS & COPPR HLDGS I,34.3018439542,32593,34.3688719166,9689,30.5673424485,25452,33.7848357465,25692,-22904,15763
1259,GLOBAL EAGLE ENTMT INC,6.45873585426,18115,3.1885898759,75582,3.55855168121,85147,3.41774833949,108551,57467,9565
1260,GLOBAL NET LEASE INC,7.82710619872,103231,24.0801170249,275497,22.240331556,214745,21.8911157553,199533,172266,-60752
1261,GLOBAL PARTNERS LP,19.4496903746,721194,19.4999684324,791950,18.0502077544,951845,17.4000584342,944652,70756,159895
1262,GLOBAL PMTS INC,69.4100971803,2385359,80.6799791241,2657611,90.3199839002,2484500,95.029840338,2414852,272252,-173111
1263,GLOBAL X FDS,17.5430519524,434417,23.9451125314,330130,19.2398357672,655411,21.7862828691,748728,-104287,325281
1264,GLOBALSTAR INC,1.57988040673,653214,1.60004444425,3888017,2.13013729419,4760726,1.63005645793,4957497,3234803,872709
1265,GLOBANT S A,33.3300752615,20462,36.4139734297,52013,43.4405940594,137360,40.0654721381,69037,31551,85347
1266,GLOBUS MED INC,24.8101398418,190930,29.617638341,131577,33.1446805949,166090,29.7234284023,324256,-59353,34513
1267,GLOWPOINT INC,0.263683278713,53094,0.294879625924,47477,0.274400540358,47376,0.2348047766,29812,-5617,-101
1268,GLU MOBILE INC,1.93798449612,21156,2.26457822231,47691,2.49899675313,54822,3.76197929538,72834,26535,7131
1269,GMS INC,29.2883950254,27178,35.0509893969,29614,28.0994645074,107938,35.4005506752,144913,2436,78324
1270,GNC HLDGS INC,11.0416811083,201962,7.36048068445,153115,8.42820265753,336252,8.84233881493,122592,-48847,183137
1271,GODADDY INC,34.949954778,1395338,37.8998476322,3821018,42.4202216903,3382467,43.5100636027,3966025,2425680,-438551
1272,GOGO INC,9.22612689596,74896,10.9983406012,25913,11.5311234744,274648,11.808675988,306893,-48983,248735
1273,GOLAR LNG LTD BERMUDA,22.9401395458,3360616,27.9301182121,3673060,22.2499630889,6400505,22.6100428823,5849038,312444,2727445
1274,GOLAR LNG PARTNERS LP,24.0395575463,622890,22.3406101933,466639,20.0696775911,916507,23.2298624917,964233,-156251,449868
1275,GOLD FIELDS LTD NEW,3.01002136965,4126881,3.5300679645,2829124,3.47973534164,2317705,4.30956840202,2947859,-1297757,-511419
1276,GOLD RESOURCE CORP,4.35356412856,124266,4.51306413302,58940,4.07678189969,132948,3.73844034892,15247,-65326,74008
1277,GOLDCORP INC NEW,13.6000016761,5250367,14.5898718051,5428766,12.9101392957,4485854,12.9601661159,2380988,178399,-942912
1278,GOLDEN MINERALS CO,0.58025751073,291250,0.631625667901,234316,0.563278493389,188184,0.478581232392,332232,-56934,-46132
1279,GOLDEN OCEAN GROUP LTD,4.70790452305,185008,7.64610295398,68924,6.71867963339,82159,7.83954891681,40436,-116084,13235
1280,GOLDEN STAR RES LTD CDA,0.745089184918,221450,0.846549507072,279960,0.650298261799,2079046,0.7691860644,292517,58510,1799086
1281,GOLDMAN SACHS BDC INC,23.5199200204,6483653,24.6399676232,6483653,22.5200207352,6483653,22.8200059442,6483653,0,0
1282,GOLDMAN SACHS ETF TR,28.0403147006,16893391,32.0388398147,17168568,34.7237414448,26996630,37.4409618661,27934699,275177,9828062
1283,GOLDMAN SACHS GROUP INC,23.1161702676,54291,21.7473509747,124291,20.3045946544,194291,21.5263269091,170396,70000,70000
1284,GOLDMAN SACHS MLP ENERGY REN,7.21594605785,16907,8.10315254037,16907,7.21594605785,16907,6.97935766251,16907,0,0
1285,GOLUB CAP BDC INC,18.3902686543,656271,19.8804230717,658990,19.1207563961,687682,18.819300259,684882,2719,28692
1286,GOODYEAR TIRE & RUBR CO,30.8703431916,2194663,35.9998463873,2551872,34.959933172,2637219,33.250469052,2125564,357209,85347
1287,GOPRO INC,8.70853414656,461042,8.702034523,189381,8.13446017124,126253,11.007900407,208850,-271661,-63128
1288,GORMAN RUPP CO,30.9497947495,212667,31.4008336388,455593,25.4685177042,477570,32.5707933007,553195,242926,21977
1289,GOVERNMENT PPTYS INCOME TR,19.0660777067,377162,20.9300639395,372383,18.3096475805,472647,18.7713022644,474128,-4779,100264
1290,GPO AEROPORTUARIO DEL PAC SA,82.5342322348,23881,97.1148406562,37121,112.295924192,43795,102.54114549,37975,13240,6674
1291,GRACE W R & CO DEL NEW,67.6399489366,736340,69.7091932125,1127484,72.0104799823,913742,72.1500850654,1340733,391144,-213742
1292,GRACO INC,83.0889803751,408562,94.1409103928,652883,109.281393648,378747,123.691818262,396065,244321,-274136
1293,GRAHAM HLDGS CO,511.953334183,31372,599.565284894,32205,599.652151507,31048,585.119880282,30739,833,-1157
1294,GRAINGER W W INC,232.24908319,318223,232.761626366,358517,180.531614149,290060,179.749192179,371679,40294,-68457
1295,GRAMERCY PPTY TR,9.18025997351,1033413,26.2990399979,378645,29.7104768804,563202,30.2493754915,677733,-654768,184557
1296,GRAN TIERRA ENERGY INC,3.01773767506,132881,2.64307290391,97992,2.23651104277,67963,2.28433774972,72231,-34889,-30029
1297,GRAND CANYON ED INC,58.4536734912,121669,71.6096937068,134479,78.4172603031,122269,90.8189990798,113016,12810,-12210
1298,GRANITE CONSTR INC,55.0006926059,642501,50.190425215,808979,48.2407424589,1131699,57.9501952056,922361,166478,322720
1299,GRANITE REAL ESTATE INVT TR,33.4406818256,399633,34.9740480199,286298,39.8404163279,306297,40.470662578,354479,-113335,19999
1300,GRAPHIC PACKAGING HLDG CO,12.4799027813,3031514,12.8699943705,4243747,13.7799011576,4194152,13.949833836,1713067,1212233,-49595
1301,GRAY TELEVISION INC,10.8638970972,34518,14.4938789243,38637,13.7047114421,139660,15.7010225406,250748,4119,101023
1302,GREAT LAKES DREDGE & DOCK CO,4.19389446991,20506,3.98739468776,15549,4.28254984002,20315,4.84233913465,35107,-4957,4766
1303,GREAT PLAINS ENERGY INC,27.4644492311,3922489,29.2194701545,1460841,29.6572834855,1579848,30.3001219354,2188044,-2461648,119007
1304,GREAT SOUTHN BANCORP INC,54.6583102326,16594,50.5494505495,16835,53.4995582605,10187,55.6223692123,9978,241,-6648
1305,GREAT WESTN BANCORP INC,43.5899336028,1983669,42.4102890752,2015808,40.8102713081,1968279,41.2803201046,2034335,32139,-47529
1306,GREEN DOT CORP,23.5511113768,117107,33.3616484902,72988,38.5403387361,43928,49.577322233,280592,-44119,-29060
1307,GREEN PLAINS INC,27.848852301,215736,24.7517032914,166736,20.5481328954,255449,20.1515020157,184552,-49000,88713
1308,GREENBRIER COS INC,41.5495108828,127679,43.0983603221,147407,46.2516518447,167994,48.1487953094,206028,19728,20587
1309,GREENHILL & CO INC,27.7002351037,195233,29.2993879857,408814,20.0994692902,515536,16.5996217121,479529,213581,106722
1310,GREENLIGHT CAPITAL RE LTD,22.8012378956,250425,22.0949439046,93234,20.8952372867,94232,21.6502335236,96350,-157191,998
1311,GREIF INC,51.3079343549,126803,55.090447498,150861,55.7777575422,142763,58.5358081733,125530,24058,-8098
1312,GRIDSUM HLDG INC,10.1901244399,2272985,13.2901242668,2247985,8.56005210271,2227907,10.2969507739,15053,-25000,-20078
1313,GRIFFON CORP,26.1999779169,5832524,24.6500134333,5836224,21.9499799871,5836224,22.1999703918,5836224,3700,0
1314,GRIFOLS S A,16.0681011818,156708,18.8779227661,150970,21.1283168379,126702,21.8894409506,201467,-5738,-24268
1315,GROUP 1 AUTOMOTIVE INC,77.9363336992,112964,74.08520337,176378,63.3157625073,115153,72.4568995123,145590,63414,-61225
1316,GROUPE CGI INC,48.0303164862,855772,47.9319563089,378933,51.0735416807,208562,51.8682714104,359102,-476839,-170371
1317,GROUPON INC,3.32028588181,1577575,3.92980050117,3978319,3.83961806567,2702873,5.20015646403,4136414,2400744,-1275446
1318,GRUBHUB INC,37.61914653,216645,32.8922616565,342877,43.5989060881,374436,52.6572403706,280987,126232,31559
1319,GRUPO AEROPORTUARIO CTR NORT,34.5506557194,26917,43.1865471995,23549,48.1863785452,41464,44.3642379126,26598,-3368,17915
1320,GRUPO AEROPORTUARIO DEL SURE,143.863179074,9940,173.229892959,20366,210.398679788,99378,190.81941649,110298,10426,79012
1321,GRUPO AVAL ACCIONES Y VALORE,7.94051429091,396196,8.1704552696,439388,8.28030889272,435491,8.96913426342,453221,43192,-3897
1322,GRUPO FINANCIERO GALICIA S A,26.9184127381,551667,37.8604715824,661772,42.6392193476,531248,51.5399058504,408499,110105,-130524
1323,GRUPO FINANCIERO SANTANDER M,7.19036136428,709561,9.02988582415,2614651,9.63977527838,2050359,10.0902284754,2184787,1905090,-564292
1324,GRUPO SUPERVIELLE S A,13.1404302835,1139156,16.9995365381,1292447,18.0799688811,1269969,24.6903617339,1350689,153291,-22478
1325,GRUPO TELEVISA SA,20.8899734145,7977272,25.9400283259,5130989,24.370551579,1489995,24.6697312546,1489923,-2846283,-3640994
1326,GS FIN CORP,15.6500014488,310607,16.2512822461,315852,16.6686123372,316943,16.1407470606,315289,5245,1091
1327,GSV CAP CORP,5.03034915449,215492,4.47648439258,124428,4.33738270922,115738,5.40644912145,88043,-91064,-8690
1328,GUESS INC,12.0978242856,253434,11.1499121002,460183,12.7788467735,217234,17.0314567535,322697,206749,-242949
1329,GUIDEWIRE SOFTWARE INC,49.3306951606,659042,56.3293041728,988047,68.7102112173,727592,77.8600567385,920716,329005,-260455
1330,GULF ISLAND FABRICATION INC,11.8996843811,70338,11.5542684978,68373,11.593294689,38298,12.6983582959,58354,-1965,-30075
1331,GULFPORT ENERGY CORP,21.6392854815,613560,17.1909502163,725498,14.7504782361,744925,14.3392316402,635041,111938,19427
1332,GW PHARMACEUTICALS PLC,111.750764714,243882,120.941880707,32743,100.249181408,48559,101.492783311,84942,-211139,15816
1333,H & E EQUIPMENT SERVICES INC,23.247383143,262051,24.5207576711,201829,20.406220751,189109,29.1989687959,216446,-60222,-12720
1334,HACKETT GROUP INC,17.668913081,46296,19.4903045257,60389,15.5073046509,74610,15.198604182,73362,14093,14221
1335,HAEMONETICS CORP,40.2021560355,135341,40.5716886927,138397,39.4889663182,52521,44.8668964334,128246,3056,-85876
1336,HAIN CELESTIAL GROUP INC,39.0303896102,1167603,37.2002786902,986041,38.819893267,2041917,41.1497581194,1962952,-181562,1055876
1337,HALLADOR ENERGY COMPANY,9.08789985255,33231,8.00850620999,132609,7.77767912634,56315,5.68032858516,11443,99378,-76294
1338,HALLIBURTON CO,54.0901181407,4086569,49.210332476,4197716,42.7101526312,3687320,46.0300136122,7197934,111147,-510396
1339,HALOZYME THERAPEUTICS INC,9.88048916064,215880,12.9602384455,210027,12.8198213217,407884,17.3699831078,445769,-5853,197857
1340,HALYARD HEALTH INC,36.9798360722,567201,38.0889520528,543911,39.2803781522,1864646,45.0303063641,1617977,-23290,1320735
1341,HANCOCK HLDG CO,43.0999166246,485755,45.549974887,398200,49.0008736927,391442,48.4498879336,478288,-87555,-6758
1342,HANESBRANDS INC,21.5699456903,2949567,20.7598030959,4036888,23.159781861,4589551,24.6399722597,3322244,1087321,552663
1343,HANMI FINL CORP,34.9006405227,140198,30.7535812893,130749,28.452780601,194814,30.9506095118,262095,-9449,64065
1344,HANNON ARMSTRONG SUST INFR C,18.9982039513,25055,20.2024480115,47222,22.8679995216,217378,24.3697759203,179936,22167,170156
1345,HANOVER INS GROUP INC,91.0090201651,366623,90.0606087962,398787,88.6300294567,365621,96.9296379486,505315,32164,-33166
1346,HARLEY DAVIDSON INC,58.3408707957,1096744,60.5003725118,762392,54.0195880466,737899,48.2101723053,1681782,-334352,-24493
1347,HARMONIC INC,5.00125572655,230942,5.95111183575,159466,5.24153997057,32624,3.05245240377,349555,-71476,-126842
1348,HARMONY GOLD MNG LTD,2.20985012744,2522343,2.44988873935,2274389,1.65011342698,2047132,1.82928806378,1110268,-247954,-227257
1349,HARRIS CORP DEL,102.471114345,1077611,111.269526034,497989,109.079795322,590586,131.678620098,625204,-579622,92597
1350,HARSCO CORP,13.6044909839,193098,12.7492286906,237583,16.0983257741,250026,20.9000563665,1394446,44485,12443
1351,HARTE-HANKS INC,1.51348784758,134788,1.40115410852,108482,1.0296010296,85470,1.06367891079,14102,-26306,-23012
1352,HARTFORD FINL SVCS GROUP INC,47.6500144532,5431310,48.0700991226,4441368,52.5702535984,3195210,55.4303585181,2844849,-989942,-1246158
1353,HARVARD BIOSCIENCE INC,3.04965214905,31479,2.61167849068,25654,2.55951646725,32428,3.74702979346,21884,-5825,6774
1354,HASBRO INC,77.7902806714,807813,99.8202668078,687686,111.509610345,837587,97.6701579238,1407134,-120127,149901
1355,HAVERTY FURNITURE INC,23.7014487239,73582,24.3601135649,46141,25.1003000573,59322,26.1491685361,155569,-27441,13181
1356,HAWAIIAN ELEC INDUSTRIES,33.0698485479,1016757,33.3097462154,1098057,32.3798119385,973724,33.3699450189,944143,81300,-124333
1357,HAWAIIAN HOLDINGS INC,56.9997812629,772617,46.4495520034,550339,46.9501108748,661106,37.5509836683,888765,-222278,110767
1358,HAWKINS INC,53.9298299372,13054,48.9786166527,8371,46.3026952315,4341,40.8052721856,22154,-4683,-4030
1359,HAYNES INTERNATIONAL INC,43.0003984593,30116,38.1037656071,20103,36.3135284105,24674,35.9032809574,98264,-10013,4571
1360,HC2 HLDGS INC,5.90046177527,27286,6.19502344525,29217,5.87873191751,32490,5.25812619503,18828,1931,3273
1361,HCI GROUP INC,39.4724791648,21838,45.5519224264,17738,46.9756097561,20500,38.2624610369,34969,-4100,2762
1362,HCP INC,29.7200918985,9093949,31.2800326602,9540655,31.9600109126,10684915,27.8300307313,10422590,446706,1144260
1363,HD SUPPLY HLDGS INC,42.5096996338,906993,41.1248056189,1291921,30.6305382783,838934,36.0702528132,1278810,384928,-452987
1364,HDFC BANK LTD,60.6800707331,666166,75.2184938465,515804,86.9669849984,419688,96.3704061621,527745,-150362,-96116
1365,HEALTH INS INNOVATIONS INC,17.8416899975,39290,15.9997922105,77001,23.4758653731,16698,14.5040176009,83632,37711,-60303
1366,HEALTHCARE RLTY TR,30.3184351422,584232,32.5009046304,395189,34.1489578691,661865,32.3402259367,579897,-189043,266676
1367,HEALTHCARE SVCS GRP INC,39.1697909525,1370980,43.0894695751,1282123,46.8297213209,1199516,53.9699918342,1096035,-88857,-82607
1368,HEALTHCARE TR AMER INC,29.1119250581,241894,31.4601297601,1473643,31.109129417,897100,29.7990464948,747138,1231749,-576543
1369,HEALTHEQUITY INC,40.516838488,181875,42.4501954943,139646,49.8348478622,131394,50.5807296812,369449,-42229,-8252
1370,HEALTHSOUTH CORP,41.2402669633,251720,42.809139193,454132,48.4011678628,343876,46.3509920754,350931,202412,-110256
1371,HEALTHSTREAM INC,25.0444647407,41606,24.2153331618,31096,26.301946344,13307,23.3646623636,79479,-10510,-17789
1372,HEARTLAND EXPRESS INC,20.3605425489,167137,20.0515290691,267810,20.818424799,395467,25.0791210674,863866,100673,127657
1373,HEARTLAND FINL USA INC,47.9964773228,22710,49.9540441176,43520,47.0834661445,21961,49.3925618736,37617,20810,-21559
1374,HECLA MNG CO,5.24012612946,3886166,5.28983983819,3586498,5.10013558842,3998129,5.02007033321,1608344,-299668,411631
1375,HEICO CORP NEW,73.3867635225,183916,79.1024656806,165431,67.348252933,290401,82.0711955213,274006,-18485,124970
1376,HEIDRICK & STRUGGLES INTL IN,24.148678287,129945,26.3501669216,89563,21.7387699604,60307,21.139889083,85289,-40382,-29256
1377,HELEN OF TROY CORP LTD,84.4521670593,111649,94.2084287289,70758,94.1002775645,84665,96.9037372297,76447,-40891,13907
1378,HELIX ENERGY SOLUTIONS GRP I,8.82059043952,544408,7.77077528792,569956,5.63957903398,456949,7.38967423203,1102349,25548,-113007
1379,HELMERICH & PAYNE INC,77.4003731129,1460148,66.5689262799,802807,54.3400808904,797128,52.1088476335,930034,-657341,-5679
1380,HEMISPHERE MEDIA GROUP INC,11.1863057325,25120,11.7736102935,11891,11.8314940577,18848,11.955827325,32871,-13229,6957
1381,HENRY JACK & ASSOC INC,88.7796665151,875482,93.1007015288,715580,103.87057928,968253,102.789071974,714969,-159902,252673
1382,HERBALIFE LTD,48.1397354315,1064526,58.1398211668,2233925,71.329917476,2664436,67.8303096651,2221529,1169399,430511
1383,HERC HLDGS INC,40.1604200452,1281386,48.8897199261,1320973,39.3197153156,1190090,49.1291951631,1015038,39587,-130883
1384,HERCULES CAPITAL INC,14.1135203554,120877,15.1254068543,88791,13.2376225565,131368,12.9015044583,116188,-32086,42577
1385,HERITAGE COMMERCE CORP,14.4475053566,16335,14.0853548426,16613,13.7627305257,25431,14.2204036271,39591,278,8818
1386,HERITAGE CRYSTAL CLEAN INC,15.6924284033,35686,13.7179672796,27628,15.8810824546,23613,21.7688236298,11714,-8058,-4015
1387,HERITAGE FINL CORP WASH,25.7492910764,977891,24.7503943846,973035,26.4994963696,971943,29.499759356,970313,-4856,-1092
1388,HERITAGE INS HLDGS INC,15.6840691099,32007,12.7651541965,42381,13.0118289354,10990,13.1969646981,18186,10374,-31391
1389,HERON THERAPEUTICS INC,13.0928671535,27114,15.0010467963,219718,13.8495744477,418280,16.1506036542,275903,192604,198562
1390,HERSHA HOSPITALITY TR,21.5007352609,199249,18.7867115647,249751,18.5100875424,153754,18.6698108341,2151709,50502,-95997
1391,HERSHEY CO,103.429961965,851059,109.249972333,858435,107.3700925,1803668,109.169220834,1276019,7376,945233
1392,HERTZ GLOBAL HLDGS INC,21.5602971221,295636,17.5399873317,1078279,11.500216224,1586318,22.3604928826,1275598,782643,508039
1393,HESKA CORP,71.5693392802,9641,104.985967222,28861,102.069005208,34751,88.0886534491,51346,19220,5890
1394,HESS CORP,62.2904679453,1258459,48.209711527,2506300,43.8703715146,2233398,46.8899070832,3142382,1247841,-272902
1395,HEWLETT PACKARD ENTERPRISE C,23.1399939912,13153936,23.699946315,12066694,16.5900034996,11755754,14.7100173238,14567284,-1087242,-310940
1396,HEXCEL CORP NEW,51.4398871973,1899246,54.5501806992,2385180,52.7878606236,360348,57.4213775119,379249,485934,-2024832
1397,HFF INC,30.2496177198,1490399,27.6702935255,1247728,34.7699769529,747599,39.5591102417,621652,-242671,-500129
1398,HI-CRUSH PARTNERS LP,19.7999656187,2344297,17.3501270601,4371553,10.8500433014,3705423,9.49995256562,3594439,2027256,-666130
1399,HIBBETT SPORTS INC,37.2983313613,90433,29.498435918,66173,20.7520240486,79173,14.2466362109,144034,-24260,13000
1400,HIGHWOODS PPTYS INC,51.0096023528,1424026,49.1301725936,1399588,50.7105365132,709675,52.0891054474,646066,-24438,-689913
1401,HILL ROM HLDGS INC,56.1411633045,518265,70.5997804692,1023091,79.6085695775,635924,73.9999648074,397811,504826,-387167
1402,HILLENBRAND INC,38.3533776102,150417,35.8508310115,113777,36.0993012634,399149,38.8511498443,603560,-36640,285372
1403,HILLTOP HOLDINGS INC,29.7973864218,138737,27.4697091823,232001,26.208257916,311047,25.9991778916,379512,93264,79046
1404,HILTON WORLDWIDE HLDGS INC,27.1999854066,28396302,58.460114421,4991215,61.8501316839,4575350,69.449969156,13308890,-23405087,-415865
1405,HIMAX TECHNOLOGIES INC,6.04181403339,188023,9.11910211918,216688,8.1997952046,375985,10.929507174,320600,28665,159297
1406,HMS HLDGS CORP,18.1599364966,1366855,20.329677945,1370853,18.4999234916,1522709,19.8602144778,1848117,3998,151856
1407,HNI CORP,55.9226037796,192981,46.093117718,130974,39.8696360674,193305,41.4669060008,132033,-62007,62331
1408,HOEGH LNG PARTNERS LP,19.0002271003,1994713,19.6499446286,1994713,19.150002296,1981723,18.5501767786,1966019,0,-12990
1409,HOLLY ENERGY PARTNERS L P,32.059959516,2606959,35.7099073894,2463434,32.4801104233,2218373,33.4002391306,2126871,-143525,-245061
1410,HOLLYFRONTIER CORP,32.7600782311,954607,28.3395588869,1605212,27.4701261862,1697808,35.9702338791,2349248,650605,92596
1411,HOLOGIC INC,40.1196444529,2740453,42.5502684688,2700500,45.3798186325,1475678,36.6902673151,1510128,-39953,-1224822
1412,HOME BANCSHARES INC,27.770267678,2215535,27.0699496095,2093650,24.8998532257,2259933,25.2197686412,2519809,-121885,166283
1413,HOME DEPOT INC,134.080039494,5371948,146.83007367,5418454,153.400214662,5853851,163.559840197,5895995,46506,435397
1414,HOMESTREET INC,31.6013239185,255907,27.9449260581,107855,27.6708623739,124969,26.9996468743,172743,-148052,17114
1415,HOMETRUST BANCSHARES INC,25.9145520177,18561,23.4802187198,21763,24.3954089196,23611,25.6381423592,8893,3202,1848
1416,HONDA MOTOR LTD,29.1893152242,480347,30.2597805545,531795,27.3903974736,512990,29.5599100546,622600,51448,-18805
1417,HONEYWELL INTL INC,115.850162625,5131430,124.87014744,6622896,133.290034086,7718379,141.739973168,8054538,1491466,1095483
1418,HOOKER FURNITURE CORP,37.9223328193,14266,31.0691758328,19183,41.1263666412,15732,47.8147691465,7299,4917,-3451
1419,HOPE BANCORP INC,21.8911590626,361059,19.1705300088,127696,18.6543095459,134875,17.7097410988,404749,-233363,7179
1420,HORACE MANN EDUCATORS CORP N,42.7930518808,60851,41.040417413,51364,37.7986682335,15318,39.3537529451,74275,-9487,-36046
1421,HORIZON BANCORP IND,27.9402209227,7695,26.1748234721,8214,26.3264071011,9914,29.198341396,11576,519,1700
1422,HORIZON PHARMA PLC,16.1796696943,983271,14.7792068322,938616,11.8700444126,2161323,12.679734103,908773,-44655,1222707
1423,HORMEL FOODS CORP,34.8099915741,1500144,34.6298266134,1284182,34.1098250196,1343865,32.1400615127,1297944,-215962,59683
1424,HORNBECK OFFSHORE SVCS INC N,7.21851177225,192699,4.42541042113,63045,2.82610916272,117476,4.02746346515,26071,-129654,54431
1425,HOSPITALITY PPTYS TR,31.7394964522,1413570,31.5302704549,1103733,29.1497944725,1045359,28.4902703676,977632,-309837,-58374
1426,HOST HOTELS & RESORTS INC,18.840188381,4310838,18.6600812402,5827413,18.2700548277,8246007,18.4900158239,10360294,1516575,2418594
1427,HOSTESS BRANDS INC,13.0012047448,258976,15.8709195116,401300,16.0914220616,56179,13.6586389699,314453,142324,-345121
1428,HOUGHTON MIFFLIN HARCOURT CO,10.8498770647,2001866,10.1511584804,315629,12.3006810358,390141,12.0509229859,736956,-1686237,74512
1429,HOULIHAN LOKEY INC,31.1446141639,15123,34.4464619352,76002,34.8996313646,124242,39.1291479508,229752,60879,48240
1430,HOVNANIAN ENTERPRISES INC,2.73224043716,193248,2.27056497594,296402,2.79112394812,72014,1.93264679246,107107,103154,-224388
1431,HOWARD HUGHES CORP,114.105551544,134323,117.253325942,144320,122.839888054,169725,117.934176274,150584,9997,25405
1432,HP INC,14.8399976401,15542927,17.8801038832,16309469,17.4799980189,14941020,19.959919074,12353507,766542,-1368449
1433,HRG GROUP INC,15.5601775376,448581,19.3189927617,137326,17.7100849942,393674,15.6095266389,484704,-311255,256348
1434,HSBC HLDGS PLC,39.5364274444,1378425,40.3099741398,1724660,45.7295725789,1783791,48.6797019479,1833639,346235,59131
1435,HSN INC,34.3007915567,167897,37.0933504468,101285,31.8981865592,134992,39.0505962387,698965,-66612,33707
1436,HUB GROUP INC,43.7498930216,58423,46.4026389364,49717,38.3380018674,53550,42.9461705202,66432,-8706,3833
1437,HUBBELL INC,116.700631091,1591371,120.050092732,1530761,113.169664646,1352244,116.019712072,1258924,-60610,-178517
1438,HUBSPOT INC,46.9951908517,165102,60.548823109,254654,65.7522460226,378892,84.0498109485,243320,89552,124238
1439,HUDBAY MINERALS INC,4.58315146224,54984,6.37891538901,409474,5.46912547393,224716,7.30836294767,572358,354490,-184758
1440,HUDSON GLOBAL INC,1.34645593563,31193,1.24099088349,20951,1.33645172068,20951,1.47964297647,20951,-10242,0
1441,HUDSON PAC PPTYS INC,34.7796646317,1875550,34.6399466286,3729336,34.1899923401,4334280,33.5300436541,5469125,1853786,604944
1442,HUGOTON RTY TR TEX,2.1388468051,11221,1.87149095446,11221,1.78237233758,11221,1.87149095446,11221,0,0
1443,HUMANA INC,204.029758215,1500090,206.139993767,4482871,240.620327098,2539241,243.630691886,1852242,2982781,-1943630
1444,HUNT J B TRANS SVCS INC,97.0699584418,486546,91.7396290197,367998,91.3803422973,379261,111.07981791,543249,-118548,11263
1445,HUNTINGTON BANCSHARES INC,13.2199968161,17243045,13.3899689712,14801752,13.51995211,13505965,14.140932453,16142712,-2441293,-1295787
1446,HUNTINGTON INGALLS INDS INC,184.190223643,865844,200.240190415,875139,186.160031968,928427,226.439770786,925946,9295,53288
1447,HUNTSMAN CORP,19.0799238312,5619100,24.5399302315,5679356,25.8398982445,5982183,27.4199247676,5682656,60256,302827
1448,HURON CONSULTING GROUP INC,50.6419610416,102109,42.0965744944,109035,43.1784710135,14938,34.3148802513,25470,6926,-94097
1449,HYATT HOTELS CORP,55.2574193613,299453,53.9790578318,436058,56.2115711979,501089,61.7910691004,613600,136605,65031
1450,HYSTER YALE MATLS HANDLING I,63.7638757422,34863,56.3727292785,27194,70.2265372168,18540,76.4582033687,25648,-7669,-8654
1451,IAC INTERACTIVECORP,64.7903581226,1334180,73.7195626815,1417914,103.239921185,1159164,117.580715142,799757,83734,-258750
1452,IAMGOLD CORP,3.84989571542,2136941,4.00015133688,2140919,5.16018441569,1806137,6.10043649735,1424980,3978,-334782
1453,IBERIABANK CORP,83.7553285841,69906,79.0955589436,162664,81.5039870012,179709,82.1461381908,227497,92758,17045
1454,ICF INTL INC,55.2259826725,23431,41.3046325809,22903,47.0998855341,53291,53.9446956294,61044,-528,30388
1455,ICHOR HOLDINGS,10.8163265306,29400,19.8286909017,14827,20.1479462721,30822,26.8051326664,91960,-14573,15995
1456,ICICI BK LTD,7.49010174946,2898492,8.60025428504,3446526,8.97013656687,3583446,8.55976599022,3858984,548034,136920
1457,ICON PLC,75.1999381834,129415,79.7172779938,123938,97.7838216858,47063,113.88265243,56567,-5477,-76875
1458,ICONIX BRAND GROUP INC,9.34048902184,267759,7.51905889847,200956,6.90777895107,22728,5.69048527028,167824,-66803,-178228
1459,ICU MED INC,147.34838643,319447,152.700539547,374203,172.501048979,388473,185.848403734,382925,54756,14270
1460,IDACORP INC,80.5500824554,1369831,82.9596713966,1339000,85.3497688752,1135750,87.9294016276,1042177,-30831,-203250
1461,IDEX CORP,90.0609229032,1154574,93.5093420116,1232818,113.00949612,1112349,121.470492451,1154552,78244,-120469
1462,IDEXX LABS INC,117.271188928,538359,154.610269426,887703,161.421052039,1243642,155.489728894,621160,349344,355939
1463,IDT CORP,18.5291465114,24394,12.7018355862,38026,14.3686718285,80592,14.0893363673,32081,13632,42566
1464,IHS MARKIT LTD,35.4099359315,1628413,41.9496828405,1727522,44.0397648649,2881237,44.0798754773,3209696,99109,1153715
1465,II VI INC,29.6480985973,246660,36.0508703504,131786,34.3003186922,641685,41.149935512,1249844,-114874,509899
1466,IKANG HEALTHCARE GROUP INC,17.3300490028,4386485,14.5999674182,4382818,12.2699764191,4385746,13.4800542069,4395012,-3667,2928
1467,ILG INC,18.1702584672,743963,20.9600063906,325477,27.4889863082,370221,26.7300966758,594461,-418486,44744
1468,ILLINOIS TOOL WKS INC,122.459352049,1241514,132.470159953,1231734,143.249465972,1707776,147.960214446,1707655,-9780,476042
1469,ILLUMINA INC,128.041225707,958043,170.640876515,1385852,173.519947089,1439408,199.199662054,1576584,427809,53556
1470,IMAX CORP,31.4000919504,306687,33.9995297018,1122692,22.0001625084,1267627,22.6500621214,618144,816005,144935
1471,IMMERSION CORP,10.6377038195,35816,8.65365264641,34783,9.09240742776,36404,8.17265007854,43927,-1033,1621
1472,IMMUNOGEN INC,2.04061135441,627263,3.86886961722,588544,7.1095964605,568668,7.65372045299,131570,-38719,-19876
1473,IMMUNOMEDICS INC,3.67025032306,150126,6.47119610434,417079,8.8307590266,907623,13.9801372607,921021,266953,490544
1474,IMPAX LABORATORIES INC,13.251315154,345777,12.6510062922,240139,16.0988481376,727257,20.3000559559,1994428,-105638,487118
1475,IMPERIAL OIL LTD,34.7592429947,881262,30.5006521521,707657,29.1802159501,278305,31.9392818916,256925,-173605,-429352
1476,IMPERVA INC,38.4000666212,624426,41.0506069553,676409,47.8510737602,711332,43.4026333776,276527,51983,34923
1477,INC RESH HLDGS INC,52.5971179509,180219,45.8501912516,597642,58.4988669064,300946,52.3002813715,580016,417423,-296696
1478,INCYTE CORP,100.270660348,1416905,133.670227796,2013687,125.909597506,1741567,116.739774515,1777055,596782,-272120
1479,INDEPENDENCE CONTRACT DRIL I,6.72795097256,15012,5.51432790624,53497,3.88982686132,60414,3.8026507529,72055,38485,6917
1480,INDEPENDENCE RLTY TR INC,8.92096790944,96290,9.36776013162,119132,9.86747369067,211807,10.1711128438,401431,22842,92675
1481,INDEPENDENT BANK CORP MASS,70.4493538756,915381,64.999944207,896170,66.6504248537,870182,74.6506258355,905190,-19211,-25988
1482,INDEPENDENT BANK CORP MICH,21.7038733066,41928,20.6988947192,44785,21.7509025271,33240,22.6600152194,35481,2857,-11545
1483,INDEPENDENT BK GROUP INC,62.4000430067,446442,64.3006775979,463992,59.5009596929,525689,60.2995650105,706224,17550,61697
1484,INFINERA CORPORATION,8.48973308279,353368,10.2310547437,365065,10.6688545252,656959,8.87116655645,511094,11697,291894
1485,INFINITY PHARMACEUTICALS INC,1.34830198219,213602,3.23298066607,140737,1.57167572309,246234,1.33073459238,74395,-72865,105497
1486,INFINITY PPTY & CAS CORP,87.9072667236,43307,95.5163854589,31827,94.0229964435,28961,94.2035153424,46994,-11480,-2866
1487,INFORMATION SERVICES GROUP I,3.64057060372,94216,3.14401129119,102735,4.13372264689,30481,4.01969651291,49755,8519,-72254
1488,INFOSYS LTD,14.8301041607,2903014,15.8000908483,3355044,15.0202278447,3264065,14.5899598073,3157788,452030,-90979
1489,INFRAREIT INC,17.909596827,1255863,18.000167524,346219,19.1505620088,234249,22.3731196921,270235,-909644,-111970
1490,ING GROEP N V,14.1000413601,1196805,15.0900344165,1314775,17.3905311713,1383339,18.4201579087,1588260,117970,68564
1491,INGERSOLL-RAND PLC,75.0392109432,1794142,81.3199002752,1671399,91.3896903,1838424,89.1700959322,2139428,-122743,167025
1492,INGEVITY CORP,54.8594151986,306292,60.8577933666,113757,57.4030817146,97608,62.4687951649,152220,-192535,-16149
1493,INGREDION INC,124.95902609,1162325,120.4291319,983101,119.209636221,999894,120.640446338,1116284,-179224,16793
1494,INNERWORKINGS INC,9.85190364203,94398,9.96500552052,106874,11.5929413627,101096,11.246638494,104120,12476,-5778
1495,INNOPHOS HOLDINGS INC,52.2634553485,213744,53.9692856123,203097,43.8406925329,321140,49.1908012834,353745,-10647,118043
1496,INNOSPEC INC,68.5024301851,59049,64.7545021621,36538,65.5731065209,24690,61.6534187688,98632,-22511,-11848
1497,INNOVIVA INC,10.6994814004,445816,13.8292520056,546595,12.7995547981,661273,14.1200685292,1011539,100779,114678
1498,INOGEN INC,67.1557213213,48529,77.5609063368,126752,95.4132596081,128043,95.0975763299,127080,78223,1291
1499,INOVALON HLDGS INC,10.2989744481,253132,12.5984718481,472597,13.1504416332,481961,17.0492179267,505771,219465,9364
1500,INOVIO PHARMACEUTICALS INC,6.93780118193,111851,6.61722760981,78885,7.84102826104,185945,6.33227614372,92068,-32966,107060
1501,INPHI CORP,44.6048568806,23966,48.8150923319,45109,34.2976521535,144558,39.7021631321,70777,21143,99449
1502,INSEEGO CORP,2.45213301982,29770,2.09044625859,696502,1.25046571283,700539,1.51039682433,963323,666732,4037
1503,INSIGHT ENTERPRISES INC,40.440484171,132763,41.095890411,104171,39.9812679272,85415,45.9156570763,116714,-28592,-18756
1504,INSMED INC,13.2300037585,279365,17.5104524568,289884,17.1613128492,171840,31.2098702564,361328,10519,-118044
1505,INSPERITY INC,70.9484343853,194141,88.6543188563,121641,71.0011346504,64337,87.9949634721,76243,-72500,-57304
1506,INSTALLED BLDG PRODS INC,41.3008396926,109683,52.7462202101,93656,52.9521768135,91441,64.8009913839,102483,-16027,-2215
1507,INSTEEL INDUSTRIES INC,35.6420326074,50418,36.1445783133,27224,32.9648945279,25694,26.1037176779,48767,-23194,-1530
1508,INSULET CORP,37.6782832109,242872,43.0888568135,192602,51.3104158932,131981,55.0813113284,57987,-50270,-60621
1509,INSYS THERAPEUTICS INC NEW,9.20086100491,265736,10.5089862646,226568,12.6443220592,137453,8.88380815756,133839,-39168,-89115
1510,INTEGER HLDGS CORP,29.4577445361,65246,40.1907465591,62701,43.2376550718,16444,51.1447866908,121420,-2545,-46257
1511,INTEGRA LIFESCIENCES HLDGS C,85.7894424165,605972,42.1298005654,1088778,54.5101565717,1189870,50.4808156742,1138690,482806,101092
1512,INTEGRATED DEVICE TECHNOLOGY,23.5598013074,744064,23.6716308145,217560,25.7893266942,418933,26.5797648987,703016,-526504,201373
1513,INTEL CORP,36.2699737822,23870792,36.0699949781,23003136,33.740022272,25051169,38.0799826486,26298804,-867656,2048033
1514,INTELLIA THERAPEUTICS INC,13.1097767097,162703,14.0786240786,40700,15.99884693,48566,24.8404455012,31964,-122003,7866
1515,INTELLIGENT SYS CORP NEW,4.23197492163,25520,4.40708397943,24506,3.48802586244,23509,3.83637045995,23981,-1014,-997
1516,INTELSAT S A,2.66436799624,12761,4.14743907555,104884,3.0814380044,20445,4.69901968727,135773,92123,-84439
1517,INTER PARFUMS INC,32.7556970925,48358,36.5601287652,39141,36.6338770853,32429,41.2478005265,146626,-9217,-6712
1518,INTERACTIVE BROKERS GROUP IN,36.5094421386,415372,34.7196782833,368523,37.4220187065,333253,45.0394897169,405422,-46849,-35270
1519,INTERCEPT PHARMACEUTICALS IN,108.641317709,48812,113.100343053,130592,121.068176755,139153,58.0403982311,128669,81780,8561
1520,INTERCONTINENTAL EXCHANGE IN,56.4199381839,11385390,59.8700789868,11350127,65.9200404156,11773673,68.7000129838,10952094,-35263,423546
1521,INTERCONTINENTAL HOTELS GROU,44.3279780564,61248,48.9297117063,63581,55.5268446741,69660,52.879015395,71257,2333,6079
1522,INTERDIGITAL INC,91.3499426554,752469,86.2996264473,726805,77.3002919312,740243,73.7487027003,628228,-25664,13438
1523,INTERFACE INC,18.5491813036,277209,19.0465705163,163494,19.6496979169,104938,21.898834432,320702,-113715,-58556
1524,INTERNAP CORP,1.54004279769,296745,3.71903661856,437210,3.67210281888,138885,4.34207704953,55964,140465,-298325
1525,INTERNATIONAL BANCSHARES COR,40.8015739041,243471,35.3991667388,207858,35.0514881757,247921,40.1014485265,464472,-35613,40063
1526,INTERNATIONAL BUSINESS MACHS,165.990250473,3459655,174.139758859,4070225,153.83006324,4316900,145.080184693,5821560,610570,246675
1527,INTERNATIONAL FLAVORS&FRAGRA,117.828262037,286646,132.529854291,271569,134.997976738,269367,142.909569963,212540,-15077,-2202
1528,INTERNATIONAL GAME TECHNOLOG,25.5199898699,3972337,23.7002531958,3894220,18.2999493745,4280449,24.5501384825,3023486,-78117,386229
1529,INTERNATIONAL SPEEDWAY CORP,36.8011225587,289339,36.9504747332,452254,37.5523364652,338674,36.0007135087,285911,162915,-113580
1530,INTERPUBLIC GROUP COS INC,23.4100905958,5241415,24.5699126134,7044673,24.5999380673,8547989,20.78998208,9720980,1803258,1503316
1531,INTERSECT ENT INC,12.1008727349,114124,17.1456897641,102883,27.9549551734,123699,31.1405647413,90236,-11241,20816
1532,INTERXION HOLDING N.V,35.0701003311,928027,39.5600748191,867693,45.7802543298,889947,50.9298677743,811567,-60334,22254
1533,INTL FCSTONE INC,39.6069795019,29515,37.9717256689,34236,37.8076630297,7882,38.323906268,77967,4721,-26354
1534,INTL PAPER CO,53.0602079289,2641961,50.780123745,2445189,56.610082449,1958909,56.8197530111,2097422,-196772,-486280
1535,INTRA CELLULAR THERAPIES INC,15.0900360144,83300,16.2481979817,133184,12.4197186494,580770,15.7804097986,227624,49884,447586
1536,INTREPID POTASH INC,2.09304790165,37744,1.72082782185,482326,2.25846925972,39850,4.35404866053,49609,444582,-442476
1537,INTREXON CORP,24.2994382209,90249,19.8161021409,144428,24.0863569631,152576,19.0067953604,168203,54179,8148
1538,INTUIT,114.610021747,3887845,115.989768304,3534898,132.810033255,3629530,142.140220505,3456242,-352947,94632
1539,INTUITIVE SURGICAL INC,634.168855051,279506,766.47004801,1339310,935.369641431,850297,1045.88032639,631033,1059804,-489013
1540,INVACARE CORP,13.0489669031,232892,11.8977465586,169696,13.199751261,723650,15.7500029543,1353968,-63196,553954
1541,INVESCO LTD,30.3400143983,5853458,30.6298758789,5087288,35.1897123219,3924073,35.0398089712,4422370,-766170,-1163215
1542,INVESCO MORTGAGE CAPITAL INC,14.5992930527,1047037,15.420101089,969838,16.7101732795,990654,17.1290312311,785275,-77199,20816
1543,INVESTMENT TECHNOLOGY GRP NE,19.7431755511,122574,20.2516456092,115003,21.2418603788,107806,22.1384114879,360866,-7571,-7197
1544,INVESTORS BANCORP INC NEW,13.9506868479,977873,14.3803505295,662084,13.3592961161,733871,13.6396452515,1393438,-315789,71787
1545,INVESTORS REAL ESTATE TR,7.13097460034,98584,5.92825139443,131236,6.20821026167,129667,6.10627421517,135762,32652,-1569
1546,INVITAE CORP,7.93914903732,21035,11.0692188708,20688,9.56179652497,54906,9.37370766898,43526,-347,34218
1547,INVIVO THERAPEUTICS HLDGS CO,4.19647114926,104850,4.04739987434,68439,2.70144276169,167318,1.45450627593,74252,-36411,98879
1548,ION GEOPHYSICAL CORP,6.00196910027,105632,4.85386581911,57892,4.33688286544,25825,9.50987564009,12303,-47740,-32067
1549,IONIS PHARMACEUTICALS INC,47.8301860913,692617,40.20005726,736989,50.8696803573,1465136,50.7002075457,1686857,44372,728147
1550,IPG PHOTONICS CORP,98.7119529719,191375,120.7022641,201007,145.096835886,280268,185.061167914,256834,9632,79261
1551,IRHYTHM TECHNOLOGIES INC,30.0183445439,17989,37.5985008649,83248,42.4742761426,16716,51.8741103906,18969,65259,-66532
1552,IRIDIUM COMMUNICATIONS INC,9.59941816397,228243,9.64811398668,129559,11.0547136071,55361,10.2986873624,196627,-98684,-74198
1553,IROBOT CORP,58.4504971667,149648,66.1409924323,157512,84.1415934073,290748,77.0609027088,245572,7864,133236
1554,IRON MTN INC NEW,32.4798861021,5207469,35.6699013877,5157065,34.360025805,6959890,38.9000002536,7096838,-50404,1802825
1555,IRONWOOD PHARMACEUTICALS INC,15.2900788883,1109543,17.0605212582,1049499,18.8801651185,798457,15.7693426085,178828,-60044,-251042
1556,IRSA INVERSIONES Y REP S A,18.4420113417,127318,24.5134230824,127318,24.1207056347,127318,24.5526948271,127318,0,0
1557,ISHARES,34.865200362,1058534,37.344174832,1169580,39.9936005641,2087684,28.3518930958,44900,111046,918104
1558,ISHARES GOLD TRUST,11.0817405449,186884,12.0065207828,115937,11.9397003878,84843,12.3050811499,84843,-70947,-31094
1559,ISHARES INC,39.4289979212,29244517,43.8349351739,22395904,45.1058659472,30312155,46.3381960806,30006563,-6848613,7916251
1560,ISHARES SILVER TRUST,15.1098778824,786373,17.2488326697,744862,15.7102828048,911123,15.739841176,568176,-41511,166261
1561,ISHARES TR,72.6383954951,185734857,73.5200914768,209590218,80.5492040172,206355956,84.5356176923,204747389,23855361,-3234262
1562,ISRAEL CHEMICALS LTD,4.11007588847,8415903,4.25998464712,10041116,4.72995864959,7691822,4.43999483286,8492127,1625213,-2349294
1563,ISTAR INC,12.3699547053,2938976,11.8000265161,2866180,12.0397396768,1921304,11.7996329637,1402586,-72796,-944876
1564,ITAU UNIBANCO HLDG SA,10.2798072027,3090914,12.0700447248,6270565,11.0500420406,9130463,13.700028448,8091954,3179651,2859898
1565,ITRON INC,62.84644734,152801,60.7060073844,109149,67.7497269763,125447,77.449397989,199498,-43652,16298
1566,ITT INC,38.5697423423,2300145,41.0201925738,2475415,40.1798391121,2278481,44.2696098463,2354098,175270,-196934
1567,IXYS CORP,11.9213313162,16525,14.5468732583,17942,16.4444291704,58196,23.7001666242,1153494,1417,40254
1568,J & J SNACK FOODS CORP,133.431942486,29071,135.578151914,17997,132.073568474,29741,131.306936655,89683,-11074,11744
1569,J2 GLOBAL INC,81.7999796827,305159,83.9057454701,187365,85.0856147669,194651,73.8825372076,283477,-117794,7286
1570,JA SOLAR HOLDINGS CO LTD,4.76129578074,101653,6.54231708549,168289,6.34899268632,44574,7.63159854069,26862,66636,-123715
1571,JACK IN THE BOX INC,111.640137875,1090262,101.720122131,1179393,98.4999831896,565127,101.916150984,100514,89131,-614266
1572,JACOBS ENGR GROUP INC DEL,56.9998526792,2932376,55.27993257,2707402,54.3902141458,2057337,58.2698723175,1797035,-224974,-650065
1573,JAMBA INC,10.302778175,153842,9.05016548684,150163,7.79060568272,149154,8.63823139433,152346,-3679,-1009
1574,JAMES HARDIE INDS PLC,15.9008464329,33080,15.8100558659,35800,15.7669763751,39069,14.0519214846,41062,2720,3269
1575,JAMES RIV GROUP LTD,41.5823623805,14333,42.870157012,18661,39.7301788573,853306,41.4808788711,904706,4328,834645
1576,JANUS DETROIT STR TR,30.6313036982,34801,32.9142011834,37856,33.5060096461,39187,34.3207457099,39801,3055,1331
1577,JAZZ PHARMACEUTICALS PLC,109.031188984,372343,145.129808278,320203,155.503614523,221191,146.250571051,584449,-52140,-99012
1578,JD COM INC,25.4399724664,3527323,31.1099130538,4329231,39.2200902228,4603712,38.2001677583,3997417,801908,274481
1579,JETBLUE AIRWAYS CORP,22.4199735915,12735296,20.609990999,16596999,22.8299850527,13597775,18.5299878492,11226397,3861703,-2999224
1580,JETPAY CORP,2.23285486443,15675,2.33413269384,31275,2.11262956361,15147,1.88579618315,13257,15600,-16128
1581,JINKOSOLAR HLDG CO LTD,15.3036037519,6077,16.5786792628,21594,20.8300948236,6433,24.9217433181,8306,15517,-15161
1582,JOHN BEAN TECHNOLOGIES CORP,85.9496663429,887438,87.9490689448,843022,98.0008046414,797871,101.100663002,936799,-44416,-45151
1583,JOHNSON & JOHNSON,115.209973299,10352602,124.55006526,12129259,132.290031065,13877410,130.010018189,14207159,1776657,1748151
1584,JOHNSON CTLS INTL PLC,41.1903546908,2259461,42.1199346847,2283693,43.3596707749,2337610,40.290076506,3320917,24232,53917
1585,JOHNSON OUTDOORS INC,39.6808164152,18422,36.5740740741,6480,48.19079845,18323,73.2331853875,17574,-11942,11843
1586,JONES ENERGY INC,5.00451438153,38765,2.5516670328,177531,1.60083392279,107444,1.91814379145,129813,138766,-70087
1587,JONES LANG LASALLE INC,101.040064069,379592,111.451355089,334074,124.999666012,374265,123.501101768,456085,-45518,40191
1588,JPMORGAN CHASE & CO,84.6431666439,20378420,85.2957251486,21688754,83.6876969849,22871044,86.6665283098,23851365,1310334,1182290
1589,JRJR33 INC,0.752706849632,17271,0.464317221526,21537,0.535857819059,22394,0.341296928328,11720,4266,857
1590,JUMEI INTL HLDG LTD,5.00945045263,140734,3.68827780008,159424,2.12846826302,65775,2.89656285299,123940,18690,-93649
1591,JUNIPER NETWORKS INC,28.2599862222,4459344,27.8300497589,6363086,27.8799717443,8842118,27.8300734111,6265129,1903742,2479032
1592,JUNO THERAPEUTICS INC,18.8495200167,148651,22.1908217617,859860,29.8899791441,867381,44.8604668087,920677,711209,7521
1593,JUST ENERGY GROUP INC,5.45877016465,269841,6.25897745038,346702,5.23698757236,306092,5.81152987911,285467,76861,-40610
1594,K12 INC,17.1582767852,327597,19.1497864845,270238,17.9204039516,323207,17.8406764808,305818,-57359,52969
1595,K2M GROUP HLDGS INC,20.0398678775,103843,20.5106991735,116037,24.3590046553,211585,21.2084772802,458213,12194,95548
1596,KADANT INC,61.2086045853,28264,59.3451568895,11728,75.2369380316,20575,98.5433357611,96110,-16536,8847
1597,KAISER ALUMINUM CORP,77.6896383163,413234,79.8989400408,393034,88.5207607757,331346,103.138813367,336178,-20200,-61688
1598,KAMAN CORP,48.9291934291,1131717,48.1294189102,1192036,49.8695884181,1002595,55.7801338746,703046,60319,-189441
1599,KANDI TECHNOLOGIES GROUP INC,4.91858887381,5896,3.78979282466,11874,4.44551657592,29018,5.74253107509,41271,5978,17144
1600,KANSAS CITY SOUTHERN,84.8500693844,596676,85.7603068517,345183,104.650128796,1394456,108.679982767,1220878,-251493,1049273
1601,KAPSTONE PAPER & PACKAGING C,22.0500554054,2702805,23.09995816,2433078,20.6301035748,1779390,21.490284725,1723523,-269727,-653688
1602,KAR AUCTION SVCS INC,42.6191800771,587787,43.6690182656,687192,41.9702101124,803427,47.7409831203,883371,99405,116235
1603,KARYOPHARM THERAPEUTICS INC,9.40001179918,101702,12.8443128794,79724,9.05747028682,47033,10.9849282326,80747,-21978,-32691
1604,KB FINANCIAL GROUP INC,35.2863715433,123022,43.9718436424,133540,50.4917897573,145489,49.0319968164,143233,10518,11949
1605,KB HOME,15.8098897877,2094322,19.8803089832,1837899,23.9703436198,1546244,24.120079721,2007000,-256423,-291655
1606,KBR INC,16.6897029961,637399,15.030110716,752556,15.2202707788,1687355,17.8802958038,2032293,115157,934799
1607,KEARNY FINL CORP MD,15.5505170602,90415,15.0478011472,156900,14.846036309,154452,15.3459402671,186564,66485,-2448
1608,KELLOGG CO,73.7100628206,1579418,72.61000075,1146674,69.4604412795,2773118,62.3702290961,2631079,-432744,1626444
1609,KELLY SVCS INC,22.9118886491,88513,21.8570734079,51425,22.4499109364,67929,25.0898252491,195936,-37088,16504
1610,KEMET CORP,6.63129973475,93496,11.999219563,276768,12.8050253684,74502,21.1294945328,296221,183272,-202266
1611,KEMPER CORP DEL,44.2975594493,127840,39.9071873486,88781,38.6038630973,73775,52.9970259945,80363,-39059,-15006
1612,KENNAMETAL INC,31.2605997268,218166,39.2289668806,363201,37.4194882177,841647,40.3401691329,1534178,145035,478446
1613,KENNEDY-WILSON HLDGS INC,20.4998163007,3503007,22.2001568201,3452363,19.0501623251,3287846,18.5499374766,3249984,-50644,-164517
1614,KERYX BIOPHARMACEUTICALS INC,5.86061938135,656074,6.15951961937,678462,7.22939360307,685673,7.09975100734,708053,22388,7211
1615,KEY ENERGY SVCS INC DEL,31.950104887,958651,23.2200449755,925838,19.2400233919,926818,13.1701571492,967870,-32813,980
1616,KEYCORP NEW,18.2700121722,8502950,17.780037807,7008759,18.7400851647,5853602,18.819757464,6064584,-1494191,-1155157
1617,KEYSIGHT TECHNOLOGIES INC,36.5702908174,544431,36.1386115843,652211,38.9287129339,411393,41.6609792018,556780,107780,-240818
1618,KEYW HLDG CORP,11.7967907655,31534,9.43902753318,186248,9.35254575634,181341,7.60959362815,613699,154714,-4907
1619,KFORCE INC,23.0824501527,11134,23.7678159089,25118,19.5774532996,12259,20.1836451836,11544,13984,-12859
1620,KILROY RLTY CORP,73.220318812,604996,72.0798053735,941290,75.1502081934,1301194,71.1203656953,1037804,336294,359904
1621,KIMBALL ELECTRONICS INC,18.198039647,163644,16.9530224328,157671,18.0468607943,153988,21.6474969765,197621,-5973,-3683
1622,KIMBALL INTL INC,17.5579611504,231405,16.5003478676,288903,16.6888858991,490566,19.7699958422,459383,57498,201663
1623,KIMBERLY CLARK CORP,114.119967499,3190064,131.63028691,3343068,129.109748995,3258654,117.68005922,3821701,153004,-84414
1624,KIMCO RLTY CORP,25.1600012002,2632949,22.090230246,3398018,18.3497809408,4289479,19.5500338228,3811042,765069,891461
1625,KINDER MORGAN INC DEL,20.6177971392,24702251,21.6536549244,27847539,19.1600040768,27188251,19.1851700698,30099238,3145288,-659288
1626,KINDRED BIOSCIENCES INC,4.25727764354,17382,7.02901146132,22336,8.57511283043,15510,7.84762527589,48932,4954,-6826
1627,KINDRED HEALTHCARE INC,7.85039382197,844671,8.35062713337,866881,11.6496473061,1753787,6.80005256717,3028506,22210,886906
1628,KINROSS GOLD CORP,3.10981600856,4161661,3.51018334584,2543172,4.06980714352,2225904,4.23983428208,3065450,-1618489,-317268
1629,KINSALE CAP GROUP INC,34.0093550818,707423,32.0400518351,706085,37.3104317286,895192,43.1694844855,881178,-1338,189107
1630,KIRBY CORP,66.5000973318,467473,70.549630845,341320,66.8473647737,243869,65.9506794994,121045,-126153,-97451
1631,KIRKLANDS INC,15.5049686377,42567,12.4051504011,55219,10.2654920382,66631,11.4303312948,113645,12652,11412
1632,KITE PHARMA INC,44.8340378352,86586,78.492502711,213944,103.670815624,395280,179.809790695,806480,127358,181336
1633,KITE RLTY GROUP TR,23.4813708429,364885,21.4994575702,561363,18.9301679939,895449,20.2501435324,1220979,196478,334086
1634,KKR & CO L P DEL,15.3900710179,4435782,18.2300119242,4646020,18.5999901633,2439840,20.329994675,3113626,210238,-2206180
1635,KLA-TENCOR CORP,78.6793928918,1403506,95.0712102006,683961,91.5097347674,821694,105.999900095,960916,-719545,137733
1636,KLONDEX MNS LTD,4.67083501466,740981,3.89088822824,287595,3.37071727878,162280,3.63579759615,89939,-453386,-125315
1637,KLX INC,45.1097556431,1609940,44.7000360678,2620065,49.99985585,2428027,52.92990684,2446972,1010125,-192038
1638,KMG CHEMICALS INC,38.8985566588,9769,46.0568992679,10791,48.6680327869,9760,54.8587181254,14510,1022,-1031
1639,KNOLL INC,27.9287050294,337359,23.8127607204,139757,20.0463683425,157435,20.0035871412,189566,-197602,17678
1640,KNOT OFFSHORE PARTNERS LP,23.5998330209,1674461,23.2997321021,1652122,22.9501916417,1623603,23.4998174471,1615970,-22339,-28519
1641,KNOWLES CORP,16.709419018,222210,18.950506891,356191,16.9200692343,803070,15.2699310564,723055,133981,446879
1642,KOHLS CORP,49.3801910114,2249080,39.8101967764,2409232,38.6699119358,1891574,45.6499167401,2297025,160152,-517658
1643,KONINKLIJKE PHILIPS N V,30.5703948721,277229,32.1126069579,277212,35.8201163808,390786,41.1989681439,345397,-17,113574
1644,KOPIN CORP,2.84060010876,312610,4.10091910529,104123,3.73222468937,21167,4.17343280538,127473,-208487,-82956
1645,KOPPERS HOLDINGS INC,40.2979063178,141521,42.3463833123,114815,36.1412988003,146951,46.1521187717,195939,-26706,32136
1646,KOREA ELECTRIC PWR,18.4772962763,201707,20.7271199052,290296,17.9714599961,283672,16.7604791338,326005,88589,-6624
1647,KORN FERRY INTL,29.4299595008,121237,31.4868531861,128244,34.5282700669,136381,39.4311028212,214450,7007,8137
1648,KORNIT DIGITAL LTD,12.650415954,1056487,19.1001203463,747011,19.3500514029,611833,15.2998996138,611638,-309476,-135178
1649,KOSMOS ENERGY LTD,7.00973241584,1571244,6.6598282764,3683128,6.41009880705,3782625,7.9601744548,1742801,2111884,99497
1650,KRAFT HEINZ CO,87.3202167497,3738321,90.8099552466,4145834,85.6400303755,3971624,77.5498516799,4931228,407513,-174210
1651,KRATON CORPORATION,28.4840115886,110799,30.9312638581,27060,34.434194775,99407,40.4383134943,143824,-83739,72347
1652,KRATOS DEFENSE & SEC SOLUTIO,7.40543420352,18770,7.78324708654,23769,11.8720884042,110764,13.0874873681,60363,4999,86995
1653,KROGER CO,34.5101257582,4586422,29.4898177337,3634407,23.3199684512,4797648,20.059970451,6946421,-952015,1163241
1654,KRONOS WORLDWIDE INC,11.9424740064,102910,16.4341293265,14908,18.2240066743,38356,22.8539049958,10589,-88002,23448
1655,KT CORP,14.0892335513,575120,16.8303158663,591611,16.6401820632,653839,13.8694998941,883233,16491,62228
1656,KULICKE & SOFFA INDS INC,15.949726411,311416,20.3199629795,242028,19.0192507714,289391,21.5693591162,300148,-69388,47363
1657,KYOCERA CORP,49.7842315809,63494,56.1285291824,67969,58.274182511,74527,62.1702142934,83577,4475,6558
1658,L BRANDS INC,65.8398737886,3680809,47.100037033,2468066,53.8903962603,2080148,41.6097885114,3157334,-1212743,-387918
1659,LA QUINTA HLDGS INC,14.210222185,453406,13.5216763519,309577,14.769987929,1675086,17.5004382446,1294939,-143829,1365509
1660,LA Z BOY INC,31.0501631236,238163,27.0026232009,128469,32.4992453318,185512,26.9013770833,215528,-109694,57043
1661,LABORATORY CORP AMER HLDGS,128.380288094,1627524,143.469668892,1690657,154.140534536,1551889,150.969543524,1630819,63133,-138768
1662,LADDER CAP CORP,13.7239062965,117605,14.4448616848,119835,13.407521158,145217,13.7749900262,90236,2230,25382
1663,LADENBURG THALMAN FIN SVCS I,2.43958440962,34842,2.48463449719,38235,2.44453763463,97769,2.87705389681,125128,3393,59534
1664,LAKELAND BANCORP INC,19.4774570836,21204,19.6191259077,36495,18.8494162451,51991,20.3944456285,60997,15291,15496
1665,LAKELAND FINL CORP,47.3608234482,716985,43.1202992598,806256,45.8798000721,912929,48.7197820499,921679,89271,106673
1666,LAM RESEARCH CORP,105.7300286,4713240,128.359850121,5021913,141.429489327,1847387,185.039391931,2702457,308673,-3174526
1667,LAMAR ADVERTISING CO NEW,67.2399022966,2636961,74.7402288032,1886949,73.570060359,1630908,68.5300483405,1468334,-750012,-256041
1668,LAMB WESTON HLDGS INC,37.8501406978,1254817,42.0601630732,1244717,44.040671138,996874,46.8898349866,931076,-10100,-247843
1669,LANCASTER COLONY CORP,141.388955248,200928,128.839169618,178424,122.624295362,159479,120.117498951,119150,-22504,-18945
1670,LANDAUER INC,48.1192476991,19992,48.7354696827,25464,52.3063185845,42557,67.2838869404,38776,5472,17093
1671,LANDEC CORP,13.7911439437,45754,12.0045771351,48065,14.850263013,52659,12.9500174764,57220,2311,4594
1672,LANDS END INC NEW,15.1549738751,78852,21.4528267254,43584,14.8940579185,38606,13.213969053,34963,-35268,-4978
1673,LANDSTAR SYS INC,85.3012448921,168368,85.6487776517,213278,85.60200505,214259,99.6523013519,203337,44910,981
1674,LANNET INC,22.0539931805,95901,22.348398819,198135,20.4015863516,152047,18.4516521481,256454,102234,-46088
1675,LANTHEUS HLDGS INC,8.60796236519,39963,12.5013101047,171742,17.6482107015,163416,17.7987366424,320416,131779,-8326
1676,LAREDO PETROLEUM INC,14.1397748568,1891685,14.599739787,1819279,10.5200972853,3082481,12.9300949535,1761704,-72406,1263202
1677,LAS VEGAS SANDS CORP,53.4101220888,1576967,57.0700447106,2456017,63.8902807331,3131337,64.160094811,4266172,879050,675320
1678,LASALLE HOTEL PPTYS,30.470193155,5248375,28.9500224635,4527354,29.800014354,4834897,29.0200764004,4576418,-721021,307543
1679,LATAM AIRLS GROUP S A,8.18008080888,302442,12.6690416794,337121,11.069949062,159802,13.2533080989,191273,34679,-177319
1680,LATTICE SEMICONDUCTOR CORP,7.36010294546,562628,6.92029470373,545497,6.65921854882,998015,5.21031629306,900905,-17131,452518
1681,LAUDER ESTEE COS INC,76.4896680597,2116495,84.7894704066,2039357,95.9804316375,2011410,107.839874086,2226273,-77138,-27947
1682,LAZARD LTD,41.0899169599,3027093,45.9900267709,3343551,46.3298527517,3037998,45.2200737789,3123657,316458,-305553
1683,LCNB CORP,23.2292460015,10504,23.8686045138,8463,19.9975051845,128266,20.9464967606,116535,-2041,119803
1684,LEAR CORP,132.369569727,2265770,141.579772062,2291761,142.080062942,2343756,173.079907486,2667710,25991,51995
1685,LEE ENTERPRISES INC,2.89989355269,282769,2.60012278358,276910,1.9015353137,269782,2.19792030524,186085,-5859,-7128
1686,LEGACY RESVS LP,2.12844715899,10806,2.31352952064,10806,1.49220323808,13403,1.52149106124,18403,0,2597
1687,LEGACY TEX FINL GROUP INC,43.060082384,2258449,39.8999244221,2225518,38.1299286978,2125181,39.9200881964,2317555,-32931,-100337
1688,LEGG MASON INC,29.9105143083,1439895,36.1101613455,1550090,38.1593895081,1370567,39.3094382834,1109937,110195,-179523
1689,LEGGETT & PLATT INC,48.8797735372,512932,50.3202660759,531277,52.5301049441,620330,47.7307196052,662655,18345,89053
1690,LEIDOS HLDGS INC,51.1398450916,4297119,51.1399082848,3949616,51.6897942407,3970513,59.2201026781,3895282,-347503,20897
1691,LEMAITRE VASCULAR INC,25.3164556962,13667,24.6230095961,18966,31.2244781676,52651,37.4100719424,63245,5299,33685
1692,LENDINGCLUB CORP,5.24930864633,522164,5.48994138498,982342,5.5096678781,1271220,6.08988838608,1567188,460178,288878
1693,LENDINGTREE INC NEW,101.361993885,21586,125.377281656,20873,172.192327721,17283,244.452873127,36911,-713,-3590
1694,LENNAR CORP,42.7716562816,1012189,51.1036755509,910639,53.0666381093,1139228,52.7649535147,1887048,-101550,228589
1695,LENNOX INTL INC,153.170870742,280680,167.302443681,252447,183.640197764,169293,178.972242796,141765,-28233,-83154
1696,LEUCADIA NATL CORP,23.2499884548,1429162,26.0004014394,1180751,26.1597762861,1933541,25.2502647777,3159254,-248411,752790
1697,LEVEL 3 COMMUNICATIONS INC,56.3599018714,5575542,57.2199941751,5394111,59.2998988195,5204562,53.2898734082,5699657,-181431,-189549
1698,LEXICON PHARMACEUTICALS INC,13.8310144313,169908,14.331714527,113664,16.4499451668,134043,12.2904524917,244336,-56244,20379
1699,LEXINGTON REALTY TRUST,10.7998175847,1302522,9.97936964477,1328140,9.90906518567,901195,10.2198295031,1061368,25618,-426945
1700,LG DISPLAY CO LTD,12.8755364807,14446,13.6191611121,76363,16.0741378603,73161,13.4212781587,65344,61917,-3202
1701,LGI HOMES INC,28.7242642632,58139,33.9056434757,66980,40.1836781384,61194,48.5681232368,98542,8841,-5786
1702,LHC GROUP INC,45.7101459275,57974,53.905097525,48808,67.8871651594,81606,70.9173957957,160694,-9166,32798
1703,LIBBEY INC,19.4695585821,43247,14.5726546668,33556,8.06006713606,106947,9.26811327694,40785,-9691,73391
1704,LIBERTY ALL STAR EQUITY FD,5.18168275147,15439,5.48006486607,17883,5.65443278319,47927,6.05476075658,18663,2444,30044
1705,LIBERTY BROADBAND CORP,73.9960906574,589869,86.3284208074,600845,86.7289118672,1001523,95.2674776204,1021020,10976,400678
1706,LIBERTY EXPEDIA HOLDINGS,39.6690210976,260077,45.4785497761,240487,54.0185099763,203782,53.1125427534,208463,-19590,-36705
1707,LIBERTY GLOBAL PLC,27.2197918047,17094914,34.8529501173,5000208,30.8162271631,8120754,32.6172204132,6106253,-12094706,3120546
1708,LIBERTY INTERACTIVE CORP,22.6117608624,1922274,23.4878657963,2345807,28.0186396719,1826427,26.0686618579,2642253,423533,-519380
1709,LIBERTY MEDIA CORP DELAWARE,33.3909757769,1881137,36.7278151987,2997728,38.3966750151,3280857,38.8099800478,6074520,1116591,283129
1710,LIBERTY PPTY TR,39.4998681836,4593509,38.5501346894,4422397,40.7099345221,3700792,41.059622596,1660025,-171112,-721605
1711,LIBERTY TRIPADVISOR HLDGS IN,15.0503091804,1048417,14.1000161856,376879,11.6000266412,450430,12.349056514,420356,-671538,73551
1712,LIFE STORAGE INC,85.2600463834,2066689,82.1199958446,2647175,74.0998414805,2559938,81.8098638808,2804454,580486,-87237
1713,LIFEPOINT HEALTH INC,56.8021814576,201700,65.4985255361,408284,67.1513459214,176199,57.9030582283,221370,206584,-232085
1714,LIGAND PHARMACEUTICALS INC,101.612464683,169182,105.840849969,241797,121.398210169,274551,136.150976916,265683,72615,32754
1715,LILLY ELI & CO,73.5499074816,7585516,84.1099602896,7415186,82.2998256247,8048158,85.54007082,7684270,-170330,632972
1716,LIMELIGHT NETWORKS INC,2.51999062434,30918369,2.57998732081,30918369,2.88998426705,30957954,3.97002105261,31039382,0,39585
1717,LINCOLN ELEC HLDGS INC,76.6715533607,296042,86.8621519659,262151,92.0899407473,233576,91.6812548947,347312,-33891,-28575
1718,LINCOLN NATL CORP IND,66.2700137342,6092816,65.4500789612,3698651,67.5798367504,2501323,73.47999657,2623925,-2394165,-1197328
1719,LINDSAY CORP,74.6268656716,20234,88.143525741,10256,89.3013482753,5711,91.9156489034,23663,-9978,-4545
1720,LINE CORP,34.0097497206,875102,38.4594951755,301174,34.7793910778,327004,36.2009112273,326373,-573928,25830
1721,LIONS GATE ENTMNT CORP,24.8126385795,1500042,25.1233136936,1046518,26.9039579816,1066200,32.2010198236,1523989,-453524,19682
1722,LIQTECH INTL INC,0.635352847742,22035,0.403768506057,22290,0.31679942071,22096,0.367027937303,46318,255,-194
1723,LIQUIDITY SERVICES INC,9.74627158462,209003,7.99952062798,200262,6.34796760348,105073,5.89071238654,43628,-8741,-95189
1724,LITHIA MTRS INC,96.831239218,715895,85.6503993109,683803,94.2300914312,723495,120.310038764,544061,-32092,39692
1725,LITTELFUSE INC,151.769087523,95586,159.907676526,58490,164.992952784,56760,195.880221247,89131,-37096,-1730
1726,LIVANOVA PLC,44.9682564091,91042,49.0098326071,398165,61.2122445918,373324,70.060428493,464185,307123,-24841
1727,LIVE NATION ENTERTAINMENT IN,26.5999473268,3842564,30.3699950218,3820646,34.8500900464,3824696,43.5500578363,3772716,-21918,4050
1728,LIVEPERSON INC,7.54725708471,129716,6.84983253167,39709,11.0035985606,62525,13.5511952936,117628,-90007,22816
1729,LKQ CORP,30.6503611065,2111427,29.2699329698,2075782,32.9501986315,2930301,35.9900380154,3229477,-35645,854519
1730,LLOYDS BANKING GROUP PLC,3.10010974801,3681160,3.40003146849,4601428,3.53006476614,5902158,3.66001292838,6274568,920268,1300730
1731,LOCKHEED MARTIN CORP,249.939958855,882728,267.59967166,1008712,277.60969331,1442727,310.290720986,1469003,125984,434015
1732,LOEWS CORP,46.8301350581,1121073,46.7704914407,1175442,46.809365607,1124839,47.8598668327,1040496,54369,-50603
1733,LOGITECH INTL S A,24.7700343,2103792,31.8696275505,1653110,36.6595534405,1588590,36.4602492236,1092834,-450682,-64520
1734,LOGMEIN INC,96.5449367254,114817,97.5003289041,532070,104.50008084,834985,110.05114421,757466,417253,302915
1735,LOMBARD MED INC,0.620842572062,22550,0.79822616408,22550,0.539713951606,22234,0.443037974684,15800,0,-316
1736,LORAL SPACE & COMMUNICATNS I,41.0610465116,13760,39.3893569525,13887,41.5530321813,20167,49.4968724504,25739,127,6280
1737,LOUISIANA PAC CORP,18.9297193085,769742,24.8188739703,564248,24.1106278407,1308676,27.0797491692,1784470,-205494,744428
1738,LOWES COS INC,71.1198696701,5035836,82.2099345614,4012155,77.5302388467,3978409,79.9401192432,6945136,-1023681,-33746
1739,LOXO ONCOLOGY INC,32.1125958275,42133,42.1024039114,44178,80.1878334155,89228,92.1234064512,118211,2045,45050
1740,LPL FINL HLDGS INC,35.2096863341,694752,39.8297804074,947482,42.4611058077,310072,51.5698897441,1229322,252730,-637410
1741,LSB INDS INC,8.41239602392,53017,9.37770413947,149077,10.3303650751,145203,7.94248246217,183318,96060,-3874
1742,LSC COMMUNICATIONS INC,29.678806741,458509,25.1596533592,407915,21.4002824349,188362,16.5098066226,246823,-50594,-219553
1743,LSI INDS INC,9.73690554082,116156,10.0957338545,111037,9.0630228667,50204,6.60782665546,42828,-5119,-60833
1744,LTC PPTYS INC,46.978861874,381065,47.8993210497,88519,51.3903416155,50671,46.9781635809,122227,-292546,-37848
1745,LULULEMON ATHLETICA INC,64.9893460089,378262,51.8704652545,519737,59.6713213741,381406,62.2500663565,455871,141475,-138331
1746,LUMBER LIQUIDATORS HLDGS INC,15.7456548532,79514,20.9871523245,140181,25.0570744474,143672,38.9822633105,187239,60667,3491
1747,LUMENTUM HLDGS INC,38.647050269,165032,53.3458986382,129457,57.0491230396,331942,54.3507137257,308662,-35575,202485
1748,LUMINEX CORP DEL,20.2277951393,193595,18.3726743187,180431,21.1160597328,133595,20.3304898234,219916,-13164,-46836
1749,LUMOS NETWORKS CORP,15.6175063638,81319,17.699331685,367641,17.8694496406,142198,17.9218352624,192670,286322,-225443
1750,LUXOFT HLDG INC,56.2064661594,24837,62.5466723994,88382,60.8500227583,70304,47.7810792677,20866,63545,-18078
1751,LYDALL INC DEL,61.864816906,49592,53.6191401506,32936,51.711026616,21040,57.2987721692,40315,-16656,-11896
1752,LYON WILLIAM HOMES,19.0296286599,908951,20.6207327014,994921,24.1400231431,817522,22.9894507331,887929,85970,-177399
1753,LYONDELLBASELL INDUSTRIES N,85.7796716054,2823676,91.1901268159,3319537,84.3903227666,3538036,99.0498925839,4730202,495861,218499
1754,M & T BK CORP,156.429511945,967554,154.729469109,814066,161.949062924,858628,161.040231916,897223,-153488,44562
1755,M D C HLDGS INC,25.6621184867,273516,30.0541019251,176149,35.3298217162,464933,33.2110713613,663875,-97367,288784
1756,M/I HOMES INC,25.1795125531,1392521,24.4995746602,1152020,28.5496441027,988909,26.7309789379,979388,-240501,-163111
1757,MA COM TECHNOLOGY SOLUTIONS,46.2815747044,178624,48.299730124,780729,55.7698753502,316246,44.6123154148,404014,602105,-464483
1758,MACATAWA BK CORP,10.4299160519,19655,9.8669457318,26756,9.54156613292,27354,10.2644486019,39554,7101,598
1759,MACERICH CO,70.8402636445,774376,64.4010040468,1184407,58.0597201239,1249696,54.9703801509,1073942,410031,65289
1760,MACK CALI RLTY CORP,29.0197536517,650867,26.938104051,393903,27.138785785,396849,23.7085570419,494505,-256964,2946
1761,MACQUARIE INFRASTRUCTURE COR,81.7003591165,1294009,80.5804166297,1440896,78.3997837662,1398486,72.1796662395,1389020,146887,-42410
1762,MACROGENICS INC,20.4281859911,57078,18.5974594008,117059,17.5076143213,93902,18.4765044804,61267,59981,-23157
1763,MACYS INC,35.8098351723,3303450,29.6400589445,2878638,23.2398899992,2882888,21.8200975464,3105394,-424812,4250
1764,MADDEN STEVEN LTD,35.7498997944,925597,38.552943184,240267,39.9471096544,214784,43.298409948,435143,-685330,-25483
1765,MADISON SQUARE GARDEN CO NEW,171.521136413,32101,199.710796915,118256,196.901076853,172447,214.100281353,147146,86155,54191
1766,MAGELLAN HEALTH INC,75.2485263506,154209,69.0504103165,85300,72.8986704725,79878,86.2999096145,246721,-68909,-5422
1767,MAGELLAN MIDSTREAM PRTNRS LP,75.6298833515,10346122,76.9100117288,10026640,71.269986288,10306316,71.060006048,10036405,-319482,279676
1768,MAGICJACK VOCALTEC LTD,6.85107201642,93562,8.5508097178,168639,7.20293602905,153132,7.14924815622,115117,75077,-15507
1769,MAGNA INTL INC,43.399887045,1366916,43.160111521,1105442,46.3298131336,983751,53.3788463441,667062,-261474,-121691
1770,MAIDEN HOLDINGS LTD,17.4498692425,3067129,13.9999324299,3019086,11.1000223873,2488013,7.94947582702,848861,-48043,-531073
1771,MAIN STREET CAPITAL CORP,36.7695672074,19663,38.2683568524,16724,38.4521840646,41116,39.7627843671,30858,-2939,24392
1772,MAINSOURCE FINANCIAL GP INC,34.4243450904,16529,32.9529805233,20332,33.5065086685,17131,35.8157765801,20410,3803,-3201
1773,MALIBU BOATS INC,19.0853184421,28294,22.4389220929,28611,25.8710431955,77809,31.6365684178,209536,317,49198
1774,MALLINCKRODT PUB LTD CO,49.8195474054,1189232,44.5699475063,1127374,44.8096472258,1062606,37.370160179,1687175,-61858,-64768
1775,MANCHESTER UTD PLC NEW,14.2537233853,84399,16.8954190115,78542,16.2612236375,38312,18.0059381285,31323,-5857,-40230
1776,MANHATTAN ASSOCS INC,53.0294512224,649243,52.0498336361,503114,48.0610756436,422296,41.5699559473,612221,-146129,-80818
1777,MANITOWOC INC,5.98153249668,313632,5.70040959237,301031,6.00604501719,230934,9.00010102812,465217,-12601,-70097
1778,MANNKIND CORP,0.636692274575,7702308,1.47976997001,1562405,1.40987275634,2083876,2.17005326494,704591,-6139903,521471
1779,MANPOWERGROUP INC,88.8703162886,1573405,102.568878482,1315360,111.650673891,1184910,117.820211021,1199217,-258045,-130450
1780,MANTECH INTL CORP,42.2508896042,117749,34.6245550987,28939,41.3779097809,39393,44.1513293949,269822,-88810,10454
1781,MANULIFE FINL CORP,17.8200459137,4746733,17.7401034149,2665768,18.7602582108,4727920,20.2896819917,2679490,-2080965,2062152
1782,MARATHON OIL CORP,17.309946982,4368702,15.8000590662,3565493,11.8500905204,4730428,13.559891005,8746088,-803209,1164935
1783,MARATHON PETE CORP,50.3499421773,6786264,50.5401672025,5220976,52.3300333695,8004027,56.0801167815,5765983,-1565288,2783051
1784,MARCHEX INC,2.66631554692,30379,2.73087554534,30027,2.97911793636,212479,3.0939556036,53653,-352,182452
1785,MARCUS CORP,31.5060273823,91665,32.1077484706,80261,30.2000105826,75596,27.7005999015,119853,-11404,-4665
1786,MARIN SOFTWARE INC,2.35109009196,110587,1.79622370381,94643,1.30042427984,76129,1.7452256634,69905,-15944,-18514
1787,MARINEMAX INC,19.3459858529,51742,21.6512496136,84106,19.5461502952,82318,16.5384106058,67963,32364,-1788
1788,MARKEL CORP,904.479655712,51120,975.852296547,59633,975.851153943,67291,1067.98477479,56748,8513,7658
1789,MARKETAXESS HLDGS INC,146.920979231,385772,187.488336343,316153,201.100623796,306190,184.511276723,306339,-69619,-9963
1790,MARLIN BUSINESS SVCS CORP,20.9011797315,204199,25.7493915249,204199,25.1519351221,204199,28.7478505549,191910,0,0
1791,MARRIOTT INTL INC NEW,82.6793815299,1891959,94.1805488388,1554992,100.310147982,1852664,110.260640864,1788553,-336967,297672
1792,MARRIOTT VACATIONS WRLDWDE C,84.8500442888,878326,99.9303832564,988268,117.748913841,664728,124.530079616,530675,109942,-323540
1793,MARSH & MCLENNAN COS INC,67.5901665956,3123191,73.8899350368,3919140,77.9601297202,4546093,83.8100256204,3822347,795949,626953
1794,MARTEN TRANS LTD,23.2957800267,73318,23.4512330944,670711,27.4006146161,980124,20.5500938414,1673569,597393,309413
1795,MARTIN MARIETTA MATLS INC,221.529626978,715024,218.251079859,564657,222.579555747,390858,206.228987158,435448,-150367,-173799
1796,MARTIN MIDSTREAM PRTNRS L P,18.3446968539,32707,19.9992213152,385265,17.5503090117,462442,15.5504014011,272919,352558,77177
1797,MARVELL TECHNOLOGY GROUP LTD,13.8699485008,9550432,15.2599160549,6573103,16.5200231456,6855741,17.9000423066,9071878,-2977329,282638
1798,MASCO CORP,31.6198585304,1985303,33.9897910471,2779717,38.2100748278,4039275,39.0097676898,4426840,794414,1259558
1799,MASIMO CORP,67.3979832613,311493,93.2605173138,433238,91.1802878562,361361,86.5607568269,452838,121745,-71877
1800,MASONITE INTL CORP NEW,65.8007530245,568109,79.2501345078,319684,75.4992958897,385593,69.2010538156,270256,-248425,65909
1801,MASTEC INC,38.2411583654,103318,40.0486111111,144000,45.1490431481,214401,46.394943707,138916,40682,70401
1802,MASTERCARD INCORPORATED,103.250027757,6331669,112.470003098,7004890,121.450202688,6904690,141.20012999,7108230,673221,-100200
1803,MATADOR RES CO,25.7629926753,229360,23.7890374413,392828,21.3699514044,495930,27.1498525544,664313,163468,103102
1804,MATCH GROUP INC,17.1002786256,1429158,16.3261036998,105169,17.3843347521,72364,23.1960260284,68848,-1323989,-32805
1805,MATERION CORP,39.6021930384,117645,33.5520320758,109740,37.3901663862,96282,43.1501099919,138192,-7905,-13458
1806,MATRIX SVC CO,22.6955126546,77284,16.4961261712,57953,9.35453695042,84451,15.2005072119,126180,-19331,26498
1807,MATSON INC,35.3880535486,92178,31.7559153176,64240,30.0410574669,73799,28.1757549558,129544,-27938,9559
1808,MATTEL INC,27.5500956705,1932153,25.6098751411,3472801,21.5299096227,3666295,15.4799200053,4236779,1540648,193494
1809,MATTHEWS INTL CORP,76.8397799627,69261,67.6482724173,92094,61.2551635863,103126,62.2547912002,194732,22833,11032
1810,MAXIM INTEGRATED PRODS INC,38.5700417544,4822966,44.9595437106,2904122,44.900010609,3770400,47.7100171443,4042170,-1918844,866278
1811,MAXIMUS INC,55.7904870874,936916,62.2011025993,361328,62.6288871713,304045,64.4995788555,364483,-575588,-57283
1812,MAXLINEAR INC,21.7975717275,147677,28.0504308204,233508,27.8948944332,123571,23.7467750437,180235,85831,-109937
1813,MB FINANCIAL INC NEW,47.2300449493,2207599,42.820184004,2147562,44.0398739856,2071827,45.0198009801,2296856,-60037,-75735
1814,MBIA INC,10.7047808263,134893,8.47151688923,576166,9.42969258196,616457,8.69982803255,591391,441273,40291
1815,MBT FINL CORP,11.3455061159,11282,11.3532382147,59014,9.70779347107,51402,10.9456795159,29418,47732,-7612
1816,MCBC HLDGS INC,14.5783836901,160786,16.1686925861,86216,19.5490108159,238631,20.3794540324,243824,-74570,152415
1817,MCCORMICK & CO INC,93.3306111772,1253908,97.5499296512,889852,97.5097979311,1067062,102.640608818,1103647,-364056,177210
1818,MCDERMOTT INTL INC,7.3899251322,1207996,6.74963479967,1883213,7.17004819971,3071388,7.27007215276,3649895,675217,1188175
1819,MCDONALDS CORP,121.720021563,5574465,129.610019982,5250628,153.159978881,5233247,156.68001177,5216645,-323837,-17381
1820,MCEWEN MNG INC,2.910570599,424659,3.03913428089,184263,2.63029848049,719310,1.95476123988,103849,-240396,535047
1821,MCGRATH RENTCORP,39.1900239128,163511,33.5708868456,159543,34.6288347624,196166,43.7491022627,264554,-3968,36623
1822,MCKESSON CORP,140.450305763,1295120,148.25969363,1947387,164.540097953,2079171,153.60991252,2412787,652267,131784
1823,MDU RES GROUP INC,28.7699613488,1842373,27.3701316222,982129,26.2000623608,586907,25.949064847,1013524,-860244,-395222
1824,MECHEL PAO,5.73196183661,134160,5.31570458104,169874,4.62870091757,134595,5.16870525539,218043,35714,-35279
1825,MEDEQUITIES RLTY TR INC,11.0998705317,1377944,11.2102118929,2191484,12.6200709543,2193807,11.7501087129,2304234,813540,2323
1826,MEDICAL PPTYS TRUST INC,12.2997551406,1320758,12.8895098466,1653360,12.8697107339,2091500,13.1303317851,1127085,332602,438140
1827,MEDICINES CO,33.940199185,705977,48.9001723922,2070279,38.0102101411,2147081,37.0402923126,3060559,1364302,76802
1828,MEDICINOVA INC,6.03253258645,27849,5.98028720145,27089,5.26691287561,47656,6.37977032827,25863,-760,20567
1829,MEDIDATA SOLUTIONS INC,49.6655716667,143379,57.6882523907,109069,78.1977972284,336122,78.0604239824,508606,-34310,227053
1830,MEDIFAST INC,41.6404742809,46133,44.3833073685,30169,41.4704372475,89606,59.3737513168,55058,-15964,59437
1831,MEDLEY CAP CORP,7.50803883256,129994,7.69361017631,94494,6.39267402482,136719,5.97066773777,184234,-35500,42225
1832,MEDNAX INC,66.6604124234,1289791,69.3796151471,1136746,60.3705471412,1085314,43.1198747965,634487,-153045,-51432
1833,MEDPACE HLDGS INC,36.0076909631,5721,29.8468194574,34208,28.9997117325,34690,31.8922432148,44619,28487,482
1834,MEDTRONIC PLC,71.2299925033,4131139,80.5600757908,4691865,88.7499979617,6132710,77.7699645261,6810367,560726,1440845
1835,MELLANOX TECHNOLOGIES LTD,40.89578616,72428,50.9450818131,85072,43.3013389602,582915,47.1515282144,547469,12644,497843
1836,MERCADOLIBRE INC,156.139969572,391085,211.469469433,332814,250.879136309,320485,258.929967376,479705,-58271,-12329
1837,MERCANTILE BANK CORP,37.7233956133,19696,34.3864173651,13959,31.471917366,18588,34.8926802422,18170,-5737,4629
1838,MERCER INTL INC,10.6505128558,625322,11.6992619581,747654,11.4994390894,647162,11.849830218,630220,122332,-100492
1839,MERCK & CO INC NEW,58.8700664206,12308989,63.5400638713,15240951,64.0899921426,15733018,64.0299730906,19195885,2931962,492067
1840,MERCURY GENL CORP NEW,60.2103169474,557064,60.9904316944,548791,53.9986101088,598608,56.6909912483,616112,-8273,49817
1841,MERCURY SYS INC,30.2231943133,120702,39.0496565885,1231176,42.0901537655,1293723,51.8795647537,1185168,1110474,62547
1842,MEREDITH CORP,59.1485347235,266059,64.6008975119,330692,59.4487377486,334759,55.4978035612,298210,64633,4067
1843,MERIDIAN BANCORP INC MD,18.8973333494,82763,18.3007897972,239935,16.9002829757,242777,18.6494963308,331269,157172,2842
1844,MERIDIAN BIOSCIENCE INC,17.6973298122,163584,13.7981938827,132771,15.7514302855,136686,14.2983052796,208766,-30813,3915
1845,MERIT MED SYS INC,26.500445236,112300,28.9004615571,131728,38.1354196535,24413,42.35446996,197004,19428,-107315
1846,MERITAGE HOMES CORP,34.8002098924,815656,36.7999799748,798995,42.2002742662,800682,44.3999558885,589415,-16661,1687
1847,MERITOR INC,12.4221110137,174447,17.1339563863,96942,16.6051328231,166575,26.0115489158,245391,-77505,69633
1848,MERRIMACK PHARMACEUTICALS IN,4.08329930584,161634,3.07982316517,1264683,1.23958594097,910788,14.5379500115,109025,1103049,-353895
1849,MESOBLAST LTD,5.34979423868,243000,8.97942386831,243000,7.95146974868,243477,5.48251748252,143000,0,477
1850,METHANEX CORP,43.7985717788,314097,46.898926003,189386,44.0512596476,96138,50.3006783778,168785,-124711,-93248
1851,METHODE ELECTRS INC,41.3499651297,113277,45.5949904217,97094,41.207824887,73918,42.350861688,169725,-16183,-23176
1852,METLIFE INC,53.8898965937,8466986,52.8199826329,9534119,54.9399749284,9297365,51.9500587791,10127746,1067133,-236754
1853,METTLER TOLEDO INTERNATIONAL,418.559902573,656900,478.90800947,554144,588.537242149,554439,626.161774946,479654,-102756,295
1854,MFA FINL INC,7.63001370377,7827771,8.08002702538,2356304,8.39022987779,3005162,8.75992537282,3113611,-5471467,648858
1855,MGE ENERGY INC,65.2957027372,35255,64.9910815632,30835,64.3305877426,35815,64.6103896104,36960,-4420,4980
1856,MGIC INVT CORP WIS,10.1902626095,781236,10.1295621123,905666,11.2000274437,4839006,12.5299723253,7709195,124430,3933340
1857,MGM GROWTH PPTYS LLC,25.3115554695,67163,27.0490789962,80890,29.1847930131,151483,30.2106193177,35087,13727,70593
1858,MGM RESORTS INTERNATIONAL,28.830008337,2043912,27.3998543142,3754655,31.2900316273,2801691,32.5900707456,3023651,1710743,-952964
1859,MGP INGREDIENTS INC NEW,49.9793618257,428817,54.2293092874,603290,51.1697891742,640671,60.630781584,545482,174473,37381
1860,MICHAEL KORS HLDGS LTD,42.9800371384,3337247,38.1099070404,2292501,36.2502881678,2056094,47.8499791867,1599938,-1044746,-236407
1861,MICHAELS COS INC,20.4486559387,424869,22.3891876,483001,18.5193144833,837558,21.4706173149,829366,58132,354557
1862,MICROCHIP TECHNOLOGY INC,64.1501514353,1701056,73.7797176605,1556566,77.1796262781,1096805,89.7800278477,1637480,-144490,-459761
1863,MICRON TECHNOLOGY INC,21.9200336053,12559926,28.899983048,12712395,29.8600259921,10708631,39.3300542989,14706565,152469,-2003764
1864,MICROSEMI CORP,53.9699014011,940376,51.5297275403,535749,46.8001264617,967882,51.4798266163,898585,-404627,432133
1865,MICROSOFT CORP,62.1400011936,38555857,65.8599750954,41113772,68.9299854723,43328879,74.4899917196,41967799,2557915,2215107
1866,MICROSTRATEGY INC,197.40797546,65200,187.81275222,37170,191.663636947,46759,127.708470125,82242,-28030,9589
1867,MID AMER APT CMNTYS INC,97.9201070478,4896502,101.739966445,4508995,105.379815052,3302976,106.879948301,3274356,-387507,-1206019
1868,MID CON ENERGY PARTNERS LP,2.6013143483,51128,2.36493713308,84146,1.35478810639,84146,1.13984469616,42111,33018,0
1869,MIDDLEBY CORP,128.810441812,2548753,136.450512814,2357580,121.509811177,2859086,128.170043048,3448021,-191173,501506
1870,MIDDLESEX WATER CO,42.9243344445,21899,36.9454923897,15374,39.6003559583,24722,39.2993045532,15242,-6525,9348
1871,MIDSTATES PETE CO INC,20.7406702662,294301,18.4506376949,317550,12.6747979305,48127,15.5457592986,81437,23249,-269423
1872,MILACRON HLDGS CORP,18.6242642537,11383,18.6073557203,55032,17.586476383,200893,16.8575083461,320510,43649,145861
1873,MILLER HERMAN INC,34.2002126283,1268881,31.5497265275,1090786,30.3991856617,888083,35.8991127824,599402,-178095,-202703
1874,MILLER INDS INC TENN,26.4421734517,35814,26.3701489913,22753,24.8608685055,24617,27.9632421567,27858,-13061,1864
1875,MIMEDX GROUP INC,8.86032034365,256537,9.53033417066,197055,14.9698836887,577760,11.8798296532,827958,-59482,380705
1876,MINERALS TECHNOLOGIES INC,77.2502907478,1235607,76.6002089892,1200062,73.1997811264,1220796,70.6494915115,1169053,-35545,20734
1877,MINERVA NEUROSCIENCES INC,11.7436346244,49133,8.1000501306,37901,8.86140870755,35096,7.59878419453,27636,-11232,-2805
1878,MISTRAS GROUP INC,25.685931115,20556,21.3903743316,17204,21.9814241486,16150,20.5128205128,15795,-3352,-1054
1879,MITEK SYS INC,6.1215566244,11435,6.64961636829,365585,8.39918341272,360035,9.49567880976,45705,354150,-5550
1880,MITEL NETWORKS CORP,6.82076544146,15834,6.95592286501,14520,7.3505341785,67206,8.39552238806,20368,-1314,52686
1881,MITSUBISHI UFJ FINL GROUP IN,6.15993782688,4026177,6.3401523545,4338697,6.75008670496,4728680,6.43987497381,4677420,312520,389983
1882,MIZUHO FINL GROUP INC,3.59009904509,2363166,3.68986189811,2677878,3.66990160404,2863837,3.55010086622,2767527,314712,185959
1883,MKS INSTRUMENT INC,59.4009169916,1026836,68.749689714,825851,67.2990640013,579488,94.4514178022,276449,-200985,-246363
1884,MOBILE MINI INC,30.2498749213,991376,30.4999652641,1079575,29.8498907319,1256085,34.4501157459,1479966,88199,176510
1885,MOBILE TELESYSTEMS PJSC,9.1100487203,2454213,11.0299697388,4210347,8.38000544698,4600713,10.4400980403,1726229,1756134,390366
1886,MOBILEIRON INC,3.75140487835,65842,4.3436928702,68375,6.04926423544,312600,3.70104611201,211832,2533,244225
1887,MODINE MFG CO,14.8992018476,187057,12.1963655646,49031,16.5474482369,190966,19.2512532271,166171,-138026,141935
1888,MOELIS & CO,33.8973729078,54547,38.4976250513,136424,38.8501820654,244143,43.0499944793,1720790,81877,107719
1889,MOHAWK INDS INC,199.679866411,433569,229.491354429,648251,241.690437883,771942,247.50957428,718853,214682,123691
1890,MOLINA HEALTHCARE INC,54.259424605,535354,45.601127166,297383,69.179966451,521625,68.7589910282,455315,-237971,224242
1891,MOLSON COORS BREWING CO,97.3098199225,2881703,95.7099817608,2755606,86.3398055181,4203681,81.6398942284,4602370,-126097,1448075
1892,MOMENTA PHARMACEUTICALS INC,15.0502299982,346307,13.3495415646,494399,16.9002071244,769103,18.4996174856,539849,148092,274704
1893,MOMO INC,18.3797973585,1248708,34.0701610516,1087726,36.9598767057,1899844,31.3399020188,965287,-160982,812118
1894,MONARCH CASINO & RESORT INC,25.7785605636,37473,29.5510587499,25549,30.2543660922,34871,39.5193977997,55264,-11924,9322
1895,MONDELEZ INTL INC,44.3299895792,7208664,43.079862071,7520103,43.1899354609,9573573,40.6599315386,6425515,311439,2053470
1896,MONEYGRAM INTL INC,11.7984777857,37971,16.8022964894,37971,17.2413793103,37990,16.1095025007,37990,0,19
1897,MONMOUTH REAL ESTATE INVT CO,15.2397913751,78610,14.2744000147,54293,15.0471573592,41669,16.191281335,54412,-24317,-12624
1898,MONOLITHIC PWR SYS INC,81.9313637512,114779,92.1036297138,104719,96.3996959436,376246,106.549690795,410569,-10060,271527
1899,MONOTYPE IMAGING HOLDINGS IN,19.849853671,94308,20.0923703542,54996,18.3072477325,59867,19.2463514781,109839,-39312,4871
1900,MONSANTO CO NEW,105.210206068,4128877,113.200136131,3050014,118.360070387,3901265,119.819878741,4602233,-1078863,851251
1901,MONSTER BEVERAGE CORP NEW,44.3402009636,4169512,46.1696097894,3263597,49.6798969689,3852041,55.2500488145,4419797,-905915,588444
1902,MOODYS CORP,94.2703382698,569161,112.039370379,707537,121.680276073,681269,139.21053278,814220,138376,-26268
1903,MOOG INC,65.6801064938,1009636,67.349044353,869411,71.7201152754,868529,83.4305164453,843768,-140225,-882
1904,MORGAN STANLEY,42.2499199389,12128236,42.8401342243,10175505,44.5599422941,8991798,48.170116048,8496741,-1952731,-1183707
1905,MORGAN STANLEY ASIA PAC FD I,13.5006871551,536269,15.3505050637,536269,16.6308959321,500875,17.2410798795,460644,0,-35394
1906,MORGAN STANLEY EM MKTS DM DE,7.20288115246,10829,7.60674560459,13935,7.9302832244,11475,8.07050092764,10780,3106,-2460
1907,MORNINGSTAR INC,73.5600907029,55125,78.5975973417,46948,78.3307916262,50491,84.9998384648,30953,-8177,3543
1908,MOSAIC CO NEW,29.329919761,3459914,29.1802415583,1717018,22.8301204774,2381941,21.5898066341,2160464,-1742896,664923
1909,MOSYS INC,0.231450228557,51847,2.11130359463,18472,1.6967126193,28290,0.971480119353,14411,-33375,9818
1910,MOTOROLA SOLUTIONS INC,82.889323766,574875,86.2202287475,544443,86.7404746794,601922,84.8695103426,614838,-30432,57479
1911,MOVADO GROUP INC,28.7576020851,57550,24.9560988788,59224,25.2463524559,52364,28.0078975758,98258,1674,-6860
1912,MPLX LP,34.6200112864,14994998,36.0800052536,16171838,33.4000013753,18323622,35.0099739426,17173249,1176840,2151784
1913,MRC GLOBAL INC,20.2601095486,329169,18.3285251205,157023,16.5196530052,219254,17.4882139765,311810,-172146,62231
1914,MSA SAFETY INC,69.3313916426,352957,70.6916281412,109235,81.1692676992,304943,79.5092589228,412845,-243722,195708
1915,MSC INDL DIRECT INC,92.3901891549,1359679,102.760449455,1310475,85.9592915231,1095251,75.5714752472,413185,-49204,-215224
1916,MSCI INC,78.7799289215,1036038,97.1900304767,608334,102.989848973,504875,116.899972455,1045552,-427704,-103459
1917,MSG NETWORK INC,21.5006253959,307805,23.3499924401,244711,22.4504889009,1771320,21.1994211506,798135,-63094,1526609
1918,MTGE INVT CORP,15.6995189523,630083,16.7507910287,436457,18.7996630776,197078,19.3970821628,235654,-193626,-239379
1919,MTS SYS CORP,56.7089660911,24035,55.0558312655,19344,51.759232335,6878,53.4423349774,29602,-4691,-12466
1920,MUELLER INDS INC,39.9638533568,128366,34.238659347,96908,30.4503824002,63546,34.9457858261,143136,-31458,-33362
1921,MUELLER WTR PRODS INC,13.310026129,545754,11.8192930376,400870,11.6798697214,367213,12.7985195929,199945,-144884,-33657
1922,MULTI COLOR CORP,77.6133088813,15268,71.0333482877,6687,81.5294355654,4943,81.9287308551,25986,-8581,-1744
1923,MURPHY OIL CORP,31.1301073503,2447502,28.5900755341,4530803,25.629865946,4753829,26.5599988191,5961559,2083301,223026
1924,MURPHY USA INC,61.4703326266,903265,73.4199312009,856988,74.1093986674,672074,69.0002208143,706476,-46277,-184914
1925,MVC CAPITAL INC,8.57124019252,15167,9.01054063244,11764,9.84796129924,11576,10.0090307044,13288,-3403,-188
1926,MYERS INDS INC,14.3037442154,54671,15.850096807,91419,17.9475709045,55885,20.9442816056,72669,36748,-35534
1927,MYLAN N V,38.1499900475,5792531,38.9900928874,6203422,38.8200664615,7524356,31.370153052,9705850,410891,1320934
1928,MYOKARDIA INC,12.9662749106,15656,13.1560283688,56400,13.1044665928,48762,42.8412106295,52006,40744,-7638
1929,MYR GROUP INC DEL,37.6816969569,113238,41.0030607314,93115,31.0273040275,74934,29.1375057653,49867,-20123,-18181
1930,MYRIAD GENETICS INC,16.6692272238,872206,19.2002290051,950197,25.8406860493,1001444,36.1795798327,892216,77991,51247
1931,NABORS INDUSTRIES LTD,16.3999379591,2127630,13.0699531892,3863212,8.13992949328,3948560,8.06991307549,3770053,1735582,85348
1932,NACCO INDS INC,90.3885480573,2445,69.7748938556,12483,70.805285465,8022,85.8939987626,9698,10038,-4461
1933,NANOMETRICS INC,25.0527023311,65462,30.4712279112,44140,25.2789264258,38451,28.8049172313,71585,-21322,-5689
1934,NANOSTRING TECHNOLOGIES INC,22.2958542087,50099,19.8652400151,71683,16.5413961963,70248,16.160354324,88055,21584,-1435
1935,NANOVIRICIDES INC,1.06000824451,16981,1.12133632356,25862,1.34042812462,24619,1.16432507956,12883,8881,-1243
1936,NANTHEALTH INC,9.94485806853,93214,4.95602795245,88579,4.22751956039,169603,4.11747558665,137220,-4635,81024
1937,NANTKWEST INC,5.72121793048,66769,3.54604645619,67117,7.58489915532,52209,5.47875537473,43258,348,-14908
1938,NASDAQ INC,67.1198554756,1774095,69.4504155646,1316522,71.4902317479,1295114,77.5699736981,1841692,-457573,-21408
1939,NATERA INC,11.696883616,11969,8.85770159899,17386,10.8790505556,17189,12.8754003742,31533,5417,-197
1940,NATIONAL BEVERAGE CORP,51.0649918078,10986,84.4759804392,10429,93.5619957919,94579,124.044041872,110622,-557,84150
1941,NATIONAL BK HLDGS CORP,31.8975891665,75617,32.5014435106,77935,33.1174565793,33970,35.6919642857,89600,2318,-43965
1942,NATIONAL CINEMEDIA INC,14.7293331698,105979,12.6340773198,109545,7.42160807835,158052,6.98344901228,140475,3566,48507
1943,NATIONAL FUEL GAS CO N J,56.6400686343,298393,59.6189656156,385582,55.8401207971,700679,56.6099021704,597263,87189,315097
1944,NATIONAL GEN HLDGS CORP,24.9894746914,2090200,23.7598758588,2058302,21.1001546458,1571979,19.1092152676,585843,-31898,-486323
1945,NATIONAL GRID PLC,58.3296163267,255582,63.4803244315,246092,62.8208096177,250538,62.7120736917,202465,-9490,4446
1946,NATIONAL HEALTH INVS INC,74.1666167933,66836,72.6297558523,89495,79.2022220471,418713,77.290242364,1103464,22659,329218
1947,NATIONAL HEALTHCARE CORP,75.8229897464,7412,71.2924132673,10492,70.1620104605,15678,62.5622477329,38154,3080,5186
1948,NATIONAL INSTRS CORP,30.818649403,667453,32.5589315775,563747,40.2197935273,1056992,42.1693310411,871937,-103706,493245
1949,NATIONAL OILWELL VARCO INC,37.439945559,3826528,40.0896635155,1826830,32.9396367029,1389056,35.730428178,2146070,-1999698,-437774
1950,NATIONAL PRESTO INDS INC,106.413529036,12536,102.216619393,9519,110.537895456,13181,106.459462449,18082,-3017,3662
1951,NATIONAL RESH CORP,19.010852939,13729,19.6611253197,12512,26.9173473057,19467,37.6081233546,5318,-1217,6955
1952,NATIONAL RETAIL PROPERTIES I,44.1999532955,2072604,43.6201533688,2116728,39.099939787,1818545,41.6595436912,1672990,44124,-298183
1953,NATIONAL STORAGE AFFILIATES,22.0702754036,105300,23.9020349607,117103,23.108115366,297904,24.2353178143,139012,11803,180801
1954,NATIONSTAR MTG HLDGS INC,18.05865372,60968,15.7588366791,45181,17.9042179262,27312,18.5743061374,56099,-15787,-17869
1955,NATURAL GAS SERVICES GROUP,32.1794966418,13549,26.0814249364,14148,24.8473813859,9337,28.4050179211,22320,599,-4811
1956,NATURAL HEALTH TRENDS CORP,24.8753431565,17849,28.9101917255,19820,27.8482378974,18529,23.8911053743,21305,1971,-1291
1957,NATURAL RESOURCE PARTNERS L,32.2992574368,491002,36.1489178737,444218,27.5505637053,518356,24.7506410783,547905,-46784,74138
1958,NATUS MEDICAL INC DEL,34.8030641173,132632,39.2555442625,60017,37.2998880569,92011,37.5028848373,103992,-72615,31994
1959,NAUTILUS INC,18.5001396173,297241,18.2492236974,327192,19.1497096594,203554,16.9058830204,52881,29951,-123638
1960,NAVIDEA BIOPHARMACEUTICALS I,0.637912837353,816726,0.577515585702,346311,0.509050720876,298595,0.41592575916,262066,-470415,-47716
1961,NAVIGANT CONSULTING INC,26.1781925685,258765,22.8600742794,284601,19.7613923654,239305,16.9199189866,292791,25836,-45296
1962,NAVIGATORS GROUP INC,117.76187378,29203,54.2994325622,34365,54.9138420754,36967,58.3558519861,64021,5162,2602
1963,NAVIOS MARITIME ACQUIS CORP,1.70172707194,220952,1.71933244836,204149,1.46688840561,234510,1.21785055406,82933,-16803,30361
1964,NAVIOS MARITIME HOLDINGS INC,1.40809593221,242171,1.87029803578,858152,1.36970613681,881941,1.67004484862,498789,615981,23789
1965,NAVISTAR INTL CORP NEW,31.3677572609,117031,24.6189565966,99923,26.224339306,117982,44.0737223163,145302,-17108,18059
1966,NBT BANCORP INC,41.8782098313,68150,37.0816139386,34896,36.963036963,12012,36.7180417044,114712,-33254,-22884
1967,NCI BUILDING SYS INC,15.652173913,257600,17.1515196233,149083,16.6965620329,133800,15.5994964796,166031,-108517,-15283
1968,NCR CORP NEW,40.5596167827,896828,45.6799769876,980342,40.840715934,1004953,37.5197497018,800645,83514,24611
1969,NEENAH PAPER INC,85.1903842779,68388,74.6961047947,63591,80.2342040921,46626,85.5436388157,62284,-4797,-16965
1970,NEFF CORP,14.0983398809,31564,19.4536704399,44259,18.9933169362,80502,25.0012279582,20359,12695,36243
1971,NEKTAR THERAPEUTICS,12.2698364091,480039,23.4692751583,643437,19.5499275651,799338,23.9993677722,949025,163398,155901
1972,NELNET INC,50.7453171013,65878,43.8664932813,57675,47.0152475742,44007,50.4900588071,35710,-8203,-13668
1973,NEOGEN CORP,65.9994534773,146380,65.5492762158,113777,69.1074879724,194552,77.4608888274,274474,-32603,80775
1974,NEOGENOMICS INC,8.55527830117,19637,7.88689606824,17117,8.96407849273,30678,11.1342713219,57570,-2520,13561
1975,NEOPHOTONICS CORP,10.7991360691,14816,9.00938218421,96566,7.72172908999,96999,5.55520081732,140949,81750,433
1976,NET 1 UEPS TECHNOLOGIES INC,11.4912997781,42815,12.2433273866,28587,9.8642110192,32035,9.72590627763,11310,-14228,3448
1977,NETAPP INC,35.2699708231,2080410,41.8501768401,2028952,40.0500184551,1872109,43.7593372267,1767120,-51458,-156843
1978,NETEASE INC,215.338381715,478173,283.997659927,382894,300.630842571,419122,263.810972162,433333,-95279,36228
1979,NETFLIX INC,123.800023711,3871639,147.809997979,4491868,149.410055516,5045390,181.350049146,5372797,620229,553522
1980,NETGEAR INC,54.3541473066,166795,49.5510057471,111360,43.0994204776,121997,47.6035432128,208850,-55435,10637
1981,NETLIST INC,1.0089120565,35682,0.987876066457,33405,1.03568402222,31863,0.723127312944,23509,-2277,-1542
1982,NETQIN MOBILE INC,3.21217244294,23660,4.17365577906,75713,3.39550218985,60963,3.4987843207,67452,52053,-14750
1983,NETSCOUT SYS INC,31.4998112007,2174267,37.9499443927,2211940,34.3999065186,3517277,32.3499880523,3481856,37673,1305337
1984,NETWORK 1 TECHNOLOGIES INC,3.3593518427,10121,4.86593843098,10070,4.24536787192,55590,3.85612658733,45123,-51,45520
1985,NEUROCRINE BIOSCIENCES INC,38.6998251877,746515,43.3000047593,1743949,46.0000067309,2674217,61.2797879884,2438357,997434,930268
1986,NEVRO CORP,72.6605605905,1412582,93.700229512,1486197,74.4301448831,1149064,90.8800233869,1204093,73615,-337133
1987,NEVSUN RES LTD,3.09128044603,307963,2.56068472008,28508,2.4308466052,11930,2.15334420881,15325,-279455,-16578
1988,NEW GOLD INC CDA,3.49981272051,2290694,2.97977401437,2615299,3.18006310365,2572276,3.70985894562,1655319,324605,-43023
1989,NEW JERSEY RES,35.4999580774,2242228,39.5999782141,3102931,39.6999521938,2740230,42.1500646934,2496390,860703,-362701
1990,NEW MEDIA INVT GROUP INC,15.9922733554,276446,14.2108907897,102527,13.4822261444,149011,14.791263478,390636,-173919,46484
1991,NEW MTN FIN CORP,14.1063956964,58555,14.8998276731,85303,14.5480252265,161259,14.249691773,161407,26748,75956
1992,NEW ORIENTAL ED & TECH GRP I,42.099721506,1722838,60.3801536019,1962996,70.4900126115,2333593,88.260072118,2325355,240158,370597
1993,NEW RELIC INC,28.2406356413,44050,37.0467133452,19138,43.011720001,277901,49.798834161,400913,-24912,258763
1994,NEW RESIDENTIAL INVT CORP,15.7201096037,748150,16.979830564,690054,15.5598466925,2147579,16.7299720048,2234672,-58096,1457525
1995,NEW SR INVT GROUP INC,9.79228763911,214046,10.1999843303,408432,10.0497267888,297023,9.14650149598,228612,194386,-111409
1996,NEW YORK & CO INC,2.26279249164,19445,1.94671348958,52396,1.34895278665,14085,2.03271706514,10331,32951,-38311
1997,NEW YORK CMNTY BANCORP INC,15.9097576373,4260970,13.9698201396,4278151,13.13011058,5039790,12.8900672373,6553806,17181,761639
1998,NEW YORK MTG TR INC,6.59745946383,136113,6.16691206282,140589,6.21698209478,127393,6.1468111263,174074,4476,-13196
1999,NEW YORK REIT INC,10.1203930071,216790,9.68995937451,787929,8.65124521966,42884,7.85113283436,305561,571139,-745045
2000,NEW YORK TIMES CO,13.2996628552,757538,14.4013629662,536477,17.6992885004,408152,19.5993462758,565376,-221061,-128325
2001,NEWELL RUBBERMAID INC,44.6500446283,6395044,47.1700532183,5810975,53.6200663202,7536768,42.6701167149,3879366,-584069,1725793
2002,NEWFIELD EXPL CO,40.4999439498,4165907,36.910268247,4006419,28.4598259983,2564457,29.6701073166,2387049,-159488,-1441962
2003,NEWLINK GENETICS CORP,10.275445307,88366,24.0981458197,225868,7.35597131789,48532,10.1809260963,48915,137502,-177336
2004,NEWMARKET CORP,423.837273227,45475,453.228163903,39682,460.492966132,58787,425.745412844,48832,-5793,19105
2005,NEWMONT MINING CORP,34.0700496767,2596386,32.9598396006,2791033,32.3895204565,2642367,37.5100137566,3111969,194647,-148666
2006,NEWPARK RES INC,7.49874274942,379797,8.09885133717,295474,7.349706314,595534,10.0,829800,-84323,300060
2007,NEWS CORP NEW,11.5098279119,1832434,13.0688285567,1866885,13.7577947444,2115528,13.3077833391,2246054,34451,248643
2008,NEWSTAR FINANCIAL INC,9.24535385771,21308,10.5980616185,25382,10.4820855736,22133,11.767925561,14616,4074,-3249
2009,NEXEO SOLUTIONS INC,9.3123537777,196191,8.85915541196,262779,8.30349961361,126814,7.3003217905,145747,66588,-135965
2010,NEXPOINT RESIDENTIAL TR INC,22.3390529012,51927,24.1639477977,49040,24.8786272009,44697,23.7497998612,18737,-2887,-4343
2011,NEXTERA ENERGY INC,119.460236361,2453963,128.369883909,7301253,140.130302196,2227591,146.549688168,2599794,4847290,-5073662
2012,NEXTERA ENERGY PARTNERS LP,25.5400685596,247376,33.1299238754,308573,36.9876888573,331732,40.2919229748,354066,61197,23159
2013,NGL ENERGY PARTNERS LP,20.9986020233,241778,22.5997602517,2557682,14.0000754861,3073412,11.5500054625,3908483,2315904,515730
2014,NIC INC,23.89941258,303020,20.1998406586,361488,18.9492605877,360489,17.14999597,620350,58468,-999
2015,NICE SYS LTD,68.7773989284,51325,67.9758308157,32438,78.7353391127,29415,81.3136521851,31028,-18887,-3023
2016,NIELSEN HLDGS PLC,41.9496161821,939508,41.3102994382,1949417,38.6599507813,2216635,41.4495373233,1366505,1009909,267218
2017,NII HLDGS INC,2.15593101021,68184,1.30083695359,203715,0.804109282983,948876,0.461394983557,101865,135531,745161
2018,NIKE INC,50.8301555061,10985231,55.7299882904,10822701,58.9999551232,11587280,51.8499305638,10625588,-162530,764579
2019,NISOURCE INC,22.1400266118,5512595,23.7899973142,4311602,25.3599972004,3314748,25.5899782703,3360378,-1200993,-996854
2020,NMI HLDGS INC,10.6365462509,30367,11.3950591024,32909,11.451048951,22880,12.4075545505,32722,2542,-10029
2021,NN INC,19.0851257195,13204,25.1801540628,12073,27.4320145881,25226,29.0001786459,16793,-1131,13153
2022,NOAH HLDGS LTD,21.9310305593,316401,25.3804326566,511260,28.6508539144,388505,32.1093698586,349493,194859,-122755
2023,NOBILIS HEALTH CORP,2.09800445623,61487,1.70007483235,137641,1.89963316932,694871,1.50597009574,27889,76154,557230
2024,NOBLE CORP PLC,5.92009628951,3979665,6.19006022308,6384429,3.6200937273,7000095,4.60012134718,4082501,2404764,615666
2025,NOBLE ENERGY INC,38.0600735521,4294369,34.3398190984,3513181,28.2996817435,1805462,28.3596706425,1930911,-781188,-1707719
2026,NOBLE MIDSTREAM PARTNERS LP,36.0001141954,1471162,52.0799644712,1292474,45.3994756755,1087876,51.8708331345,922156,-178688,-204598
2027,NOKIA CORP,4.81051579459,1416688,5.42037893312,2128080,6.15994514454,4338675,5.97982249314,3072332,711392,2210595
2028,NOMURA HLDGS INC,5.89958905798,941252,6.27005438312,1031570,6.04026907491,1085051,5.56923179978,955428,90318,53481
2029,NOODLES & CO,4.11568825532,26727,5.76576576577,22200,3.92874077085,14763,4.38335809807,26920,-4527,-7437
2030,NORBORD INC,25.2429760839,30147,28.5377358491,25440,31.1321557175,35269,38.1162259223,73512,-4707,9829
2031,NORDIC AMERICAN TANKERS LIMI,8.39996571443,81667,8.18846608574,68511,6.34212071483,265684,5.33920752341,408113,-13156,197173
2032,NORDIC AMERN OFFSHORE LTD,2.74926972523,64017,1.09502951819,63012,1.26215983253,32484,1.40062561277,42838,-1005,-30528
2033,NORDSON CORP,112.050384962,363283,122.839232031,351264,121.318949112,292172,118.499760454,292220,-12019,-59092
2034,NORDSTROM INC,47.9302405604,714914,46.5704874938,766902,47.8300101829,1190236,47.1504662802,1020202,51988,423334
2035,NORFOLK SOUTHERN CORP,108.069931572,2178358,111.969984974,2109610,121.699931055,1697010,132.239949877,1975946,-68748,-412600
2036,NORTHERN DYNASTY MINERALS LT,2.0705546063,218299,1.43022751212,490831,1.3900207041,512942,1.79936408173,512959,272532,22111
2037,NORTHERN OIL & GAS INC NEV,2.74920138547,386294,2.59980127418,427725,1.40081583894,421897,0.899293515015,138998,41431,-5828
2038,NORTHERN TR CORP,89.0499149284,5866822,86.5800094839,5109713,97.2099374341,5164472,91.9301400184,5140969,-757109,54759
2039,NORTHFIELD BANCORP INC DEL,19.9774128564,65524,18.0098471107,30872,17.1556187189,19702,17.3524223653,73131,-34652,-11170
2040,NORTHROP GRUMMAN CORP,232.580505855,1438001,237.839958399,1636487,256.709771165,1518867,287.720407274,1585077,198486,-117620
2041,NORTHSTAR REALTY EUROPE CORP,12.5595548389,82487,11.5951996149,145405,12.6780333849,111847,12.8144320461,120177,62918,-33558
2042,NORTHWEST BANCSHARES INC MD,18.0305972411,445465,16.8412291045,216255,15.610521413,203965,17.2712474603,420815,-229210,-12290
2043,NORTHWEST NAT GAS CO,59.8026694362,71251,59.0920393592,56302,59.8462305334,66203,64.3951346854,139436,-14949,9901
2044,NORTHWEST PIPE CO,17.2339755518,34931,15.7076886777,29667,16.3064833006,10180,19.0081049788,10364,-5264,-19487
2045,NORTHWESTERN CORP,56.8733727896,276931,58.697728378,170671,61.0229317673,259509,56.9381706112,245951,-106260,88838
2046,NORWEGIAN CRUISE LINE HLDGS,42.5292288698,664155,50.7307244477,758357,54.2906046647,772362,54.0510132128,897689,94202,14005
2047,NOVAGOLD RES INC,4.55321570859,80822,4.86877492349,129396,4.56061594021,797480,4.12118911281,474135,48574,668084
2048,NOVANTA INC,20.9754681376,13778,26.5349071278,10929,35.9948348219,18586,43.6203997758,10706,-2849,7657
2049,NOVARTIS A G,72.8403512546,1022620,74.270006147,958193,83.4693821835,915725,85.8495587501,965666,-64427,-42468
2050,NOVAVAX INC,1.26022015587,391995,1.28020417404,728790,1.14903915078,467347,1.13985570888,588671,336795,-261443
2051,NOVELION THERAPEUTICS INC,8.42243701188,111013,10.743830933,112902,9.23353562598,111225,7.01935483871,19375,1889,-1677
2052,NOVO-NORDISK A S,35.860403857,728129,34.2795641717,819497,42.8892509725,905868,48.1489627452,991174,91368,86371
2053,NOVOCURE LTD,7.85326233124,92955,8.09405807251,74252,17.3000960103,4988007,19.8498113127,4887452,-18703,4913755
2054,NOW INC,20.4704692893,1610222,16.9599920388,683314,16.0799381581,1139681,13.8104205901,1228203,-926908,456367
2055,NRG ENERGY INC,12.2600045276,2341190,18.699684759,2369933,17.2200190678,2136583,25.5902010511,3199037,28743,-233350
2056,NRG YIELD INC,15.4588533987,634135,17.4366771956,586637,17.191920421,657460,19.1061584886,717465,-47498,70823
2057,NTT DOCOMO INC,22.7491857943,411751,23.3496987758,466430,23.6502607631,473610,22.7885305159,430743,54679,7180
2058,NU SKIN ENTERPRISES INC,47.7798051769,1210637,55.5398738011,1360392,62.840290049,1366114,61.4801210497,1420573,149755,5722
2059,NUANCE COMMUNICATIONS INC,14.9001972347,3197206,17.3100897813,2912521,17.4096194921,1516920,15.7199294013,1152995,-284685,-1395601
2060,NUCOR CORP,59.5195852929,2220748,59.7197625125,1396958,57.869743234,2292165,56.0400111611,2132405,-823790,895207
2061,NUSTAR ENERGY LP,49.8000027535,3123293,51.9800262365,3242053,46.6300264679,3734332,40.590067456,3434387,118760,492279
2062,NUSTAR GP HOLDINGS LLC,28.8999614444,1014119,27.9485391977,157790,24.4562154852,97603,22.0032316623,100258,-856329,-60187
2063,NUTANIX INC,26.5640406776,67949,18.759998061,20629,20.1500640916,734886,22.3874244531,70486,-47320,714257
2064,NUTRI SYS INC NEW,34.651977967,109835,55.4943871323,83558,52.0486998347,166325,55.9007837684,381873,-26277,82767
2065,NUVASIVE INC,67.3595356232,1414024,74.6792182817,599551,76.9198268157,2153775,55.4600036749,1812279,-814473,1554224
2066,NVIDIA CORP,106.740013176,15872239,108.929831587,3498711,144.560167699,6354240,178.770007591,4044090,-12373528,2855529
2067,NVR INC,1668.97987509,48994,2106.8673607,45243,2410.60244702,51573,2855.01761449,49675,-3751,6330
2068,NXP SEMICONDUCTORS N V,98.0094029954,1833671,103.499951907,1361933,109.45043086,800609,113.090814915,590773,-471738,-561324
2069,NXSTAGE MEDICAL INC,26.2143053898,43564,26.8308722425,83635,25.0666985227,100452,27.5995238185,1273464,40071,16817
2070,O REILLY AUTOMOTIVE INC NEW,278.410166681,612668,269.840612246,893105,218.740405178,742588,215.371528988,410291,280437,-150517
2071,OAKTREE CAP GROUP LLC,37.5006893509,380793,45.29902594,458288,46.6002315415,400792,47.0498257938,317727,77495,-57496
2072,OASIS PETE INC NEW,15.1399538511,1529397,14.2601138721,2299070,8.04992576979,4978431,9.12015518559,1399099,769673,2679361
2073,OCCIDENTAL PETE CORP DEL,71.229738676,2412293,63.3599394588,3351108,59.8700386097,2555836,64.2100062316,3284893,938815,-795272
2074,OCEANEERING INTL INC,28.209966996,2650588,27.0796778865,1566156,22.8400226695,1718606,26.2703141835,1742994,-1084432,152450
2075,OCEANFIRST FINL CORP,30.0304832451,735486,28.1747588856,774736,27.1198195483,902624,27.4900869325,1362091,39250,127888
2076,OCH ZIFF CAP MGMT GROUP,3.31041533236,989906,2.26000113631,950442,2.56004405802,965999,3.2198865712,927983,-39464,15557
2077,OCLARO INC,8.94686889814,165421,9.81957404594,129028,9.33991582903,724953,8.63054732283,947101,-36393,595925
2078,OCULAR THERAPEUTIX INC,8.37708926209,49898,9.28270042194,31995,9.27671544423,33417,6.17535841563,36759,-17903,1422
2079,OCWEN FINL CORP,5.39103527174,580408,5.47017326253,619176,2.68889706183,367065,3.44028399336,456067,38768,-252111
2080,OFFICE DEPOT INC,4.52003191723,8039545,4.66504773701,6101974,5.64002508852,8381523,4.54005299358,9952527,-1937571,2279549
2081,OFG BANCORP,13.1013488444,684586,11.8006884327,563018,9.99931550607,525936,9.15075409167,529246,-121568,-37082
2082,OGE ENERGY CORP,33.4500068795,1918744,34.9800158229,1946540,34.7899083559,1435445,36.0301199545,1370520,27796,-511095
2083,OI S A,3.97132357801,559763,6.51049389984,1129561,6.04013349016,2799607,7.79008199726,3503044,569798,1670046
2084,OIL STS INTL INC,39.0004690101,481866,33.1513823734,484746,27.1495340444,595443,25.3504762531,456165,2880,110697
2085,OLD DOMINION FGHT LINES INC,85.7899846936,1629386,85.5702133201,1589677,95.2398420697,1253971,110.109269551,1225410,-39709,-335706
2086,OLD NATL BANCORP IND,18.1492344053,512804,17.3525608471,234317,17.2438458068,90873,18.2999674679,731586,-278487,-143444
2087,OLD REP INTL CORP,18.999901264,3099174,20.479954479,2671295,19.5297636092,3143100,19.6900345496,4872414,-427879,471805
2088,OLD SECOND BANCORP INC ILL,11.0521027702,34835,11.247396436,43210,11.5428009373,34567,13.4474327628,22086,8375,-8643
2089,OLIN CORP,25.6098574227,3285727,32.8698775739,2911389,30.2801853835,1985721,34.2501101051,1850505,-374338,-925668
2090,OLLIES BARGAIN OUTLT HLDGS I,28.4467419877,136571,33.5021330641,122828,42.598345425,208271,46.4009198293,241784,-13743,85443
2091,OLYMPIC STEEL INC,24.234242921,31113,18.5603387438,42510,19.4801641587,18275,22.0026484669,39268,11397,-24235
2092,OM ASSET MGMT PLC,14.4998969729,2562432,15.1202996799,2553124,14.8600602639,2899248,14.9199849408,3102416,-9308,346124
2093,OMEGA HEALTHCARE INVS INC,31.2602407126,2685360,32.9899844366,2822008,33.0193743841,1983805,31.9101982907,1678899,136648,-838203
2094,OMEGA PROTEIN CORP,25.0468031996,70508,20.046157943,67594,17.9000801496,48659,16.6508799043,40118,-2914,-18935
2095,OMEROS CORP,9.92158362819,41828,15.1159279267,59606,19.8962826042,38952,21.6136965569,42288,17778,-20654
2096,OMNICELL INC,33.9111859672,48686,40.6517778827,88926,43.1038180118,116579,51.0481349167,112247,40240,27653
2097,OMNICOM GROUP INC,85.1101114192,764680,86.2102949133,994394,82.8999362193,1668216,74.0699951752,2097516,229714,673822
2098,OMNOVA SOLUTIONS INC,9.99716392513,56416,9.90295599514,40291,9.7579036631,83727,10.9564570153,67175,-16125,43436
2099,ON ASSIGNMENT INC,44.1597675494,1230713,48.5302322644,1139908,54.1501176896,1161955,53.6805622597,1356953,-90805,22047
2100,ON DECK CAP INC,4.63100254481,290002,5.04180351196,260026,4.68955167886,15993,4.66759727796,45848,-29976,-244033
2101,ON SEMICONDUCTOR CORP,12.7600967646,954068,15.4900349255,1121818,14.0403228892,1333089,18.4698465154,3605769,167750,211271
2102,ONCOMED PHARMACEUTICALS INC,7.72065683896,42872,9.20871243452,326430,3.33257059711,170439,4.51681054894,27453,283558,-155991
2103,ONE GAS INC,63.9612215221,515750,67.6017799737,488996,69.8096062248,692197,73.637907368,381013,-26754,203201
2104,ONE LIBERTY PPTYS INC,25.1260042916,40078,23.3687337871,45103,23.440389156,35153,24.3737702992,34053,5025,-9950
2105,ONEMAIN HLDGS INC,22.1378340366,248850,24.8490845074,380014,24.5904733147,370916,28.1839611567,106479,131164,-9098
2106,ONEOK INC NEW,57.4097371611,4398017,55.4400124033,7004598,52.159997598,8392926,55.4098671887,8417129,2606581,1388328
2107,OOMA INC,8.98244340607,22043,9.9525253103,34966,7.98726667631,34555,10.5269676141,16149,12923,-411
2108,OPEN TEXT CORP,61.8108056268,552638,34.0101695334,647424,31.5423400647,349657,32.2927731428,290901,94786,-297767
2109,OPHTHOTECH CORP,4.83166679586,154812,3.65947577295,559643,2.56052141527,652992,2.81968603457,363161,404831,93349
2110,OPKO HEALTH INC,9.29941891848,1796994,7.99990840285,2358152,6.57940377315,2075720,6.85992884964,2003082,561158,-282432
2111,OPUS BK IRVINE CALIF,30.0510488953,50148,20.1505480162,55929,24.1953671188,31039,23.9956339566,56802,5781,-24890
2112,ORACLE CORP,38.4500191272,28106592,44.6100112977,25333439,50.1399833592,28615187,48.3499851589,26938788,-2773153,3281748
2113,ORANGE,15.1397900054,646112,15.5401341973,739955,15.9798115693,741811,16.4189643765,719412,93843,1856
2114,ORASURE TECHNOLOGIES INC,8.78117316473,56940,12.9276314559,267257,17.262615879,107979,22.4998707753,135423,210317,-159278
2115,ORBCOMM INC,8.27037417855,335535,9.55328710455,67202,11.3028540194,256130,10.4691730163,358290,-268333,188928
2116,ORBITAL ATK INC,87.7284717823,298341,97.9990224684,337585,98.3593520603,326944,133.160440454,708724,39244,-10641
2117,ORBOTECH LTD,33.3983012103,41559,32.2191154042,15736,32.6252153062,29609,42.1862563014,18845,-25823,13873
2118,ORCHID IS CAP INC,10.8618987163,14178,9.98851494797,28733,9.84821105891,11068,10.1771015216,20045,14555,-17665
2119,OREXIGEN THERAPEUTICS INC,1.73713849384,52385,3.43661814423,35791,2.87174774568,17411,2.13428703276,17336,-16594,-18380
2120,ORGANOVO HLDGS INC,3.38722881703,97720,3.1754404473,94790,2.62771775377,74970,2.21769935293,208324,-2930,-19820
2121,ORION ENGINEERED CARBONS S A,18.8597127521,41358,20.4908050177,32844,19.9363627324,20114,22.4482382855,13765,-8514,-12730
2122,ORION MARINE GROUP INC,9.94950439499,160410,7.47130930352,115107,7.46976384775,85411,6.56541568546,134188,-45303,-29696
2123,ORITANI FINL CORP DEL,18.7504516721,1176185,17.0002025843,1006988,17.0497120113,975559,16.8020912069,127008,-169197,-31429
2124,ORIX CORP,77.8377965681,52391,74.3317954779,52454,77.9362469167,63244,80.9382079872,67533,63,10790
2125,ORMAT TECHNOLOGIES INC,53.6219328866,156988,57.0757639999,153305,58.679582813,177762,61.049123248,214827,-3683,24457
2126,ORTHOFIX INTL N V,36.1850224614,121542,38.1477762034,218073,46.4767931013,142867,47.2489354267,154522,96531,-75206
2127,OSHKOSH CORP,64.6108013574,1581005,68.5899318641,1372111,68.8801390322,1841300,82.5404489975,1996403,-208894,469189
2128,OSI SYSTEMS INC,76.1192384968,353879,72.9898047298,557023,75.1495305243,508759,91.3707349982,517321,203144,-48264
2129,OSISKO GOLD ROYALTIES LTD,9.7181929273,536005,11.0998046516,587668,12.2196040342,877197,12.9097483229,420380,51663,289529
2130,OTELCO INC,6.34432922232,70299,7.07209312846,66317,7.50480679774,64492,9.44303169385,64492,-3982,-1825
2131,OTONOMY INC,15.8990774505,471411,12.2533689657,140696,18.8497406389,105837,3.24659143498,140455,-330715,-34859
2132,OTTER TAIL CORP,40.8023586396,18994,37.9020554187,29629,39.6033862925,17246,43.3589611236,36809,10635,-12383
2133,OUTFRONT MEDIA INC,24.8699287765,514718,26.5495136813,757528,23.1204590716,635195,25.1793813679,765269,242810,-122333
2134,OVERSEAS SHIPHOLDING GROUP I,3.82863235437,103170,3.86168937813,180232,2.6611137298,502797,2.62981219106,574946,77062,322565
2135,OVERSTOCK COM INC DEL,17.492359659,24868,17.2050419487,49346,16.2892760023,37141,29.7043600316,113990,24478,-12205
2136,OWENS & MINOR INC NEW,35.2889588711,602058,34.5999162198,603961,32.188750344,472370,29.1995918666,587063,1903,-131591
2137,OWENS CORNING NEW,51.5602033784,2951346,61.3702236701,2560020,66.9201716912,3259107,77.3496225523,3241244,-391326,699087
2138,OWENS ILL INC,17.4101035612,3230940,20.3799172066,3200013,23.9200226117,3060365,25.1597784003,2114804,-30927,-139648
2139,OXFORD IMMUNOTEC GLOBAL PLC,14.9529828889,12974,15.4997477437,35678,16.825693044,33223,16.7696381289,13596,22704,-2455
2140,OXFORD INDS INC,60.1190084096,45543,57.2579484966,27804,62.4846358415,44747,63.5426394917,109218,-17739,16943
2141,P T TELEKOMUNIKASI INDONESIA,29.1578963308,132074,31.1710193766,164993,33.6695121733,167867,34.2974165927,150886,32919,2874
2142,PACCAR INC,63.8995870355,1487537,67.1996749614,1452135,66.0407755689,1377982,72.3401843684,1446886,-35402,-74153
2143,PACIFIC BIOSCIENCES CALIF IN,3.7981146408,240909,5.17114418805,120863,3.55869514511,150055,5.24551001612,138976,-120046,29192
2144,PACIFIC ETHANOL INC,9.50028350804,633139,6.84914752575,122643,6.25014138763,309433,5.55227112463,280786,-510496,186790
2145,PACIFIC PREMIER BANCORP,35.337918849,63388,38.5285269436,18947,36.9033338614,88366,37.7535057824,214788,-44441,69419
2146,PACIRA PHARMACEUTICALS INC,32.2987471832,107837,45.600604158,405192,47.7002916111,477691,37.5482324271,403774,297355,72499
2147,PACKAGING CORP AMER,84.8188621492,782774,91.6201189422,1084729,111.390767732,870512,114.679931321,888778,301955,-214217
2148,PACWEST BANCORP DEL,54.4398141059,3383002,53.2599497679,3106781,46.6996813767,2646699,50.5098795036,1328255,-276221,-460082
2149,PALO ALTO NETWORKS INC,125.049614738,634892,112.679967685,1109088,133.809899494,894874,144.099644909,1148719,474196,-214214
2150,PAMPA ENERGIA S A,34.8099930487,1350819,54.2198509478,1431579,58.8498911223,1376774,65.1004086297,1498178,80760,-54805
2151,PAN AMERICAN SILVER CORP,15.0681764251,328706,17.523032421,119614,16.8197021062,176103,17.0522737708,372443,-209092,56489
2152,PANDORA MEDIA INC,13.040125679,5243201,11.8099221372,3727967,8.91984023388,2761036,7.70012453362,4809143,-1515234,-966931
2153,PANHANDLE OIL AND GAS INC,23.5641316686,22025,19.2079421604,18534,23.1175252222,14967,23.7875288684,17320,-3491,-3567
2154,PAPA JOHNS INTL INC,85.5824091288,218386,80.0384711664,227703,71.7621649258,305119,73.070126198,240495,9317,77416
2155,PAR PACIFIC HOLDINGS INC,14.528133373,16795,16.4879913571,120330,18.0359375918,119151,20.7960279993,196576,103535,-1179
2156,PARAMOUNT GOLD NEV CORP,1.77845528455,19680,1.69801462905,15312,1.57571736606,12058,1.5455950541,20057,-4368,-3254
2157,PARAMOUNT GROUP INC,15.9904259646,425317,16.2100242028,1702280,16.0005557837,964404,15.999899435,795505,1276963,-737876
2158,PARATEK PHARMACEUTICALS INC,15.4043410569,54595,19.24093699,43501,24.1036113663,131723,25.1014987517,125371,-11094,88222
2159,PAREXEL INTL CORP,65.7201660446,172002,63.1086449994,267808,86.9097058037,778256,88.0800811445,631959,95806,510448
2160,PARK HOTELS RESORTS INC,29.9009274874,284640,25.67013889,3147743,26.9598141296,3486300,27.5598509469,2938550,2863103,338557
2161,PARK NATL CORP,119.679380873,7236,105.289421158,4008,103.862973761,2744,108.041329739,4452,-3228,-1264
2162,PARKER DRILLING CO,2.5973368437,197510,1.75092126962,147351,1.34983994755,129645,1.10189985283,135221,-50159,-17706
2163,PARKER HANNIFIN CORP,139.999915952,713879,160.320961768,787882,159.81956683,857492,175.019063266,738331,74003,69610
2164,PARKWAY INC,22.2522026432,181600,19.8926674638,179815,22.8900464979,947355,23.0299902819,1294486,-1785,767540
2165,PARSLEY ENERGY INC,35.240014288,4017365,32.5101161417,4607735,27.7500130688,3175494,26.3400093312,2820652,590370,-1432241
2166,PARTY CITY HOLDCO INC,14.1997349082,1685454,14.0500384738,1022773,15.6499063173,1144288,13.5501056103,1087962,-662681,121515
2167,PATRICK INDS INC,76.2941141105,49899,70.8992559863,403756,72.8517800421,387856,84.0996952145,454746,353857,-15900
2168,PATRIOT NATL INC,4.66474260017,29798,2.82504653018,30088,2.12239811515,102714,1.36286201022,14675,290,72626
2169,PATTERN ENERGY GROUP INC,18.9921109693,130054,20.1327921362,154226,23.8377857532,214827,24.0998775889,324317,24172,60601
2170,PATTERSON COMPANIES INC,41.0294061151,1171355,45.2297544682,1277146,46.9499597602,1435145,38.6502204206,2075124,105791,157999
2171,PATTERSON UTI ENERGY INC,26.91990631,1345287,24.2700268277,2798596,20.1899637257,1286035,20.93979304,2596444,1453309,-1512561
2172,PAYCHEX INC,60.8798787142,3954295,58.9001010534,3891012,56.9401351574,3556595,59.9599897342,3627569,-63283,-334417
2173,PAYCOM SOFTWARE INC,45.4899535586,168169,57.5106771274,212604,68.4078837628,341715,74.9581523932,250313,44435,129111
2174,PAYLOCITY HLDG CORP,30.0161941473,43843,38.6327110891,113246,45.1811456182,199508,48.8213927539,237314,69403,86262
2175,PAYPAL HLDGS INC,39.4699645657,5016042,43.0201127813,5363654,53.6701665955,5589828,64.0298695517,5801761,347612,226174
2176,PBF ENERGY INC,27.8800401453,915673,22.1702187974,1714417,22.2596476373,1284926,27.6099383081,1165631,798744,-429491
2177,PBF LOGISTICS LP,18.1998707724,2111004,21.5498213059,2084008,19.4999251442,2084008,20.9998117575,2087733,-26996,0
2178,PC CONNECTION INC,28.0945592777,33672,29.790037524,34911,27.0534382554,38886,28.1822012078,42722,1239,3975
2179,PCM INC,22.4912942079,31301,28.0534926814,69617,18.746481036,78148,13.9954924427,63449,38316,8531
2180,PDC ENERGY INC,72.5799114134,1659619,62.3504438675,1650718,43.109904621,1291165,49.0304629526,1461316,-8901,-359553
2181,PDL BIOPHARMA INC,2.1206424323,1234060,2.26986436822,981997,2.46997046023,1041308,3.39058298142,1297417,-252063,59311
2182,PEARSON PLC,9.98972904236,245352,8.48167460252,265042,8.96860986547,228352,8.14041218282,201464,19690,-36690
2183,PEBBLEBROOK HOTEL TR,29.5854823305,5889375,29.2099167551,6476191,32.2400494877,6186591,36.1399934258,5825845,586816,-289600
2184,PEGASYSTEMS INC,35.9945965356,58481,43.8572123064,57596,58.3502268862,159331,57.6459888666,100059,-885,101735
2185,PEMBINA PIPELINE CORP,31.3201196709,2567040,31.7103494424,2020476,33.1199007895,2901307,35.1002958273,2774592,-546564,880831
2186,PENGROWTH ENERGY CORP,1.42117796039,290604,0.999444483527,412229,0.789171306994,316788,1.02636620746,87688,121625,-95441
2187,PENN NATL GAMING INC,13.7885719609,407874,18.4297495085,613953,21.3997830591,778092,23.3898444657,971490,206079,164139
2188,PENNANTPARK FLOATING RATE CA,14.094292804,10075,13.9293402558,39485,14.112264649,56830,14.4916820702,40575,29410,17345
2189,PENNANTPARK INVT CORP,7.6532375095,57884,8.14021318343,113142,7.38885632582,168903,7.51220544446,132318,55258,55761
2190,PENNEY J C INC,8.30994182767,4378370,6.16002328813,7165882,4.64995459456,5666722,3.80998149107,6571423,2787512,-1499160
2191,PENNSYLVANIA RL ESTATE INVT,18.9604338731,488069,15.1404876141,424557,11.3213361772,493228,10.4903154716,629819,-63512,68671
2192,PENNYMAC FINL SVCS INC,16.6430594901,11296,17.0276325616,13390,16.6981413378,50305,17.8007761966,19325,2094,36915
2193,PENNYMAC MTG INVT TR,16.3698763411,2384624,17.7500136375,3153068,18.2901969514,3090508,17.3902272679,3269710,768444,-62560
2194,PENSKE AUTOMOTIVE GRP INC,51.8419347873,347325,46.8135184792,249821,43.910064962,349897,47.5708434395,299322,-97504,100076
2195,PENTAIR PLC,56.0702470682,820988,62.7809835635,960243,66.5394757364,551402,67.9601053758,604693,139255,-408841
2196,PENUMBRA INC,63.801845423,87568,83.4388908903,86051,87.7961923024,7301,90.3027193433,11694,-1517,-78750
2197,PEOPLES UNITED FINANCIAL INC,19.3599235848,4041080,18.2000518967,3591748,17.6600274829,3973380,18.140103637,4129800,-449332,381632
2198,PEPSICO INC,104.629993113,5808000,111.860051124,6154476,115.490074062,6452035,111.429985602,6877314,346476,297559
2199,PERFICIENT INC,17.4900476408,91938,17.3685462765,100872,18.6426324025,178301,19.6658652364,227094,8934,77429
2200,PERFORMANCE FOOD GROUP CO,23.9970730028,46464,23.7994050149,75296,27.3996512805,544277,28.2538823056,144051,28832,468981
2201,PERFORMANT FINL CORP,2.36132975275,43196,2.93778197461,38124,2.097465191,22408,1.84921763869,14060,-5072,-15716
2202,PERKINELMER INC,52.1502408747,1650443,58.0603955127,1379374,68.1403354555,1533497,68.9700999367,1482338,-271069,154123
2203,PERRIGO CO PLC,83.230469105,1133371,66.3896946289,1591015,75.5195562674,1975965,84.6501240471,2220930,457644,384950
2204,PETMED EXPRESS INC,23.0656577984,57358,20.1430407331,71588,40.5981147484,157963,33.1489955512,251531,14230,86375
2205,PETROBRAS ARGENTINA S A,7.02044486993,137883,11.0553364408,83670,12.0091817035,65783,12.6130783148,38690,-54213,-17887
2206,PETROCHINA CO LTD,73.7072122369,83289,73.2437165822,86219,61.2870426313,67861,64.1076690292,75342,2930,-18358
2207,PETROLEO BRASILEIRO SA PETRO,9.04542546772,18841347,9.31874301761,22306120,7.58928278594,16617117,9.92126332226,4616146,3464773,-5689003
2208,PFENEX INC,9.06442214309,24712,5.80149946448,56020,4.00739057701,160204,3.02345727243,58873,31308,104184
2209,PFIZER INC,32.4799894106,37819101,34.2099859311,41266898,33.5900251697,47716100,35.6999890605,49527074,3447797,6449202
2210,PG&E CORP,60.7700129932,6132416,66.3598453374,3887170,66.369971075,5515642,68.0899167556,5950793,-2245246,1628472
2211,PGT INNOVATIONS INC,11.4511511633,148806,10.753435539,100712,12.7965963018,91665,14.9455253645,160717,-48094,-9047
2212,PHARMERICA CORP,25.1537726149,110878,23.3977492042,79794,26.2450018175,41265,29.301102121,420462,-31084,-38529
2213,PHH CORP,15.1602808951,312857,12.7272803044,239957,13.771369012,243694,13.9407729403,58892,-72900,3737
2214,PHI INC,18.0081698406,17381,11.951735575,17487,9.76060824001,19466,11.7717478053,20048,106,1979
2215,PHIBRO ANIMAL HEALTH CORP,29.299772967,55939,28.0984772841,64096,37.0480867339,167593,37.0512216199,407328,8157,103497
2216,PHILIP MORRIS INTL INC,91.4899660448,5009839,112.899988401,6207680,117.449801124,5719899,111.009939654,7350558,1197841,-487781
2217,PHILLIPS 66,86.4100069568,2943872,79.2202594456,3163206,82.6901157818,3739274,91.6103296259,4887844,219334,576068
2218,PHILLIPS 66 PARTNERS LP,48.6398528797,3786833,51.349930592,3758934,49.4201268863,3601650,52.5597896916,3177429,-27899,-157284
2219,PHOTRONICS INC,11.3006131703,901544,10.6996514613,862458,9.40028943478,709659,8.84904384127,844159,-39086,-152799
2220,PHYSICIANS RLTY TR,18.9603520709,1201349,19.8713475134,659140,20.139816183,1151798,17.7305874883,584301,-542209,492658
2221,PICO HLDGS INC,15.1532479414,17488,13.9950518814,27081,17.5032770453,38907,16.7092532514,34831,9593,11826
2222,PIEDMONT OFFICE REALTY TR IN,20.9098180774,1462710,21.3799921211,1345370,21.0809539717,990847,20.1607457567,895949,-117340,-354523
2223,PIER 1 IMPORTS INC,8.54062754082,721961,7.15942889501,727572,5.1898764617,457429,4.18989324881,713622,5611,-270143
2224,PILGRIMS PRIDE CORP NEW,18.9899434148,6157259,22.5050168665,3992532,21.9199668586,2264237,28.4101597806,2610017,-2164727,-1728295
2225,PIMCO ETF TR,103.174369108,101721,110.967741935,3100,100.451800123,339088,100.089882237,349346,-98621,335988
2226,PINNACLE ENTMT INC NEW,14.4990977429,317537,19.5208177224,260235,19.7607211446,217654,21.309463201,286774,-57302,-42581
2227,PINNACLE FINL PARTNERS INC,69.3000609426,1243794,66.4501656746,1364120,62.8002548642,2128192,66.9498867042,1717628,120326,764072
2228,PINNACLE FOODS INC DEL,53.4499099128,2154578,57.8700125205,2872092,59.3999814908,1566785,57.1702801798,1650333,717514,-1305307
2229,PINNACLE WEST CAP CORP,78.0299559544,2929234,83.3799182155,2634975,85.1601208603,3351968,84.559764179,2864885,-294259,716993
2230,PIONEER ENERGY SVCS CORP,6.8479901995,372226,3.99988484362,555766,2.0505926505,410613,2.55052480925,561061,183540,-145153
2231,PIONEER NAT RES CO,180.069877401,1228151,186.230401713,1456760,159.581193084,654908,147.538642381,819243,228609,-801852
2232,PIPER JAFFRAY COS,72.499520981,208760,63.8478519273,135447,59.9515005397,142682,59.3467907459,250915,-73313,7235
2233,PITNEY BOWES INC,15.1903708146,1257178,13.1098389038,1977141,15.1002454839,2144336,14.0094593318,1281063,719963,167195
2234,PJT PARTNERS INC,30.8653664079,10562,35.1003151051,25071,40.2396494679,11183,38.2470119522,7530,14509,-13888
2235,PLAINS ALL AMERN PIPELINE L,32.2900105789,23535638,31.6100089473,25201891,26.2700088247,28159450,21.1900056813,27414575,1666253,2957559
2236,PLAINS GP HLDGS L P,34.6799442745,3757705,31.2598654586,4431497,26.1601440357,5132617,21.8699810329,5161047,673792,701120
2237,PLANET FITNESS INC,20.1087770071,20041,19.2533333333,18750,23.3398200452,243061,26.9808589641,333681,-1291,224311
2238,PLANET PAYMENT INC,4.07071411956,34392,3.98283049239,48458,3.30091663916,39383,4.27586206897,14500,14066,-9075
2239,PLANTRONICS INC NEW,54.7612544173,234308,54.1105034236,139326,52.3065948886,89721,44.2141525146,70249,-94982,-49605
2240,PLATFORM SPECIALTY PRODS COR,9.809491473,892401,13.0199506508,4640801,12.6799620065,4444966,11.1503127266,2475805,3748400,-195835
2241,PLEXUS CORP,54.0391475314,756063,57.8036163788,195057,52.5703364066,201958,56.0789816578,299310,-561006,6901
2242,PLUG POWER INC,1.19796346211,86814,1.37932985789,282746,2.0402497369,154883,2.60877588854,238426,195932,-127863
2243,PLY GEM HLDGS INC,16.2435989208,18161,19.6988135078,13148,17.9455445545,92112,17.0485264258,83233,-5013,78964
2244,PNC FINL SVCS GROUP INC,116.342203234,3079854,119.58471644,2787204,124.200159426,2721011,134.137574338,2890510,-292650,-66193
2245,PNM RES INC,34.3000573957,2576847,36.9999713645,2723894,38.2498665768,2641970,40.2997980238,2441377,147047,-81924
2246,POLARIS INDS INC,82.3873463099,349811,83.7997577866,427722,92.2291252079,428639,104.627886118,505047,77911,917
2247,POLYONE CORP,32.0409378206,394745,34.0872713189,253027,38.7423971218,449172,40.029128196,406479,-141718,196145
2248,POOL CORPORATION,104.340657275,372386,119.331513999,292781,117.56582322,177407,108.16953053,209449,-79605,-115374
2249,POPULAR INC,43.8197781188,993775,40.7302083323,970901,41.7097232621,969654,35.9397810972,969928,-22874,-1247
2250,PORTLAND GEN ELEC CO,43.329976828,2060675,44.419799458,2549989,45.6897583386,2573684,45.6399926613,2616280,489314,23695
2251,PORTOLA PHARMACEUTICALS INC,22.4392407947,166806,39.1899366787,517046,56.1698145015,688092,54.0286092323,432308,350240,171046
2252,POSCO,52.5535754216,192299,64.502550215,285074,62.5920851225,174431,69.3995695571,187249,92775,-110643
2253,POST HLDGS INC,80.3894369018,701423,87.5195704252,795205,77.6490440836,472897,88.2701868033,743456,93782,-322308
2254,POTASH CORP SASK INC,18.0903925688,2340303,17.0796465464,1841373,16.3000110579,1338404,19.2398654781,1845647,-498930,-502969
2255,POTBELLY CORP,12.8953803803,74833,13.8965879767,104630,11.5061868866,140620,12.3947995089,67609,29797,35990
2256,POTLATCH CORP NEW,41.6562595399,108099,45.6971474018,104361,45.6975283573,211762,51.0006656588,321486,-3738,107401
2257,POWELL INDS INC,38.9960589089,33747,34.4517135826,33322,31.9932561267,49823,29.9941022833,59345,-425,16501
2258,POWER INTEGRATIONS INC,67.8486474526,144616,65.7528712944,108923,72.9054466297,132761,73.203671438,119953,-35693,23838
2259,POWERSHARES DB CMDTY IDX TRA,15.8578442021,23017,15.2099630414,2065554,14.4515068147,31623,15.3974895397,11950,2042537,-2033931
2260,POWERSHARES DB G10 CURCY HAR,24.8173614095,27924,25.2827977827,22189,24.4199597415,18878,23.8842398884,17208,-5735,-3311
2261,POWERSHARES ETF TR II,33.9903057095,2454847,33.5319008751,2756241,28.8072857477,3444094,24.5824603656,3434644,301394,687853
2262,POWERSHARES ETF TRUST,37.6604231852,1162706,44.5349044235,741396,49.1999436623,816505,49.9694021346,890585,-421310,75109
2263,POWERSHARES ETF TRUST II,23.3489757,17359905,23.2983295401,19094502,23.3863664792,19754501,23.4315894083,15250694,1734597,659999
2264,POWERSHARES EXCHANGE TRADED,33.5601971368,12783,37.345513165,11166,39.8531255597,11166,42.6423969731,9779,-1617,0
2265,POWERSHARES QQQ TRUST,118.480029112,13698815,132.380015339,8978606,137.64002496,20884848,145.449994517,18082187,-4720209,11906242
2266,POWERSHS DB MULTI SECT COMM,22.3260158804,42820,22.6702076292,41420,25.7333903686,44417,16.9491525424,60888,-1400,2997
2267,POWERSHS DB US DOLLAR INDEX,26.460306954,773536,25.9554776912,52513,24.7513119762,38301,24.1804562673,35111,-721023,-14212
2268,PPG INDS INC,94.7605140081,552287,105.08032249,866756,109.960216911,830755,108.659839501,1245612,314469,-36001
2269,PPL CORP,34.0498403625,4543105,37.3898309248,4722514,38.6598728184,5219624,37.950016459,5762817,179409,497110
2270,PRA GROUP INC,39.1105051176,111479,33.1496484652,57889,37.9011415413,142001,28.6461130805,195489,-53590,84112
2271,PRA HEALTH SCIENCES INC,55.1200157582,888425,65.2299625311,1049671,75.0110082598,206663,76.1703220249,482944,161246,-843008
2272,PRAXAIR INC,117.19041143,826484,118.599078034,1081602,132.550037153,2749407,139.740166602,2744143,255118,1667805
2273,PRECISION DRILLING CORP,5.44873802217,271439,4.72236689235,199688,3.408942731,161047,3.12007122533,378517,-71751,-38641
2274,PREFERRED APT CMNTYS INC,14.9135129766,70473,13.2124062255,80379,15.7514109745,93198,18.8893538167,66916,9906,12819
2275,PREFERRED BK LOS ANGELES CA,52.385276245,14317,53.639279546,20265,53.4629404617,35389,60.3620643069,18505,5948,15124
2276,PREMIER INC,30.3590426961,465265,31.8304829487,608222,36.0000562996,852582,32.5701185173,1152406,142957,244360
2277,PRESTIGE BRANDS HLDGS INC,52.0994295712,763636,55.5599422545,671221,52.8104831572,836084,50.0896735323,713700,-92415,164863
2278,PRETIUM RES INC,8.23976079094,855486,10.7102107597,1486432,9.61069491412,1355261,9.26019972641,1388199,630946,-131171
2279,PRICE T ROWE GROUP INC,75.2596793917,1050815,68.1497080536,1119726,74.2097299617,1416984,90.6498830932,1484944,68911,297258
2280,PRICELINE GRP INC,1466.06105853,399158,1779.97303728,413163,1870.52234912,431225,1830.8170158,397936,14005,18062
2281,PRICESMART INC,83.5006114303,43341,92.2080396266,47241,87.6077899428,51605,89.2509050404,35910,3900,4364
2282,PRIMERICA INC,69.1495807793,354825,82.2002047493,858611,75.7507486466,927674,81.5509596233,925311,503786,69063
2283,PRIMORIS SVCS CORP,22.7861274474,82638,23.22676111,82448,24.9367340556,175845,29.4200056038,460401,-190,93397
2284,PRINCIPAL FINL GROUP INC,57.8597360666,1100126,63.1106939038,1112157,64.070647323,1381397,64.3401646761,1768320,12031,269240
2285,PROASSURANCE CORP,56.1998265575,1077014,60.2505820401,1033434,60.8005285065,1032343,54.6492738312,1132037,-43580,-1091
2286,PROCTER AND GAMBLE CO,84.0799663469,12159365,89.8499464086,13396747,87.1500488622,15731982,90.9799039452,16354205,1237382,2335235
2287,PROGENICS PHARMACEUTICALS IN,8.64281289637,271208,9.44004255207,834742,6.78900723948,313006,7.36112141215,215728,563534,-521736
2288,PROGRESS SOFTWARE CORP,31.9300492217,249890,29.0504663228,328635,30.889505717,431959,38.1665138395,182123,78745,103324
2289,PROGRESSIVE CORP OHIO,35.4997528581,3495968,39.1799846874,5091222,44.0899565396,4166323,48.4199154023,4826134,1595254,-924899
2290,PROLOGIS INC,52.7900491013,4304978,51.8802357339,5401344,58.6399575749,5411890,63.460009354,8013724,1096366,10546
2291,PROOFPOINT INC,70.6487615172,205453,74.356525133,194724,86.8284727825,350749,87.2209375508,282822,-10729,156025
2292,PROS HOLDINGS INC,21.5200505467,663149,24.1896528234,726633,27.3898427055,566962,24.1292448392,576023,63484,-159671
2293,PROSHARES TR,59.1373665655,1629545,54.1500376947,1173905,61.5807022747,1112670,65.5161261466,871938,-455640,-61235
2294,PROSHARES TR II,16.5781818922,442449,23.1345129748,384015,25.8066349768,140739,35.834410531,303256,-58434,-243276
2295,PROSPECT CAPITAL CORPORATION,8.34416250598,73105,9.03904307322,364751,8.11981060204,207394,6.72021701985,340614,291646,-157357
2296,PROSPERITY BANCSHARES INC,71.7800012191,1837392,69.7096341213,1796251,64.2395020118,1560037,65.7295372605,1006549,-41141,-236214
2297,PROTHENA CORP PLC,49.1789520799,71494,55.7916914201,326554,54.1187536129,306197,64.7712549843,317996,255060,-20357
2298,PROTO LABS INC,51.3506261955,115539,51.0978100939,70003,67.251946331,30185,80.2968494319,86778,-45536,-39818
2299,PROVIDENCE SVC CORP,38.0582679686,24988,44.4400278247,50315,50.6308550387,36934,54.0766208251,40720,25327,-13381
2300,PROVIDENT FINL SVCS INC,28.3003659543,1947784,25.8501881633,1853178,25.380002789,1792750,26.6701506452,1806364,-94606,-60428
2301,PRUDENTIAL FINL INC,104.059876294,3026373,106.679961792,2980541,108.139912159,2940302,106.320137264,3415891,-45832,-40239
2302,PRUDENTIAL PLC,39.7900859407,367579,42.362086508,382323,46.0108068251,433985,47.9110979007,477739,14744,51662
2303,PS BUSINESS PKS INC CALIF,116.519394417,575578,114.760706002,565664,132.390647047,496100,133.50100774,590430,-9914,-69564
2304,PTC INC,46.2698149258,3139174,52.5496812677,2546181,55.1202940219,1474720,56.2799276394,1581523,-592993,-1071461
2305,PTC THERAPEUTICS INC,10.9133667308,81643,9.84155135777,298835,18.3315236266,227477,20.0106213489,282450,217192,-71358
2306,PUBLIC STORAGE,223.500233991,2025716,218.910007923,1995409,208.529738042,1762305,213.989955309,1735245,-30307,-233104
2307,PUBLIC SVC ENTERPRISE GROUP,43.8800703321,4272304,44.3500653955,4382564,43.0101883581,4020373,46.2500831454,5231796,110260,-362191
2308,PULSE BIOSCIENCES INC,6.50637811618,42881,20.4063873298,22983,34.5569969638,18115,18.5925533452,20761,-19898,-4868
2309,PULTE GROUP INC,18.3802219647,2413627,23.5499487943,2577840,24.530180153,3197449,27.3300525724,4272586,164213,619609
2310,PUMA BIOTECHNOLOGY INC,30.6960237809,175267,37.1993254894,316081,87.4015466057,474717,119.750117434,498154,140814,158636
2311,PURE STORAGE INC,11.3047858942,49625,9.8302353494,1738819,12.8099890763,1745747,15.9903522278,1758748,1689194,6928
2312,PVH CORP,90.2398390628,1882971,103.470053682,1852565,114.500096832,2060269,126.060459336,1643981,-30406,207704
2313,PZENA INVESTMENT MGMT INC,11.1164482262,14573,9.8452883263,13509,10.1251694172,12543,10.9099774486,16407,-1064,-966
2314,Q2 HLDGS INC,28.8630332721,24495,34.8636520538,66631,36.9363749777,67332,41.6706889339,31077,42136,701
2315,QAD INC,30.4232804233,10584,27.8822055138,22344,31.9881225537,7409,34.3794920939,8348,11760,-14935
2316,QCR HOLDINGS INC,43.2180851064,6016,42.3543448002,10058,47.4069360484,9429,45.4864882131,15653,4042,-629
2317,QEP RES INC,18.4101207395,2662177,12.7103805215,1810410,10.0999694988,2717929,8.57006864251,2781658,-851767,907519
2318,QIAGEN NV,28.0202267089,1729001,28.9702174495,1446451,33.5302679602,2432787,31.4999530461,2449210,-282550,986336
2319,QIWI PLC,12.766156254,85617,17.17872481,12108,24.6482598117,9453,16.9388489209,278000,-73509,-2655
2320,QORVO INC,52.7297567127,1788914,68.5599022743,2086657,63.3201984181,4145186,70.6800286839,4204455,297743,2058529
2321,QTS RLTY TR INC,49.6488062471,392376,48.7480359275,307397,52.3300715885,384559,52.3584231374,433722,-84979,77162
2322,QUAD / GRAPHICS INC,26.8795499238,230361,25.2376911864,183852,22.9186505601,186922,22.6147170969,182536,-46509,3070
2323,QUAKER CHEM CORP,127.939367209,258474,131.658781246,246235,145.230281129,247111,147.95187956,259848,-12239,876
2324,QUALCOMM INC,65.1999618713,8371646,57.3398463099,8272101,55.2199149401,9723032,51.8399725928,9235518,-99545,1450931
2325,QUALITY CARE PPTYS INC,15.5008615471,858920,18.8606240849,790854,18.3096053867,1376436,15.4994479266,966357,-68066,585582
2326,QUALITY SYS INC,13.1512492047,152457,15.2431145745,274747,17.2106135637,284127,15.7312197234,397172,122290,9380
2327,QUALYS INC,31.6580382096,43654,37.8956423719,67422,40.8132699292,26707,51.7940953823,66050,23768,-40715
2328,QUANEX BUILDING PRODUCTS COR,20.2914888477,49676,20.2451079965,29538,21.1411452305,29374,22.9474688288,73385,-20138,-164
2329,QUANTA SVCS INC,34.8499634535,2041236,37.1098704641,2495293,32.9204482536,1235372,37.3694616535,1212862,454057,-1259921
2330,QUANTENNA COMMUNICATIONS INC,18.1135617081,21310,20.8271533622,64051,18.9982179226,94272,16.8159460155,73799,42741,30221
2331,QUANTUM CORP,0.832343769075,360428,0.869370327491,700507,7.80602924992,88137,6.11999699632,79902,340079,-612370
2332,QUEST DIAGNOSTICS INC,91.8999607446,1936040,98.1898804751,1768502,111.15990781,1946853,93.6401457344,2062107,-167538,178351
2333,QUIDEL CORP,21.418039455,78672,22.6419894422,78615,27.1354767518,139559,43.8587303004,773301,-57,60944
2334,QUINSTREET INC,3.7607233477,198632,3.90181453857,179660,4.17297480077,130123,7.34752364063,196801,-18972,-49537
2335,QUINTILES IMS HOLDINGS INC,76.05017714,2086767,80.5304377558,1541293,89.4995122571,1337795,95.0697197255,1898817,-545474,-203498
2336,QUORUM HEALTH CORP,7.27005711787,356806,5.44051789635,859477,4.14999882246,2377832,5.17998666332,2307921,502671,1518355
2337,QUOTIENT TECHNOLOGY INC,10.7333347966,45559,9.5554015249,20198,11.50544995,37982,15.653530465,56409,-25361,17784
2338,RADIAN GROUP INC,17.97991783,6905927,17.9601103187,6797397,16.3500020178,3518654,18.6894187161,607242,-108530,-3278743
2339,RADIANT LOGISTICS INC,3.89782045749,74144,5.00006127526,81599,5.37951029468,88298,5.30618407713,46361,7455,6699
2340,RADIUS HEALTH INC,38.0323860634,193046,38.648597942,207873,45.2340207822,170049,38.5511636713,137324,14827,-37824
2341,RADNET INC,6.44511814121,86422,5.90308172289,89106,7.75522087822,75562,11.5520689125,65010,2684,-13544
2342,RADWARE LTD,14.620368832,12038,16.1593857426,159412,17.5420296969,162980,16.8601765492,328407,147374,3568
2343,RAIT FINANCIAL TRUST,3.35977405519,190489,3.20169659035,291408,2.19009850849,979408,0.730463176343,1467562,100919,688000
2344,RALPH LAUREN CORP,90.3187390106,320764,81.6197642483,481354,73.7985449329,439155,88.2886514816,545710,160590,-42199
2345,RAMBUS INC DEL,13.7710154032,340643,13.140404681,230206,11.4286112738,143412,13.3486916053,430604,-110437,-86794
2346,RAMCO-GERSHENSON PPTYS TR,16.5788039341,453169,14.0195056559,338671,12.9001523314,531079,13.0096241004,403778,-114498,192408
2347,RAND LOGISTICS INC,0.817757009346,34240,0.640026257487,60935,0.394159864672,60889,0.32775162386,33562,26695,-46
2348,RANDGOLD RES LTD,76.3430837643,168437,87.2736823883,167519,88.4603372892,153696,97.6622140558,151297,-918,-13823
2349,RANGE RES CORP,34.3601511489,2559331,29.100084996,4527272,23.1699404324,6657980,19.5701094892,3037285,1967941,2130708
2350,RAVEN INDS INC,25.2109788888,75126,29.0480227397,80212,33.2967897903,71148,32.3995456641,88921,5086,-9064
2351,RAYMOND JAMES FINANCIAL INC,69.2698892803,1715233,76.2599438844,1514373,80.2200786681,1082522,84.3297419412,1373098,-200860,-431851
2352,RAYONIER ADVANCED MATLS INC,15.4595474227,175749,36.4866967481,205664,45.6531092758,334676,28.7021717977,857078,29915,129012
2353,RAYONIER INC,26.6010853376,659334,28.3406555938,612971,28.7697363525,510606,28.8905151756,687319,-46363,-102365
2354,RAYTHEON CO,142.000247176,1877208,152.499665125,2135126,161.480093132,2268614,186.579962559,2279323,257918,133488
2355,RBC BEARINGS INC,92.8126094809,294001,97.0919357194,287614,101.759429225,288730,125.150797707,287637,-6387,1116
2356,RE MAX HLDGS INC,56.0005339741,74910,59.4581033618,31888,56.0629233122,22885,63.5568071323,79189,-43022,-9003
2357,REAL IND INC,6.12171407994,22216,2.85681306631,34654,2.90046606279,171007,1.80518992102,39885,12438,136353
2358,REALITY SHS ETF TR,25.2418379686,66160,26.0731559855,66160,25.5441354293,66160,25.7859733978,66160,0,0
2359,REALOGY HLDGS CORP,25.7305282555,1026757,29.7897937264,945928,32.4501821844,1413952,32.9499791365,2099364,-80829,468024
2360,REALPAGE INC,29.9892786032,32645,34.8930696253,62190,35.9488544675,194582,39.8972044468,156427,29545,132392
2361,REALTY INCOME CORP,57.4793258073,710064,59.5295968363,1098462,55.1799140746,1447302,57.1902458788,1579640,388398,348840
2362,RECON TECHNOLOGY LTD,1.30755580461,10707,1.30755580461,10707,1.12076211824,10707,1.02736527505,10707,0,0
2363,RECRO PHARMA INC,8.04639160956,36041,8.7271011872,12719,7.03430884598,60276,8.98372692294,56658,-23322,47557
2364,RED HAT INC,69.7003379611,1687768,86.4995520582,2051606,95.749785728,2163138,110.859875836,1827415,363838,111532
2365,RED ROBIN GOURMET BURGERS IN,56.3955721619,28637,58.4407723503,33042,65.2527957729,55262,67.0010593907,92506,4405,22220
2366,RED ROCK RESORTS INC,23.1896939996,1676305,22.1803184509,1751102,23.5501269268,1773069,23.1602521632,1008236,74797,21967
2367,REDWOOD TR INC,15.2097699355,112099,16.6128129888,87583,17.0482432081,69274,16.2893327341,135733,-24516,-18309
2368,REGAL BELOIT CORP,69.2501957165,463681,75.6496712254,476010,81.5493429816,465436,79.0003248628,443264,12329,-10574
2369,REGAL ENTMT GROUP,20.6001243781,2675712,22.5799715569,2274715,20.4596346251,972207,16.0001461577,1696797,-400997,-1302508
2370,REGENCY CTRS CORP,68.9501690548,851499,66.3896726817,1237572,62.6401282574,1631095,62.039903867,1477952,386073,393523
2371,REGENERON PHARMACEUTICALS,367.090462756,327516,387.508709546,332968,491.139424123,372267,447.118186598,386059,5452,39299
2372,REGENXBIO INC,18.5329909568,26871,19.2917847025,35300,19.7531297737,113906,32.9465989526,164023,8429,78606
2373,REGIONAL MGMT CORP,26.2691894756,71719,19.4341079829,71215,23.633325376,96347,24.203223619,76684,-504,25132
2374,REGIONS FINL CORP NEW,14.3600163614,15751723,14.5299896117,13512329,14.6399871412,18776246,15.2299854403,20805404,-2239394,5263917
2375,REGIS CORP MINN,14.5204376505,613549,11.7211917408,598318,10.2694440805,572475,14.2702248959,343092,-15231,-25843
2376,REINSURANCE GROUP AMER INC,125.829933037,1547414,126.979904777,1342110,128.390075576,1027042,139.530167024,1163605,-205304,-315068
2377,RELIANCE STEEL & ALUMINUM CO,79.5399351339,2349147,80.020301657,1938758,72.8102069776,1262117,76.1704541043,1184882,-410389,-676641
2378,RELX NV,16.7594586906,246070,18.5597452701,302752,20.6803430869,325865,21.3294455998,326497,56682,23113
2379,RELX PLC,17.9698211611,267671,19.8007743391,312008,21.8978983038,414332,22.3495286439,413700,44337,102324
2380,RENAISSANCERE HOLDINGS LTD,136.220522254,410988,144.651440716,339727,139.050478514,405004,135.139233944,362663,-71261,65277
2381,RENASANT CORP,42.2201456375,1671548,39.6898567135,1753899,43.7400042246,1723228,42.9004053434,1709168,82351,-30671
2382,RENEWABLE ENERGY GROUP INC,9.69362222675,53953,10.4429799184,70861,12.9462128012,57932,12.1531110146,98987,16908,-12929
2383,RENT A CTR INC NEW,11.2518218314,419221,8.86874865741,586554,11.7185381139,479326,11.4798753981,373349,167333,-107228
2384,REPLIGEN CORP,30.8189112698,162887,35.2000327252,146676,41.4422715816,258287,38.3206274802,236374,-16211,111611
2385,REPROS THERAPEUTICS INC,1.32267842381,18145,1.17431192661,13625,0.457770656901,13107,0.346590416775,11541,-4520,-518
2386,REPUBLIC BANCORP KY,39.5639090326,20271,34.375869332,25163,35.6800090329,17713,38.8850231264,24431,4892,-7450
2387,REPUBLIC SVCS INC,57.049897234,3162039,62.8100229824,3020139,63.7299964526,3284105,66.0601601351,3041682,-141900,263966
2388,RESMED INC,62.0507674775,1160034,71.9700322376,1016826,77.8690854214,897211,76.9596011954,987752,-143208,-119615
2389,RESOLUTE ENERGY CORP,41.1788784282,12215,40.4003816073,196013,29.7519874328,21007,29.6924975445,39707,183798,-175006
2390,RESOLUTE FST PRODS INC,5.3522492308,101079,5.44475235159,51242,4.40208564835,46796,5.05427127351,48276,-49837,-4446
2391,RESOURCE CAP CORP,8.33620392697,72575,9.76703013987,301627,10.1633393829,82650,10.7819957091,91356,229052,-218977
2392,RESOURCES CONNECTION INC,19.250699863,83945,16.7508816253,75996,13.6982070329,64753,13.9025272624,96745,-7949,-11243
2393,RESTAURANT BRANDS INTL INC,47.6610565339,392207,55.7388963461,404529,62.5387909286,447914,63.8797438837,435271,12322,43385
2394,RETAIL OPPORTUNITY INVTS COR,21.1299672336,538051,21.0304394,824852,19.1900130643,1102240,19.0096759851,1133528,286801,277388
2395,RETAIL PPTYS AMER INC,15.3300117698,819895,14.4203913167,957741,12.2102408713,800967,13.1296192193,1474681,137846,-156774
2396,RETROPHIN INC,18.9290679538,495587,18.4611205097,323924,19.3901389886,506804,24.8894931408,594307,-171663,182880
2397,REVANCE THERAPEUTICS INC,20.6998158379,407250,20.8001458124,548650,26.4003072522,179657,27.5475984422,184880,141400,-368993
2398,REVLON INC,29.152616121,18386,27.8904245634,12083,23.6691170531,12379,24.5366339097,32156,-6303,296
2399,REX AMERICAN RESOURCES CORP,98.7312121804,25615,90.4866715578,32712,96.5568999286,54631,93.8314955887,136127,7097,21919
2400,REXFORD INDL RLTY INC,23.185345278,181839,22.5183732819,303974,27.4418343379,480653,28.6193846351,561228,122135,176679
2401,REXNORD CORP NEW,19.5903290585,942659,23.0799258695,1298791,23.2499780609,2028346,25.4100355331,3012117,356132,729555
2402,RICE ENERGY INC,21.3500702009,7004895,23.7001873215,2684156,26.6300168607,4300523,28.9399176038,8257660,-4320739,1616367
2403,RICE MIDSTREAM PARTNERS LP,24.5800665596,6136151,25.2199922279,5959756,19.9400145151,7501148,20.9399932474,9057214,-176395,1541392
2404,RICEBRAN TECHNOLOGIES,1.02305815692,38121,0.870464066155,36762,0.932893836681,16079,1.32615002072,12065,-1359,-20683
2405,RICHMONT MINES INC,6.50002544494,216153,7.09434979694,59343,7.80104959576,211510,9.34955318281,181506,-156810,152167
2406,RIGEL PHARMACEUTICALS INC,2.38061987054,615806,3.30888319956,191001,2.72990217851,184622,2.53974677074,187814,-424805,-6379
2407,RIGNET INC,23.1429768221,28648,21.4484121302,34921,16.0523358022,34699,17.1900826446,51425,6273,-222
2408,RING ENERGY INC,12.9910854276,22323,10.8163866785,101790,12.9994244198,92081,14.4939692339,119222,79467,-9709
2409,RINGCENTRAL INC,20.5977883233,185651,28.3042176116,165947,36.5521943517,139335,41.7531740192,213373,-19704,-26612
2410,RIO TINTO PLC,38.4598667664,1541503,40.6799965319,4659612,42.3100642392,5169432,47.1899517683,6163791,3118109,509820
2411,RITCHIE BROS AUCTIONEERS,33.9987645726,203978,32.8914015332,65093,28.728606357,53988,31.6123079392,49854,-138885,-11105
2412,RITE AID CORP,8.23992139779,5198836,4.24996358321,12336341,2.94987514922,6123310,1.96006221841,6688053,7137505,-6213031
2413,RIVERVIEW BANCORP INC,6.98873659927,14738,7.13677034512,18776,6.63617034985,62084,8.39888803454,50721,4038,43308
2414,RLI CORP,63.1298068381,945528,60.0197607374,862316,54.6208665806,851323,57.3600909706,852143,-83212,-10993
2415,RLJ LODGING TR,24.4900183336,14203991,23.5100494026,13665688,19.8699555892,13352823,22.0000811023,10209326,-538303,-312865
2416,RMR GROUP INC,39.4961397806,36915,49.518736001,16519,48.6384583159,23870,51.3496475443,17449,-20396,7351
2417,ROADRUNNER TRNSN SVCS HLDG I,10.3919267778,106525,6.86389198179,70951,7.27788499547,43007,9.52848835217,87527,-35574,-27944
2418,ROBERT HALF INTL INC,48.7792394647,703373,48.8287472991,746978,47.9301998742,888709,50.3400640328,1530153,43605,141731
2419,ROCKWELL AUTOMATION INC,134.400418921,859350,155.710351213,1224697,161.961504541,756297,178.210037356,705903,365347,-468400
2420,ROCKWELL COLLINS INC,92.7600743581,1060812,97.1598984857,895637,105.079311969,842811,130.710135568,2132283,-165175,-52826
2421,ROCKWELL MED INC,6.55327175751,61496,6.23344241858,12834,7.91674079345,11242,8.5661676407,12491,-48662,-1592
2422,ROGERS COMMUNICATIONS INC,38.5800960782,1370966,44.2207760016,887524,47.209504211,991813,51.5400276036,625281,-483442,104289
2423,ROGERS CORP,76.8113228742,133535,85.8742764332,105899,108.628433644,105755,133.278056166,166434,-27636,-144
2424,ROLLINS INC,33.7794793775,954396,37.1294271629,828211,40.7099116855,1142621,46.1397352472,945259,-126185,314410
2425,ROPER TECHNOLOGIES INC,183.07986359,1406348,206.490014861,1382154,231.530206206,1239199,243.399570394,1213671,-24194,-142955
2426,ROSETTA STONE INC,8.92361555869,23421,9.74958533921,24719,10.775862069,35264,10.2226081465,25336,1298,10545
2427,ROSS STORES INC,65.5999157576,6267630,65.8699273126,6539236,57.7300577422,7805899,64.5700385941,7365382,271606,1266663
2428,ROWAN COMPANIES PLC,18.8900842164,2614811,15.580172212,3272942,10.2399614146,3657338,12.8500497616,2182404,658131,384396
2429,ROYAL BANCSHARES PA INC,4.1488462622,78094,3.89739871295,66198,4.22028028166,43599,4.46296624697,33834,-11896,-22599
2430,ROYAL BK CDA MONTREAL QUE,67.7105539625,1076553,72.9095376562,1198156,72.51999879,1289203,77.3500223486,1302094,121603,91047
2431,ROYAL BK SCOTLAND GROUP PLC,12.6664909175,1274544,13.0515355069,1373325,13.8856163806,1375092,9.46550607588,1022238,98781,1767
2432,ROYAL CARIBBEAN CRUISES LTD,82.0404765504,443269,98.1101635169,599999,109.230540934,599759,118.539713745,1849473,156730,-240
2433,ROYAL DUTCH SHELL PLC,55.1748073319,2186922,53.5386366302,2182592,53.5268588144,2516120,61.1375005541,2639313,-4330,333528
2434,ROYAL GOLD INC,63.3498272434,756845,70.0504698593,637212,78.169759415,528171,86.0393871543,567647,-119633,-109041
2435,RPC INC,19.8107951913,192067,18.311029786,465621,20.2092214309,545642,24.7901475031,1076113,273554,80021
2436,RPM INTL INC,53.8301310402,4132091,55.0301045286,3717547,54.5501111634,3229031,51.3399574756,2043535,-414544,-488516
2437,RPX CORP,10.798617399,254014,11.9999183216,440753,13.9501418501,536482,13.2815713593,488647,186739,95729
2438,RSP PERMIAN INC,44.6199438709,5029836,41.4300095644,5690899,32.2700316849,4426088,34.590023923,4849722,661063,-1264811
2439,RUBICON PROJ INC,7.42254449572,75850,5.89989626556,61696,5.1399023625,193778,3.89416510498,157415,-14154,132082
2440,RUBY TUESDAY INC,3.22895153428,190774,2.81049149694,132717,2.00787478697,204196,2.1395938128,238363,-58057,71479
2441,RUDOLPH TECHNOLOGIES INC,23.348267161,97095,22.401009623,120441,22.8481226552,233761,26.3013203383,265538,23346,113320
2442,RUSH ENTERPRISES INC,31.908332812,111883,33.0780840306,287562,37.1658071263,362403,46.2901847511,483299,175679,74841
2443,RUTHS HOSPITALITY GROUP INC,18.3007656645,151633,20.0533934818,113497,21.7490842491,91728,20.9513290437,233589,-38136,-21769
2444,RYANAIR HLDGS PLC,83.2507787976,83783,82.9821088047,82331,107.601806317,74627,105.415954324,93003,-1452,-7704
2445,RYDER SYS INC,74.4414439744,458817,75.4393997376,585344,71.9802175633,643399,84.5502360397,853670,126527,58055
2446,RYDEX ETF TRUST,59.7057697923,551337,73.0990123421,551608,80.6426722223,751674,82.9427063056,642130,271,200066
2447,RYERSON HLDG CORP,13.3494925424,1322672,12.5996891579,1313207,9.89992720411,1276171,10.8502142146,1484026,-9465,-37036
2448,RYMAN HOSPITALITY PPTYS INC,63.0077942108,145236,61.8307801192,175204,64.0117085195,181748,62.486750053,150944,29968,6544
2449,S & T BANCORP INC,39.0311650683,83523,34.5782520325,39360,35.856103794,25435,39.5724666084,66334,-44163,-13925
2450,S&P GLOBAL INC,107.539842506,1002196,130.740031464,1491869,145.989936429,1643353,156.309640251,1319893,489673,151484
2451,SABAN CAP ACQUISITION CORP,10.3908099059,17323,10.5501579543,16777,10.7289741909,16777,10.6693687787,16777,-546,0
2452,SABRA HEALTH CARE REIT INC,24.4214352949,154045,27.9266433945,162712,24.0989083004,625630,21.9397040956,1599976,8667,462918
2453,SABRE CORP,24.9496353443,1600825,21.1895808745,1930949,21.7698729977,3530016,18.0999587036,3719456,330124,1599067
2454,SAFE BULKERS INC,1.1489291051,301150,2.2010178386,472963,2.29049289044,287711,2.73878670539,247920,171813,-185252
2455,SAFEGUARD SCIENTIFICS INC,13.4737152113,13582,12.7151799687,15336,11.9328430692,14414,13.3755719817,14205,1754,-922
2456,SAFETY INS GROUP INC,73.7053291536,39875,70.0878036673,32231,68.3001629237,31303,76.2993762994,48100,-7644,-928
2457,SAGE THERAPEUTICS INC,51.0566697201,153927,71.0706938412,161867,79.6419737559,238530,62.2992327214,338078,7940,76663
2458,SAIA INC,44.1534489118,108440,44.3009877094,815422,51.2994671435,893674,62.6496612504,880739,706982,78252
2459,SALEM MEDIA GROUP INC,6.26071401953,26834,7.44475945203,46207,7.11167441205,14202,6.59937888199,18032,19373,-32005
2460,SALESFORCE COM INC,68.4601904463,2909691,82.4896687123,2913480,86.6001592624,4862416,93.4200152948,4146499,3789,1948936
2461,SALLY BEAUTY HLDGS INC,26.4199839429,1967980,20.4398513063,632441,20.2499705009,1322076,19.5797841049,2090830,-1335539,689635
2462,SANCHEZ ENERGY CORP,9.03228680573,89789,9.54006212342,668025,7.17998810713,1355434,4.8208290669,518583,578236,687409
2463,SANDERSON FARMS INC,94.2415753618,120658,103.840670789,118547,115.645445858,108824,161.522765582,101447,-2111,-9723
2464,SANDSTORM GOLD LTD,3.90165343358,497994,4.27138834901,135319,3.87064861188,727785,4.54262373155,27297,-362675,592466
2465,SANDY SPRING BANCORP INC,39.9908883311,706786,40.9891183449,709359,40.6604381882,808009,41.4409208927,799572,2573,98650
2466,SANFILIPPO JOHN B & SON INC,70.394265233,34875,73.1896096051,52972,63.1222718132,40778,67.3264775972,46579,18097,-12194
2467,SANMINA CORPORATION,36.648346013,331502,40.5989199804,325920,38.0984654112,268541,37.1516570743,338639,-5582,-57379
2468,SANOFI,27.755662172,1299987,32.9792871899,1575595,34.9363430083,1656613,33.9856020721,1478685,275608,81018
2469,SANTANDER CONSUMER USA HDG I,13.5003244332,1485668,13.3200172397,1104428,12.7601693728,2569480,15.3701296787,2068883,-381240,1465052
2470,SAP SE,86.429970184,1481419,98.1699587789,2079516,104.669626731,1594560,109.650223796,1669153,598097,-484956
2471,SAREPTA THERAPEUTICS INC,27.4329489057,238363,29.5988680633,532892,33.7101704244,813968,45.3604185496,664963,294529,281076
2472,SAUL CTRS INC,66.6164280332,33175,61.6374487132,21448,58.0279736447,8651,61.913405348,45176,-11727,-12797
2473,SCANA CORP NEW,73.2804115009,3189106,65.349849779,2480679,67.0098837282,2252996,48.4895688221,1421316,-708427,-227683
2474,SCANSOURCE INC,40.3532773078,107451,39.2468378187,114557,40.3040629096,95375,43.6512464721,131451,7106,-19182
2475,SCHEIN HENRY INC,151.711231052,483570,169.970768909,411206,183.020405472,424592,81.9903668562,828390,-72364,13386
2476,SCHLUMBERGER LTD,83.9501496309,5586077,78.1000973335,6372937,65.8399624402,7539980,69.7602157327,7701381,786860,1167043
2477,SCHNITZER STL INDS,25.698794101,401692,20.6528381251,266743,25.1983229827,325101,28.1497431145,366895,-134949,58358
2478,SCHOLASTIC CORP,47.4998852105,43558,42.5734919147,60789,43.5811304221,34235,37.1916216112,77867,17231,-26554
2479,SCHULMAN A INC,33.4516330152,83404,31.440091033,71183,31.9995438818,280629,34.151617719,243151,-12221,209446
2480,SCHWAB CHARLES CORP NEW,39.4698039451,4933873,40.8100448891,4379461,42.9599786622,4682777,43.7401043061,6704305,-554412,303316
2481,SCHWAB STRATEGIC TR,43.6227798358,257526,46.5756462546,207426,51.2914440693,439508,54.8212747377,338956,-50100,232082
2482,SCHWEITZER-MAUDUIT INTL INC,45.526639263,151318,41.4173844021,84409,37.2310714767,51919,41.4593698176,89244,-66909,-32490
2483,SCICLONE PHARMACEUTICALS INC,10.7993300764,345114,9.80094310962,227121,10.9993800184,330655,11.1988539708,279225,-117993,103534
2484,SCIENCE APPLICATNS INTL CP N,84.798551801,430880,74.3979145358,411611,69.4186676503,346996,66.8504255703,338487,-19269,-64615
2485,SCIENTIFIC GAMES CORP,14.0001772174,157998,23.6503391108,165875,26.1001748532,367737,45.8503219711,486845,7877,201862
2486,SCORPIO BULKERS INC,5.04729243874,72316,9.20067336158,103362,7.09565217391,57500,7.05319517566,89463,31046,-45862
2487,SCORPIO TANKERS INC,4.52971262127,348808,4.43999417706,1016668,3.97003936278,1451371,3.4296672986,591311,667860,434703
2488,SCOTTS MIRACLE GRO CO,95.5503032028,428591,93.3898280221,409006,89.4601140714,243181,97.3403019316,271121,-19585,-165825
2489,SCRIPPS E W CO OHIO,19.3300394972,207863,23.4401982893,196884,17.8085318399,179633,19.1114777831,256966,-10979,-17251
2490,SCRIPPS NETWORKS INTERACT IN,71.3698189331,2380446,78.3699483928,1994489,68.3099017366,1620746,85.8899522803,3873247,-385957,-373743
2491,SEABOARD CORP,3954.54545455,242,4166.66666667,204,3994.75753604,763,4506.36942675,314,-38,559
2492,SEACOAST BKG CORP FLA,22.0785980741,23054,24.0071797173,31199,24.1060721683,73384,23.8922047387,110580,8145,42185
2493,SEADRILL LIMITED,3.41000829903,1592958,1.65017540377,2065235,0.360668878024,6083142,0.350275842226,1678677,472277,4017907
2494,SEADRILL PARTNERS LLC,4.19992477747,143574,3.59971547159,835066,3.40015759188,930251,3.71230212599,180481,691492,95185
2495,SEAGATE TECHNOLOGY PLC,38.1690710608,1732869,45.9299125659,2739892,38.7500471379,3845105,33.169561449,3996616,1007023,1105213
2496,SEALED AIR CORP NEW,45.3402002086,1328115,43.5797654907,1487617,44.7599534909,3466849,42.7196654151,3801247,159502,1979232
2497,SEARS HLDGS CORP,5.51026943864,302889,4.84742665167,294383,4.81626970052,755564,3.66908323469,949556,-8506,461181
2498,SEASPAN CORP,9.13300539969,62411,6.93102923443,85413,7.1394028863,628624,7.09046107983,775549,23002,543211
2499,SEATTLE GENETICS INC,52.7695695448,969555,62.8600216726,1052020,51.740574518,1148615,54.4096493146,1285397,82465,96595
2500,SEAWORLD ENTMT INC,18.9324181037,71676,18.2702242966,569068,16.2677647708,333666,12.991039674,383803,497392,-235402
2501,SEI INVESTMENTS CO,49.3593836375,980462,50.4394882719,887737,53.7802536221,841015,61.0591244397,930901,-92725,-46722
2502,SELECT COMFORT CORP,22.6204567178,403838,24.789217187,604295,35.4902909157,630595,31.0496680626,648767,200457,26300
2503,SELECT INCOME REIT,25.2005274146,182020,25.7919820578,267525,24.0307387846,155634,23.4191136391,155941,85505,-111891
2504,SELECT MED HLDGS CORP,13.2499155542,340455,13.3495502742,305853,15.3519358888,258925,19.1995185074,481835,-34602,-46928
2505,SELECT SECTOR SPDR TR,50.6449521536,98304269,51.168641642,75470227,50.226958476,77728756,51.5812864203,70496400,-22834042,2258529
2506,SELECTIVE INS GROUP INC,43.0537061696,117156,47.150781644,432294,50.049157395,995781,53.8498674252,1346410,315138,563487
2507,SEMGROUP CORP,41.7499642966,4012219,35.9999844193,4364363,26.9999152571,4354347,28.7501450839,4462934,352144,-10016
2508,SEMPRA ENERGY,100.640412893,2229343,110.499989249,2557955,112.749817869,1877768,114.12955659,1862769,328612,-680187
2509,SEMTECH CORP,31.5502097017,2148290,33.8002828695,1985368,35.7502666145,1525611,37.5500089184,1474487,-162922,-459757
2510,SENIOR HSG PPTYS TR,18.9301293074,1531157,20.2499185149,1297783,20.4397445366,2018763,19.5502449486,1599315,-233374,720980
2511,SENSATA TECHNOLOGIES HLDG NV,38.9497356074,3942055,43.6698092045,3994224,42.7200366101,4720010,48.0699139181,4517441,52169,725786
2512,SENSIENT TECHNOLOGIES CORP,78.5799128943,151540,79.2541746095,122227,80.5309734513,100570,76.9215234864,99036,-29313,-21657
2513,SEQUANS COMMUNICATIONS S A,1.8718558671,25643,2.74908363879,24008,3.29329717164,20648,3.12073337234,20508,-1635,-3360
2514,SEQUENTIAL BRNDS GROUP INC N,4.69918591568,15109,3.88835240698,194684,3.99009583083,2363853,2.99021198467,1704227,179575,2169169
2515,SERES THERAPEUTICS INC,9.89681446284,35567,11.2792111306,44418,11.2802916577,23315,16.0329023039,28691,8851,-21103
2516,SERITAGE GROWTH PPTYS,42.7098016726,559731,43.1497046407,554071,41.9504997141,337493,46.0698449925,272890,-5660,-216578
2517,SERVICE CORP INTL,28.3998843382,733172,30.8798008182,1027403,33.4505373151,959865,34.4996840093,1261113,294231,-67538
2518,SERVICEMASTER GLOBAL HLDGS I,37.671021288,291338,41.7502049051,317220,39.1913906304,202570,46.7277703286,272215,25882,-114650
2519,SERVICENOW INC,74.3403059386,1828537,87.4700146892,2187321,106.000577957,2456930,117.530111707,2636184,358784,269609
2520,SERVICESOURCE INTL INC,5.66544081105,30183,3.87665644716,39467,3.87471746852,40261,3.4657619204,54822,9284,794
2521,SERVISFIRST BANCSHARES INC,37.4452545086,75577,36.3809384379,81966,36.8581329413,19046,38.8426785686,64079,6389,-62920
2522,SHAKE SHACK INC,35.7907499001,362915,33.4000685213,615867,34.87991469,592662,33.2303107791,496655,252952,-23205
2523,SHAW COMMUNICATIONS INC,20.0600007736,1835643,20.7200044206,1954488,21.7897702902,1666929,23.0097565964,870283,118845,-287559
2524,SHELL MIDSTREAM PARTNERS L P,29.0899700691,4437887,32.2302035621,4176269,30.2998997753,4249453,27.8401478533,4207413,-261618,73184
2525,SHENANDOAH TELECOMMUNICATION,27.3024523161,91750,28.0462054403,80510,30.6992955858,82054,37.2037914692,92840,-11240,1544
2526,SHERWIN WILLIAMS CO,268.739342179,773493,310.190984043,741685,350.960512918,745383,358.040225302,878999,-31808,3698
2527,SHINHAN FINANCIAL GROUP CO L,37.6358271966,125067,41.7850936864,148474,43.490370842,150792,44.3025516104,162564,23407,2318
2528,SHIP FINANCE INTERNATIONAL L,14.8712110431,28108,14.6953846154,40625,13.6034366577,47488,14.5052473763,53360,12517,6863
2529,SHIRE PLC,170.379729018,880944,174.227852783,432560,165.271097838,363651,153.140046417,1299105,-448384,-68909
2530,SHOE CARNIVAL INC,26.9931439765,25525,24.5416486213,13854,20.8964173287,33355,22.3864444513,64682,-11671,19501
2531,SHOPIFY INC,42.8827572467,40156,68.0901677925,157218,86.8996424187,447171,116.488015612,345366,117062,289953
2532,SHUTTERFLY INC,50.1785772797,305190,48.2905351497,169205,47.5016130189,139490,48.4837172405,171439,-135985,-29715
2533,SHUTTERSTOCK INC,47.5219315601,164261,41.3499962901,188682,44.0794419279,256741,33.2897347671,269122,24421,68059
2534,SIENTRA INC,8.51991509424,783928,8.41987912926,783978,9.71976113295,783867,15.3993430314,799125,50,-111
2535,SIGMA DESIGNS INC,6.00053576212,18665,6.25461326289,25741,5.859375,18432,6.27711621896,21666,7076,-7309
2536,SIGNATURE BK NEW YORK N Y,150.199112374,969553,148.389100479,734124,143.530311591,755701,128.039727949,829844,-235429,21577
2537,SIGNET JEWELERS LIMITED,94.2608524368,548287,69.270021279,808777,63.2406495906,1098107,66.5492165116,946217,260490,289330
2538,SILGAN HOLDINGS INC,51.178469314,222789,59.3651717054,110014,31.7778907199,232174,29.4294205637,203232,-112775,122160
2539,SILICON LABORATORIES INC,64.9994393246,436973,73.5500131134,468987,68.3496525531,298319,79.8987362502,293096,32014,-170668
2540,SILICON MOTION TECHNOLOGY CO,42.4509803922,10200,46.7489752338,407410,48.2288828338,11010,48.004414199,10874,397210,-396400
2541,SILVER SPRING NETWORKS INC,13.2880972576,21222,11.2941310347,70302,11.2861662915,61314,16.1671910671,289537,49080,-8988
2542,SIMMONS 1ST NATL CORP,62.1498059646,188110,55.1521377209,169386,52.8955768354,116229,57.9021735863,166315,-18724,-53157
2543,SIMON PPTY GROUP INC NEW,177.67012738,3555336,172.029845863,3698335,161.760073242,4469564,161.010166457,4139397,142999,771229
2544,SIMPSON MANUFACTURING CO INC,43.7482173808,91158,43.0970719632,101399,43.7139388209,186142,49.0423696948,167549,10241,84743
2545,SINA CORP,60.7925165913,392976,72.1216297805,163973,84.9697299233,754045,114.651302784,538232,-229003,590072
2546,SINCLAIR BROADCAST GROUP INC,33.3493319836,572965,40.5018100529,299715,32.8996125595,532985,32.048118364,378899,-273250,233270
2547,SIRIUS XM HLDGS INC,4.45003220501,5556589,5.15006879863,7859895,5.46975011202,3903469,5.51995308342,3804199,2303306,-3956426
2548,SIX FLAGS ENTMT CORP NEW,59.959979936,927035,59.4901796908,897375,59.6094811066,1074980,60.9397886741,1533366,-29660,177605
2549,SJW GROUP,55.969833065,23602,48.231511254,24569,49.1732086187,59870,56.5993339125,55248,967,35301
2550,SK TELECOM LTD,20.899591095,143065,25.1813961873,177512,25.6714012532,332588,24.5934153114,151260,34447,155076
2551,SKECHERS U S A INC,24.5801967398,1302634,27.4497754843,1350685,29.5011588252,695532,25.0898655492,1007060,48051,-655153
2552,SKYWEST INC,36.4526182933,194115,34.2498499598,98307,35.0957187853,142553,43.8999947149,1494761,-95808,44246
2553,SKYWORKS SOLUTIONS INC,74.6592267676,1000372,97.9797328508,946063,95.949780227,975552,101.89946927,1312156,-54309,29489
2554,SL GREEN RLTY CORP,107.55012912,716001,106.61981272,689234,105.800547182,725535,101.320400572,613223,-26767,36301
2555,SLM CORP,11.0199858788,23905929,12.1000004575,18362396,11.500012376,15069549,11.4700258255,15320105,-5543533,-3292847
2556,SM ENERGY CO,34.4799271878,2021640,24.0200121211,2341381,16.5302703498,768227,17.7400608764,2076994,319741,-1573154
2557,SMART & FINAL STORES INC,14.0969591772,123289,12.1009992589,78258,9.10591884725,79948,7.84656815168,146306,-45031,1690
2558,SMART SAND INC,16.5493312411,754532,16.2498692282,1405119,8.910983336,601056,6.78106748762,315732,650587,-804063
2559,SMITH & NEPHEW PLC,30.078125,199680,30.9288345938,237222,34.849991354,462640,36.3994001052,357396,37542,225418
2560,SMITH A O,47.3497168908,2244364,51.1604228117,1905340,56.3299092329,1639360,59.4298898997,1443230,-339024,-265980
2561,SMUCKER J M CO,128.059727066,1038859,131.080398702,1017902,118.329755385,722481,104.929697087,629917,-20957,-295421
2562,SNAP ON INC,171.269436064,706676,168.670595709,566720,158.001619122,437274,149.008550676,489435,-139956,-129446
2563,SNYDERS-LANCE INC,38.3389481021,275464,40.3098122727,1999017,34.6200520705,4165505,38.1402134446,2889837,1723553,2166488
2564,SOCIEDAD QUIMICA MINERA DE C,28.6497583286,384820,34.3701796092,984749,33.0195181493,1298535,55.660030082,600359,599929,313786
2565,SODASTREAM INTERNATIONAL LTD,39.4685566759,82116,48.4295302013,93125,53.5141933652,73943,66.449283372,54282,11009,-19182
2566,SOHU COM INC,33.8861497087,89240,39.3380259507,82541,45.0619252644,75252,54.4510072777,113772,-6699,-7289
2567,SOLAR CAP LTD,20.8059722126,28934,22.6180859657,23521,21.8715351084,65839,21.6471084464,66383,-5413,42318
2568,SOLAR SR CAP LTD,16.4286994444,16739,17.9833012203,17127,16.7120093276,15438,17.19741058,15293,388,-1689
2569,SOLAREDGE TECHNOLOGIES INC,12.398157988,59283,15.6034550508,139969,19.9991205312,341115,28.5502360876,678138,80686,201146
2570,SONIC AUTOMOTIVE INC,22.8959666968,76389,20.046572846,49385,19.4664239199,14281,20.3973611537,130360,-27004,-35104
2571,SONIC CORP,26.5098708369,909548,25.3623438114,290194,26.4872481723,143352,25.4483631046,222922,-619354,-146842
2572,SONOCO PRODS CO,52.7001844648,2016103,52.919923961,1952157,51.4197515956,1366401,50.4501789487,1041919,-63946,-585756
2573,SONUS NETWORKS INC,6.29282765465,94711,6.58609674976,121468,7.44144535302,82914,7.65057501137,123128,26757,-38554
2574,SONY CORP,28.030061859,640812,33.7293690043,839150,38.1903719248,691457,37.3395387484,784691,198338,-147693
2575,SORRENTO THERAPEUTICS INC,4.89117143556,12267,3.92974966039,20612,1.99860134712,271690,1.67588402883,5967,8345,251078
2576,SOTHEBYS,39.8589473499,682582,45.4798391449,713437,53.6695159087,929019,46.110251038,914005,30855,215582
2577,SOTHERLY HOTELS INC,6.79493598455,13981,6.38610383805,31318,6.77836650914,41898,5.88623610958,18178,17337,10580
2578,SOUTH JERSEY INDS INC,33.6901630914,1499221,35.649916111,2311983,34.1700629981,2352293,34.530131035,2452322,812762,40310
2579,SOUTH ST CORP,87.4003316106,782846,89.3496363123,786114,85.700558525,965758,90.0496015376,927189,3268,179644
2580,SOUTHERN CO,49.190057953,4648419,49.7799810637,5561794,47.8799407695,7283405,49.1400035202,6624562,913375,1721611
2581,SOUTHERN COPPER CORP,31.9396698716,618729,35.8904427979,679791,34.628783948,620582,39.759896944,923770,61062,-59209
2582,SOUTHSIDE BANCSHARES INC,37.6729186968,99541,33.5695749169,131786,34.9440723548,116758,36.3566351661,62327,32245,-15028
2583,SOUTHWEST AIRLS CO,49.8399185728,2538708,53.7600338366,2742595,62.1400211365,4340359,55.9799791436,2412684,203887,1597764
2584,SOUTHWESTERN ENERGY CO,10.8199620568,11989506,8.17000876359,14527157,6.07998962842,19005789,6.11709920701,16480197,2537651,4478632
2585,SP PLUS CORP,28.1474179946,18261,33.7682624276,21766,30.5370083225,31601,39.5024477355,32479,3505,9835
2586,SPARK ENERGY INC,30.3118518249,27481,31.9560047562,13456,18.8080670746,30891,14.9857635247,13346,-14025,17435
2587,SPARK NETWORKS INC,0.836897898456,21508,0.998003992016,14028,0.98821204207,14167,1.21134387915,14034,-7480,139
2588,SPARK THERAPEUTICS INC,49.8989173009,498107,53.3413566859,550061,59.7402346299,620637,89.1591402269,574198,51954,70576
2589,SPARTAN MTRS INC,9.25033725188,25945,7.99582502376,53653,8.8471849866,22380,11.0497237569,10136,27708,-31273
2590,SPARTANNASH CO,39.5387699049,450014,34.9895789912,719700,25.9599042132,736636,26.3689446909,399030,269686,16936
2591,SPDR DOW JONES INDL AVRG ETF,197.50993032,1962676,206.33985124,536164,213.240090972,1109796,223.820104826,659762,-1426512,573632
2592,SPDR GOLD TRUST,109.610104558,2496695,118.719933699,1790626,118.020211999,781417,121.580870782,1267757,-706069,-1009209
2593,SPDR INDEX SHS FDS,38.9454152751,17182536,39.9069111347,20334548,40.8557910192,20807650,41.7071473659,20903995,3152012,473102
2594,SPDR S&P 500 ETF TR,223.529996657,53041427,235.740007171,50334019,241.800007509,48823063,251.229989489,43567852,-2707408,-1510956
2595,SPDR S&P MIDCAP 400 ETF TR,301.730358034,530815,312.420231716,383141,317.619976394,597305,326.330226359,489973,-147674,214164
2596,SPDR SER TR,29.2595651066,3103703,30.8865498725,2155987,34.1537520232,764894,34.065472202,744713,-947716,-1391093
2597,SPDR SERIES TRUST,44.9958598895,55659143,48.9184604242,46622011,46.7384605113,54488701,48.8872174905,48130025,-9037132,7866690
2598,SPECTRA ENERGY PARTNERS LP,45.8398243068,657965,43.6600826783,854396,42.8997398059,1579590,44.3800715842,1406735,196431,725194
2599,SPECTRUM BRANDS HLDGS INC,122.330358376,1144442,139.009412231,1080934,125.039122566,881844,105.920045389,923574,-63508,-199090
2600,SPECTRUM PHARMACEUTICALS INC,4.42990739569,1729833,6.49973204584,1627144,7.44973181284,1256958,14.0703523125,1814951,-102689,-370186
2601,SPEEDWAY MOTORSPORTS INC,21.6517166718,19398,18.832694846,31063,18.2835197863,23956,21.2750455373,13725,11665,-7107
2602,SPIRE INC,64.5554760726,109038,67.5084992715,57652,69.7231252102,44605,74.6466008438,114955,-51386,-13047
2603,SPIRIT AEROSYSTEMS HLDGS INC,58.349995779,4702691,57.91994908,5008637,57.9400405598,4889572,77.7201379274,4409565,305946,-119065
2604,SPIRIT AIRLS INC,57.8602401934,1000860,53.07024961,786467,51.6494031802,786921,33.4122927316,200525,-214393,454
2605,SPIRIT RLTY CAP INC NEW,10.8596224817,1553461,10.1301375266,2040841,7.40998607519,2412960,8.57032504793,2418228,487380,372119
2606,SPLUNK INC,51.1500008196,2562346,62.2902489267,2910295,56.8898364506,3228872,66.4301691722,3392284,347949,318577
2607,SPOK HLDGS INC,20.7531670198,92516,19.0020625795,91148,17.6949675054,96016,15.3506337825,90094,-1368,4868
2608,SPRAGUE RES LP,28.0999971296,1358719,27.099713902,1293962,28.2002207473,1219494,24.600288231,1281611,-64757,-74468
2609,SPRINT CORP,8.41998343692,5576258,8.67977421889,3570715,8.20993407253,3250087,7.77972001942,2686472,-2005543,-320628
2610,SPROUTS FMRS MKT INC,18.9197708869,1973174,23.1202285633,2963206,22.6699440043,2823430,18.7698755236,2926338,990032,-139776
2611,SPS COMM INC,69.8790815633,22081,58.5063614435,21143,63.7962502074,12054,56.7164552841,79871,-938,-9089
2612,SPX CORP,23.715563171,186755,24.2495390643,138848,25.1493201169,78690,29.3356284109,149886,-47907,-60158
2613,SPX FLOW INC,32.0551959946,81890,34.7093635406,82629,36.8793327938,56834,38.5590304007,119142,739,-25795
2614,SQUARE INC,13.6270519543,110809,17.2805034538,699806,23.4600697146,4594445,28.8099879691,6369423,588997,3894639
2615,SS&C TECHNOLOGIES HLDGS INC,28.599846677,1271825,35.3997893078,1084046,38.4101805866,1326289,40.1507616605,802326,-187779,242243
2616,ST JOE CO,19.006993007,71500,17.048707321,87338,18.7446015805,155138,18.8499181498,143555,15838,67800
2617,STAG INDL INC,23.8678613865,339159,25.0196097962,481902,27.5998984344,716778,27.471419839,307556,142743,234876
2618,STAMPS COM INC,114.64946813,59695,118.342674374,34079,154.874721277,136336,202.648054399,100149,-25616,102257
2619,STANDARD MTR PRODS INC,53.2225636357,342693,49.1385385896,333445,52.2235784669,326883,48.2511200596,352883,-9248,-6562
2620,STANDEX INTL CORP,87.8511874185,303684,100.15001906,325292,90.7019232658,305418,106.201423774,251023,21608,-19874
2621,STANLEY BLACK & DECKER INC,114.689916406,2405303,132.869438252,2093002,140.730118044,1777466,150.969835388,1519330,-312301,-315536
2622,STANTEC INC,25.2462830346,55018,25.8951639978,68507,25.1042603647,73374,27.7478612505,98422,13489,4867
2623,STAR BULK CARRIERS CORP,5.10304866004,60748,11.8689630035,43896,9.83540341311,49515,9.70317210922,47098,-16852,5619
2624,STARBUCKS CORP,55.5201719724,4904974,58.3899469113,5881098,58.3099688943,6804857,53.7099365851,8448325,976124,923759
2625,STARWOOD PPTY TR INC,21.9500218969,6329652,22.5800293818,6202472,22.3901318117,5250974,21.7199202872,5086759,-127180,-951498
2626,STATE BK FINL CORP,26.8604115724,1316026,26.1196731775,1339565,27.1195146122,1269418,28.6495071633,1295764,23539,-70147
2627,STATE NATL COS INC,13.8574429199,73318,14.3886917835,35514,18.383775834,25838,20.9890090749,401877,-37804,-9676
2628,STATE STR CORP,77.7198710769,4469642,79.6101081919,2593540,89.7301134014,1994949,95.5401058779,1971706,-1876102,-598591
2629,STATOIL ASA,18.2401977125,920933,17.1807923,991165,16.5297669657,1060874,20.0902248721,1043393,70232,69709
2630,STEEL DYNAMICS INC,35.5798552543,8304081,34.7600740631,7437441,35.8099846234,5182549,34.4701540004,4683559,-866640,-2254892
2631,STEELCASE INC,17.8980508994,319532,16.7481558688,223547,14.0022110173,370870,15.3980670809,428885,-95985,147323
2632,STEIN MART INC,5.48107547589,108008,3.0036514979,101876,1.68832754991,278382,1.30625636041,65837,-6132,176506
2633,STEPAN CO,81.4787044295,88023,78.8043924298,60923,87.1515539891,56178,83.6524162481,85401,-27100,-4745
2634,STERICYCLE INC,77.03977649,1090242,82.8899507643,1198927,76.3196179843,1005613,70.5543187987,918172,108685,-193314
2635,STERIS PLC,67.3902683792,891835,69.4591675141,695243,81.5006378612,576928,88.3991276933,569983,-196592,-118315
2636,STERLING BANCORP DEL,23.4006821756,786601,23.6999756224,520971,23.2503265173,784032,24.6488945597,1017287,-265630,263061
2637,STEWART INFORMATION SVCS COR,46.0794844253,93100,44.18806404,88757,45.3805772491,146869,37.7609951133,326395,-4343,58112
2638,STIFEL FINL CORP,49.9504842878,2152852,50.1899441341,2080875,45.9797636697,2155035,53.4597993427,1748454,-71977,74160
2639,STMICROELECTRONICS N V,11.3499923952,558855,15.4590754848,719642,14.3792743146,614426,19.4196461839,536776,160787,-105216
2640,STOCK YDS BANCORP INC,46.9582176881,26662,40.6602885822,25504,38.8891292123,23117,38.0051166662,32443,-1158,-2387
2641,STONERIDGE INC,17.6917438529,30014,18.1422651934,144800,15.4112394528,97656,19.8049189892,97703,114786,-47144
2642,STORE CAP CORP,24.71011777,440265,23.8799299612,653352,22.4493360653,1379729,24.8701168685,759144,213087,726377
2643,STRATASYS LTD,16.5436364588,114606,20.4909506969,19228,23.3180865256,104940,23.1299787906,59879,-95378,85712
2644,STRAYER ED INC,80.6271334924,33103,80.5084745763,11092,93.2656700041,7291,87.2527837793,18051,-22011,-3801
2645,STRYKER CORP,119.810747175,1032904,131.650054437,1138017,138.78009139,1201008,142.020567511,1218232,105113,62991
2646,STUDENT TRANSN INC,5.58367191769,42087,5.86506803243,84739,6.07067904278,70997,5.98655220238,56961,42652,-13742
2647,STURM RUGER & CO INC,52.7068972467,99228,53.5493530925,130235,62.1455966821,108986,51.6998196319,116983,31007,-21249
2648,SUBURBAN PROPANE PARTNERS L,30.0603238107,639880,26.9604482144,816752,23.7899035852,967175,26.0907675149,1067849,176872,150423
2649,SUCAMPO PHARMACEUTICALS INC,13.548695606,169389,10.9992312365,186013,10.504582797,115759,11.7996293366,753244,16624,-70254
2650,SUMITOMO MITSUI FINL GROUP I,7.63977289397,2031474,7.25023630734,2108483,7.85996142397,2341869,7.70986129369,2387851,77009,233386
2651,SUMMER INFANT INC,2.02187298961,21762,1.89376859951,22178,1.76767676768,15840,1.86950831931,10698,416,-6338
2652,SUMMIT HOTEL PPTYS,16.0299032473,512854,15.9794992632,538127,18.6488069716,165587,15.9877370855,265516,25273,-372540
2653,SUMMIT MATLS INC,23.7900680181,3196502,24.7100599608,2699265,28.8701175075,3344808,32.0300652733,2123380,-497237,645543
2654,SUMMIT MIDSTREAM PARTNERS LP,25.1493105612,1252758,24.0007208646,1032094,22.6498562679,1068307,19.9993460213,886879,-220664,36213
2655,SUN CMNTYS INC,76.614918756,276082,80.3311191189,345495,87.6904138577,589768,85.6798141135,614999,69413,244273
2656,SUN HYDRAULICS CORP,39.9687255668,31975,36.1126785017,23039,42.6937738247,23610,54.0069078603,28663,-8936,571
2657,SUN LIFE FINL INC,38.4104392412,642039,36.549428961,750299,35.751187905,578750,39.8196280871,719846,108260,-171549
2658,SUNCOKE ENERGY INC,11.3412934521,719671,8.95837166559,505449,10.9003126529,282102,9.14352089801,194564,-214222,-223347
2659,SUNCOKE ENERGY PARTNERS L P,19.24915651,181982,15.3548208604,43374,17.5392075157,26398,17.2055057618,12496,-138608,-16976
2660,SUNCOR ENERGY INC NEW,32.6901640365,3534580,30.7502633834,1951528,29.2001897009,3460183,35.0297136623,3631831,-1583052,1508655
2661,SUNOCO LP,26.890221673,1829587,24.1701803311,1322456,30.6099153206,1340350,31.100035025,1758744,-507131,17894
2662,SUNPOWER CORP,6.6116815351,148525,6.10009303044,310651,9.34094954909,306714,7.29207118245,324462,162126,-3937
2663,SUNRUN INC,5.28330781011,13060,5.3973965499,56694,7.13235090056,36033,5.54323725055,65846,43634,-20661
2664,SUNSTONE HOTEL INVS INC NEW,15.2504631517,775124,15.3295180942,743859,16.1195270554,1318463,16.0699244717,1221661,-31265,574604
2665,SUNTRUST BKS INC,54.8499069746,9413562,55.2999822791,9006332,56.7199216697,10214189,59.7698890824,10870323,-407230,1207857
2666,SUNWORKS INC,2.0179191218,12389,1.52194809356,12484,1.74755739137,12589,1.60720025715,12444,95,105
2667,SUPER MICRO COMPUTER INC,28.0481932496,201439,25.3454478668,92561,24.6507368246,300275,22.1003215214,233888,-108878,207714
2668,SUPERIOR DRILLING PRODS INC,1.31606379652,76744,0.89325591782,67170,0.632806496813,66371,0.798424442434,56361,-9574,-799
2669,SUPERIOR ENERGY SVCS INC,16.8792577516,1749603,14.2599999245,2384993,10.4299976829,3431065,10.6800901539,2014777,635390,1046072
2670,SUPERIOR INDS INTL INC,26.3497103911,180761,25.3487783808,209517,20.5473795484,242172,16.6541808333,121471,28756,32655
2671,SUPERNUS PHARMACEUTICALS INC,25.2490144607,218662,31.2972736747,178482,43.1021436348,204839,40.0035841937,301323,-40180,26357
2672,SUPERVALU INC,4.67001334935,6865505,3.86000482058,5924604,3.28998934734,4490896,21.7479667076,263243,-940901,-1433708
2673,SUPPORT COM INC,0.872487558974,30946,2.22997866977,10314,2.32333010649,10330,2.32490555071,10323,-20632,16
2674,SURMODICS INC,25.4113253255,39628,24.0414347557,38808,28.1496943492,33535,30.9984625124,44228,-820,-5273
2675,SVB FINL GROUP,171.660569287,448280,186.092274832,404509,175.790157149,583713,187.09018168,577390,-43771,179204
2676,SYKES ENTERPRISES INC,28.8602585038,144524,29.403311106,139168,33.5335335335,151848,29.1616614099,168989,-5356,12680
2677,SYMANTEC CORP,23.8901002897,10059062,30.6800007387,7689374,28.2500967645,5244690,32.8099173342,3904033,-2369688,-2444684
2678,SYNAPTICS INC,53.581005038,529572,49.5082632615,364626,51.7109672756,243488,39.1808148768,199613,-164946,-121138
2679,SYNCHRONOSS TECHNOLOGIES INC,38.3043134533,103722,24.4002306805,173400,16.4485339117,93139,9.32888743785,186839,69678,-80261
2680,SYNCHRONY FINL,36.2700202312,15574433,34.3000209171,10952763,29.8199619554,10822046,31.0499667685,10157531,-4621670,-130717
2681,SYNERGY PHARMACEUTICALS INC,6.09052100993,1013378,4.66009906833,1425077,4.44982957569,2207725,2.90022817218,3317670,411699,782648
2682,SYNNEX CORP,121.019675033,1056415,111.939842269,1161347,119.960076654,1315521,126.510102759,1233277,104932,154174
2683,SYNOPSYS INC,58.8599150308,2100054,72.1299891566,2006752,72.9294326297,2146006,80.530056523,1992995,-93302,139254
2684,SYNOVUS FINL CORP,41.0789899687,675187,41.0208365107,688455,44.2397059164,865060,46.0595558864,1123046,13268,176605
2685,SYNTEL INC,19.789152942,359692,16.8230218106,25263,16.9526719369,67423,19.6506674564,351184,-334429,42160
2686,SYSCO CORP,55.3699488497,4925289,51.9199604096,6767301,50.3300533988,8090812,53.9500254823,7544445,1842012,1323511
2687,SYSTEMAX INC,8.78734622144,19346,11.0957387936,36140,18.7733438176,10174,26.4417923247,13993,16794,-25966
2688,T MOBILE US INC,57.5099614598,1577831,64.5904688879,1181583,60.6873673771,2779969,61.7058531906,4072531,-396248,1598386
2689,T2 BIOSYSTEMS INC,5.26005639823,4252616,5.26003660792,4252632,3.21006352221,4270632,4.20008092479,4270632,16,18000
2690,TABLEAU SOFTWARE INC,42.1498828843,1188995,49.5493954118,1110508,61.2705359006,1217502,74.8900269744,1356469,-78487,106994
2691,TAHOE RES INC,9.42050123182,569078,8.02927713417,346482,8.61900280467,214642,5.27026872955,350836,-222596,-131840
2692,TAILORED BRANDS INC,25.5506587076,422494,14.9376150875,184099,11.1596462253,259148,14.438929195,364847,-238395,75049
2693,TAIWAN SEMICONDUCTOR MFG LTD,28.7500447558,5474148,32.8399727942,5523817,34.9600334203,6609147,37.5501254963,7807404,49669,1085330
2694,TAKE-TWO INTERACTIVE SOFTWAR,49.2899151372,633375,59.2701967379,731430,73.3796183826,1152568,102.229950879,981053,98055,421138
2695,TAL ED GROUP,70.149310942,887008,106.568689712,799916,122.309989014,1186984,33.7099085123,3667705,-87092,387068
2696,TALLGRASS ENERGY GP LP,26.8023981473,138607,28.7582373651,155086,25.4306406412,163071,28.2509903035,82298,16479,7985
2697,TALLGRASS ENERGY PARTNERS LP,47.4480968858,184960,53.1982734312,230515,50.0899640996,351807,47.8908325275,326764,45555,121292
2698,TANGER FACTORY OUTLET CTRS I,35.7804848503,602619,32.7716112114,532351,25.9800800163,832330,24.4196473588,1110704,-70268,299979
2699,TANZANIAN ROYALTY EXPL CORP,0.496429526101,26187,0.420055752854,26187,0.436733235399,25187,0.279876854184,10719,0,-1000
2700,TARENA INTL INC,14.9897330595,560050,18.6799651998,497699,17.9102981366,877819,14.5500034887,1003230,-62351,380120
2701,TARGA RES CORP,56.0700419676,13249999,59.8999968427,14347747,45.2000298647,13541053,47.2999983038,13500973,1097748,-806694
2702,TARGET CORP,72.2299589668,3005858,55.1900653454,2981080,52.2897068755,4551718,59.0100063101,7302592,-24778,1570638
2703,TARO PHARMACEUTICAL INDS LTD,105.278458042,113518,116.621499548,110700,112.054442488,105065,112.685560054,124488,-2818,-5635
2704,TATA MTRS LTD,34.3900288118,1010351,35.6497842513,819472,33.0105157106,794050,31.2698757427,773556,-190879,-25422
2705,TAUBMAN CTRS INC,73.9298872922,2583583,66.0200859287,2599830,59.5500577626,2309452,49.6982144834,261941,16247,-290378
2706,TAYLOR MORRISON HOME CORP,19.2590091991,59245,21.320378135,452431,24.0102136501,1917434,22.0500605305,1273738,393186,1465003
2707,TC PIPELINES LP,58.83982112,787120,59.6601826102,835331,55.0001204822,912998,52.3194599972,896588,48211,77667
2708,TCF FINL CORP,19.5894849087,1468594,17.0198428629,1394960,15.9398093928,1831515,17.0401639307,2633308,-73634,436555
2709,TCP CAP CORP,16.9023654818,23547,17.4273313166,30412,16.9067000626,62283,16.4976511819,53644,6865,31871
2710,TD AMERITRADE HLDG CORP,43.6000468736,1587246,38.8596567162,1605727,42.98995307,1444919,48.8000109739,1239303,18481,-160808
2711,TE CONNECTIVITY LTD,69.2803964705,1618683,74.5501750965,1932363,78.6802197009,1828668,83.059623306,2008208,313680,-103695
2712,TEAM INC,39.252273606,59487,27.0474067274,30502,23.4706616729,12015,13.3457848714,117790,-28985,-18487
2713,TECH DATA CORP,84.6803250156,1761023,93.8999703534,1727008,101.00004805,1810613,88.8496944536,1390787,-34015,83605
2714,TECK RESOURCES LTD,20.0302837805,2712343,21.9002384991,1617197,17.3307013797,1149463,21.0899739026,947986,-1095146,-467734
2715,TECNOGLASS INC,12.2537241711,24972,10.8448172558,33380,9.34169553967,22801,6.7214339059,12051,8408,-10579
2716,TEEKAY CORPORATION,8.03247414547,139434,9.14799804035,112265,6.67076305902,566352,8.92987229697,803035,-27169,454087
2717,TEEKAY LNG PARTNERS L P,14.4504545298,1219062,17.5501011403,1028769,15.3504116649,876198,17.7998312151,787985,-190293,-152571
2718,TEEKAY OFFSHORE PARTNERS L P,5.06101509503,159059,5.07020374308,1251429,2.87167471498,69994,2.37369087352,69512,1092370,-1181435
2719,TEEKAY TANKERS LTD,2.26133158599,280808,2.04894920862,319188,1.88257547031,224161,1.61921936021,374872,38380,-95027
2720,TEGNA INC,21.3902021807,2951024,25.6198964843,3277765,14.4100526375,2494231,13.3302848706,3857682,326741,-783534
2721,TEKLA HEALTHCARE INVS,21.10764901,19898,24.0480961924,16966,25.1050042002,83330,25.2189405536,39851,-2932,66364
2722,TELECOM ARGENTINA S A,18.1718263418,136475,22.1909978187,251228,25.3334799489,118223,30.8330441914,63406,114753,-133005
2723,TELECOM ITALIA S P A NEW,8.60499539247,311447,8.62983605119,387377,8.91846132278,370916,8.98609879366,374356,75930,-16461
2724,TELEDYNE TECHNOLOGIES INC,123.000802934,138243,126.452635286,136304,127.650079156,212871,159.180839077,76322,-1939,76567
2725,TELEFLEX INC,161.149454229,532183,193.730515609,487249,207.75925448,461101,241.971012297,369536,-44934,-26148
2726,TELEFONICA BRASIL SA,13.3797411995,1992191,14.8497156071,3194876,13.4901792254,2848146,15.8399324589,2954053,1202685,-346730
2727,TELEFONICA S A,9.19933798462,1614464,11.1897957529,1738727,10.3901579766,1868884,10.7903348943,1850823,124263,130157
2728,TELENAV INC,7.04526046114,14052,8.68240670221,13130,8.06683952751,10413,6.3309352518,10425,-922,-2717
2729,TELEPHONE & DATA SYS INC,28.8680630967,318622,26.512009438,216996,27.7517098477,266398,27.887355319,215474,-101626,49402
2730,TELETECH HOLDINGS INC,30.5058447621,76051,29.6028462044,51718,40.8030631661,127711,41.7460102952,81397,-24333,75993
2731,TELIGENT INC NEW,6.61071510692,121772,7.80907683469,102701,9.14720286306,84944,6.70893201554,108363,-19071,-17757
2732,TELUS CORP,31.8501986523,3084031,32.4799929318,1448738,34.5201836597,851357,35.9695039539,669595,-1635293,-597381
2733,TEMPUR SEALY INTL INC,68.2789868529,336575,46.4597165791,807280,53.3910920248,933770,64.5202708857,911233,470705,126490
2734,TENARIS S A,35.7095803613,1305504,34.1401739516,1335084,31.1403478602,1308399,28.3103315205,1256785,29580,-26685
2735,TENET HEALTHCARE CORP,14.8400911941,1472902,17.7099487213,2973357,19.3403981265,1376497,16.4298536283,1251198,1500455,-1596860
2736,TENNANT CO,71.2048504353,34801,72.6493691978,273065,73.7990721085,312321,66.2001652342,741977,238264,39256
2737,TENNECO INC,62.4727670438,341957,62.4203149128,378835,57.8293178282,463329,60.6685531448,616316,36878,84494
2738,TERADATA CORP DEL,27.169309065,622099,31.1189030117,590927,29.4899538359,606749,33.7897646634,606663,-31172,15822
2739,TERADYNE INC,25.3998130767,2306828,31.0997511739,1993360,30.0297013871,1763554,37.2899530691,2448917,-313468,-229806
2740,TEREX CORP NEW,31.5300268681,619695,31.3997088976,2998945,37.5000921333,3256152,45.0202038228,2224579,2379250,257207
2741,TERNIUM SA,24.1503363557,341900,26.1197207634,387485,28.1371280724,9276,30.928404571,253424,45585,-378209
2742,TERRAFORM GLOBAL INC,3.94882578615,249188,4.79988732403,4032803,5.04753323649,108766,4.74770419973,92887,3783615,-3924037
2743,TERRAFORM PWR INC,12.800378633,46483,12.3706471748,584448,12.0010378176,589699,13.2196490148,571876,537965,5251
2744,TERRENO RLTY CORP,28.4898445266,2865056,28.0002254851,1472381,33.6601114285,1321386,36.1806647376,817315,-1392675,-150995
2745,TESARO INC,134.479686245,251406,153.868654492,324777,139.860412355,461932,129.099243354,336617,73371,137155
2746,TESCO CORP,8.24582006201,118363,8.04563299942,113602,4.45006483008,124942,5.45129051508,186011,-4761,11340
2747,TETRA TECH INC NEW,43.1465292735,142074,40.8563005757,50543,45.7522521457,84586,46.5501940712,111557,-91531,34043
2748,TETRA TECHNOLOGIES INC DEL,5.0204832538,503338,4.06978173405,366113,2.78990596823,460589,2.86008297189,678302,-137225,94476
2749,TEVA PHARMACEUTICAL INDS LTD,36.2504447223,1748282,32.0898960769,1523626,33.2203793728,2098200,17.5991602837,1249946,-224656,574574
2750,TEXAS CAPITAL BANCSHARES INC,78.3998304974,1227120,83.4502825073,1448635,77.3995038799,1257760,85.8002084509,1213715,221515,-190875
2751,TEXAS INSTRS INC,72.9700784888,6565143,80.559997636,7884819,76.9301211286,8517639,89.6400407982,8269965,1319676,632820
2752,TEXAS PAC LD TR,296.59643436,1851,280.048076923,1664,293.862031505,1841,404.090267983,1418,-187,177
2753,TEXAS ROADHOUSE INC,48.2405826034,738341,44.5290680637,668844,50.9499427908,592562,49.140969134,758471,-69497,-76282
2754,TEXTAINER GROUP HOLDINGS LTD,7.44954468568,258942,15.295355617,173909,14.4991698949,18070,17.1430601695,112582,-85033,-155839
2755,TEXTRON INC,48.560077252,3624500,47.5900540414,4362214,47.0998986441,3299264,53.8798834302,3523727,737714,-1062950
2756,TFS FINL CORP,19.0361110712,208551,16.620498615,105051,15.4736528203,90541,16.1346656785,117387,-103500,-14510
2757,THE ONE GROUP HOSPITALITY IN,2.2265190133,34134,1.88754582743,27549,2.17749917519,30310,1.69113170534,14783,-6585,2761
2758,THERAPEUTICSMD INC,5.77029720778,200163,7.19923512998,384902,5.26870992364,349801,5.28925304787,419719,184739,-35101
2759,THERAVANCE BIOPHARMA INC,31.8874035281,58048,36.8201163563,256110,39.8367729204,239176,34.2395875518,256808,198062,-16934
2760,THERMO FISHER SCIENTIFIC INC,141.099615609,1566893,153.599778064,1751858,174.470241496,2091755,189.200790447,2022148,184965,339897
2761,THERMON GROUP HLDGS INC,19.0901395058,1293495,20.8400397788,1391696,19.1703511091,1362938,17.9904895569,506601,98201,-28758
2762,THIRD PT REINS LTD,11.5495295753,696392,12.099897793,339507,13.8987035691,298589,15.5984991714,308363,-356885,-40918
2763,THL CR INC,10.0180653638,42623,9.96577105989,33013,9.94403906293,72908,9.33105723048,69124,-9610,39895
2764,THOMSON REUTERS CORP,43.7797694656,1350167,43.2301120008,1662221,46.2900437602,2827001,45.8799592042,1955102,312054,1164780
2765,THOR INDS INC,100.050248592,1188093,96.1297242782,1419873,104.51995542,965452,125.909704716,806443,231780,-454421
2766,TICC CAPITAL CORP,6.61450002162,46262,7.38368749126,64331,6.34115409004,157700,6.85434753185,103438,18069,93369
2767,TIER REIT INC,17.3901711506,69062,17.3634577195,96179,18.4843565525,189728,19.3012639164,382462,27117,93549
2768,TIFFANY & CO NEW,77.4297119544,1067678,95.3004716771,1078704,93.8708731279,1091020,91.7797714531,1249284,11026,12316
2769,TILE SHOP HLDGS INC,19.5460492633,87895,19.2498009328,351640,20.6496109408,339280,12.700190903,437395,263745,-12360
2770,TILLYS INC,13.1906051723,53902,9.02498709113,44543,10.1525899341,83033,11.9825708061,60588,-9359,38490
2771,TIM PARTICIPACOES S A,11.7998390247,1196457,15.98021553,1875006,14.7999371473,1285546,18.2794984184,1534506,678549,-589460
2772,TIME INC NEW,17.8502309143,1997061,19.3501689,1953523,14.3499886435,783694,13.4998552849,870676,-43538,-1169829
2773,TIME WARNER INC,96.5299307731,4654691,97.7100643625,5685924,100.40987751,7317796,102.450031449,10137176,1031233,1631872
2774,TIMKEN CO,39.6996326962,1109708,45.1997600013,1130006,46.2505191008,1191965,48.5502677813,1061127,20298,61959
2775,TIMKENSTEEL CORP,15.4816481898,179955,18.9127300483,70746,15.3651283181,72632,16.5007180757,166417,-109209,1886
2776,TITAN INTL INC ILL,11.21285971,162492,10.3413153737,192432,11.9947533741,57942,10.1490113669,125628,29940,-134490
2777,TITAN MACHY INC,14.5658099118,68242,15.3316733346,71486,17.9798665561,179701,15.5308926034,236432,3244,108215
2778,TIVO CORP,20.8977082275,316829,18.752130924,184779,18.6487667377,258623,19.8499884877,512494,-132050,73844
2779,TJX COS INC NEW,75.1299275266,3328394,79.0798308314,2998666,72.1700364993,4145557,73.7300740086,3744293,-329728,1146891
2780,TOLL BROTHERS INC,31.000113278,2286411,36.109543898,2095014,39.509976477,1803342,41.4699868448,1840343,-191397,-291672
2781,TOOTSIE ROLL INDS INC,39.758539601,41249,37.3553175305,48641,34.8410757946,39264,38.0001423893,56184,7392,-9377
2782,TOPBUILD CORP,35.5999268969,924721,47.0007367109,988176,53.0700342693,1109157,65.170350766,1073080,63455,120981
2783,TORCHMARK CORP,73.7596556412,1069582,77.0400587583,1196767,76.4997777217,1331664,80.0900316855,1399063,127185,134897
2784,TORO CO,55.94972832,1632251,62.4598533719,1385546,69.2899838984,1360110,62.0605016042,1269487,-246705,-25436
2785,TORONTO DOMINION BK ONT,49.3399987606,1355452,50.0910933085,1271224,50.3800206936,1700039,56.2701605271,2007636,-84228,428815
2786,TOTAL S A,50.9698998704,652954,50.419927273,1081854,49.5894359193,1258756,53.5198389152,822424,428900,176902
2787,TOTAL SYS SVCS INC,49.0301805803,2639048,53.4598055233,2961178,58.2498187899,3610449,65.5003300325,3755691,322130,649271
2788,TOWER INTL INC,28.3494222362,584668,27.1002843745,608001,22.4480997304,136849,27.1996197573,130443,23333,-471152
2789,TOWER SEMICONDUCTOR LTD,19.0298701395,134683,23.0465270323,87562,23.8441225644,63999,30.7478037283,74672,-47121,-23563
2790,TOWN SPORTS INTL HLDGS INC,2.49913224575,72025,3.54327724723,52776,4.69450672646,42816,6.97775839512,16051,-19249,-9960
2791,TOWNEBANK PORTSMOUTH VA,33.1907360968,6779,32.3637390568,17705,30.8172177168,8015,33.5005966079,563184,10926,-9690
2792,TOYOTA MOTOR CORP,117.200460104,428599,108.620501933,440856,105.018595399,462480,119.169582278,517330,12257,21624
2793,TPG SPECIALTY LENDING INC,18.6889676449,39221,20.4003171781,41617,20.4459948132,109508,20.9619323399,70795,2396,67891
2794,TRACTOR SUPPLY CO,75.809568853,1150211,68.9699357347,1318908,54.2100159167,1897380,63.290179404,2123252,168697,578472
2795,TRANSALTA CORP,5.49822064057,56200,5.85333771786,106435,6.40011844594,3269002,5.85131220635,241997,50235,3162567
2796,TRANSATLANTIC PETROLEUM LTD,1.11546533985,68133,1.39636634447,64453,1.19888104436,60056,0.869565217391,18400,-3680,-4397
2797,TRANSCANADA CORP,45.1499603018,2990058,46.1498611963,4100034,47.6700098299,4735535,49.4300260752,4976368,1109976,635501
2798,TRANSDIGM GROUP INC,248.958122198,404558,220.161374104,433155,268.870304787,435976,255.649890732,497399,28597,2821
2799,TRANSENTERIX INC,1.2918543347,57282,1.2030798845,16624,0.709774526076,1203199,1.43159930093,161358,-40658,1186575
2800,TRANSGLOBE ENERGY CORP,1.68317219243,25547,1.57616241978,26647,1.3264710564,18847,1.43258874091,18847,1100,-7800
2801,TRANSMONTAIGNE PARTNERS L P,44.2691940929,586209,44.6801193453,537935,42.0000343875,697928,42.7110085362,668563,-48274,159993
2802,TRANSOCEAN LTD,14.7400518867,1846330,12.4501324674,2828243,8.23019018362,3198225,10.7601210969,4005717,981913,369982
2803,TRANSPORTADORA DE GAS SUR,9.02020436674,1256956,14.2200498648,1479601,16.6101592139,1517204,20.3098090172,1456833,222645,37603
2804,TRANSUNION,30.9300027539,55510341,38.3499985867,44788398,43.3100020193,37290370,47.2599844957,23552166,-10721943,-7498028
2805,TRAVELCENTERS AMER LLC,7.09954054279,156489,6.10104988623,300604,4.1017548207,153349,4.25894378194,29350,144115,-147255
2806,TRAVELERS COMPANIES INC,122.419964344,2043964,120.540163498,1872322,126.530179606,2160449,122.519873823,2285670,-171642,288127
2807,TRAVELPORT WORLDWIDE LTD,14.0999892985,2887449,11.7702697849,1169302,13.759774746,1603878,15.6998623982,965104,-1718147,434576
2808,TREDEGAR CORP,23.9942901635,77060,17.5550129315,69211,15.2529130006,29437,17.9994898285,62724,-7849,-39774
2809,TREEHOUSE FOODS INC,72.1893631826,1766299,84.660077762,1701345,81.6901061743,893719,67.7293700496,806873,-64954,-807626
2810,TREVENA INC,5.8734939759,53120,3.66251134034,59522,2.28746736995,37159,2.54568597145,43996,6402,-22363
2811,TREX CO INC,64.402708395,114902,69.379687052,66273,67.6605948099,51714,90.0661645184,87358,-48629,-14559
2812,TRI POINTE GROUP INC,11.4804122072,1107016,12.5403613459,1508250,13.1897567673,2201102,13.8091761838,982173,401234,692852
2813,TRIBUNE MEDIA CO,34.97978131,207234,37.2716746719,227143,40.7701770466,1326656,40.8601338222,2620941,19909,1099513
2814,TRICO BANCSHARES,34.1795338072,756125,35.5306054848,745667,35.1503716028,780134,40.750768122,843616,-10458,34467
2815,TRILOGY METALS INC NEW,0.504874994263,152513,0.550805224781,152504,0.631612190115,75996,0.95050463155,57864,-9,-76508
2816,TRIMAS CORP,23.4998745751,2312140,20.749962818,2306221,20.8499683485,2224224,27.0001935919,2210836,-5919,-81997
2817,TRIMBLE INC,30.1497661845,1287340,32.0102995667,1273840,35.6702443877,1149894,39.2501966537,1167026,-13500,-123946
2818,TRINET GROUP INC,25.626092021,66963,28.9015840042,115530,32.7412394195,233803,33.617856066,268637,48567,118273
2819,TRINITY INDS INC,27.7601540942,3768603,26.5500006542,3898079,28.0298378983,3366591,31.9000687311,3330369,129476,-531488
2820,TRINSEO S A,59.299416284,802959,67.0993812639,698844,68.6991954739,670954,67.0991182721,988627,-104115,-27890
2821,TRIPADVISOR INC,46.3710487941,820857,43.1597126906,1737639,38.2002083837,2012633,40.5297099296,1399936,916782,274994
2822,TRIPLE-S MGMT CORP,20.702413602,138921,17.5701958119,105918,16.9097040802,126318,23.6761520651,187446,-33003,20400
2823,TRISTATE CAP HLDGS INC,22.1115091805,35728,23.3347589009,37412,25.1825423166,24104,22.8839261097,14508,1684,-13308
2824,TRITON INTL LTD,15.7972615301,47983,25.800315073,67286,33.438257908,38758,33.2796418139,109887,19303,-28528
2825,TRIUMPH BANCORP INC,26.1516797425,9942,25.8068452199,16391,24.5733086572,9726,32.2328162801,14054,6449,-6665
2826,TRIUMPH GROUP INC NEW,26.498167452,210090,25.7495877243,517251,31.5998669965,1040574,29.7489146948,895831,307161,523323
2827,TRONC INC,13.865877712,50700,13.9238986916,24993,12.8916819412,114570,14.5276120839,72758,-25707,89577
2828,TRONOX LTD,10.3133374077,170168,18.4497973907,2526044,15.1198906148,3172642,21.0999143793,3728072,2355876,646598
2829,TROVAGENE INC,2.10220623293,46142,1.14479542082,23585,1.26174573846,278186,0.738155952221,14902,-22557,254601
2830,TRUEBLUE INC,24.6527268729,218272,27.3531159702,195188,26.497380767,190132,22.4471711591,221186,-23084,-5056
2831,TRUECAR INC,12.5114581156,62183,15.4701544674,1067798,19.9297599794,738895,15.7902303784,932032,1005615,-328903
2832,TRUETT-HURST INC,1.75459118026,17098,2.29621125144,15678,2.09863588667,15248,2.25611406913,11081,-1420,-430
2833,TRUSTCO BK CORP N Y,8.75129241761,323038,7.85209778513,158429,7.74508701171,186699,8.89914152887,651973,-164609,28270
2834,TRUSTMARK CORP,35.6499612643,607967,31.7901759485,517424,32.1606773183,452136,33.1199455997,479409,-90543,-65288
2835,TTM TECHNOLOGIES  INC,13.6305549841,802095,16.1305988603,1122215,17.3601550814,1075048,15.369506307,985653,320120,-47167
2836,TUCOWS INC,35.25,12000,51.0277938622,13816,53.4897025172,6992,58.59375,8192,1816,-6824
2837,TUESDAY MORNING CORP,5.39819087657,185062,3.74876575235,179259,1.90099751022,438191,3.19726245204,57862,-5803,258932
2838,TUNIU CORP,8.75052046882,451516,8.76004453805,447258,8.02939575395,448228,7.82056957356,359181,-4258,970
2839,TUPPERWARE BRANDS CORP,52.6193619181,426497,62.7224320139,441708,70.2307992218,520669,61.8209586258,678346,15211,78961
2840,TURQUOISE HILL RES LTD,3.23006417061,789458,3.06989773403,260595,2.65096499434,649952,3.09987122936,682609,-528863,389357
2841,TURTLE BEACH CORP,1.28099551652,10929,0.917599559552,10898,0.697019544428,71734,0.819183795055,13428,-31,60836
2842,TUTOR PERINI CORP,27.9957551563,138521,31.8008832751,134273,28.7503677861,71373,28.4068069141,44778,-4248,-62900
2843,TWENTY FIRST CENTY FOX INC,27.7339007877,15219316,32.1590924498,16079154,28.1369904209,13819886,26.1073759737,13133683,859838,-2259268
2844,TWILIO INC,28.847472011,153185,28.872028872,333333,29.1122789668,228529,29.8484771702,315728,180148,-104804
2845,TWITTER INC,16.2998016102,2412422,14.9498774435,5322853,17.8698940313,4767068,16.8698626814,3875076,2910431,-555785
2846,TWO HBRS INVT CORP,8.72005790627,15622488,9.58997713564,14418074,9.91007617572,9249273,10.0800062761,4869243,-1204414,-5168801
2847,TYLER TECHNOLOGIES INC,142.769344117,532061,154.561300801,756703,175.670951854,766672,174.320415934,705689,224642,9969
2848,TYSON FOODS INC,61.7324928467,4223902,61.7523760465,4651319,62.6807146709,3792235,70.4505690551,2558276,427417,-859084
2849,U S CONCRETE INC,65.4951443483,75685,64.5569856023,53689,78.5452207134,52874,76.3054956835,87687,-21996,-815
2850,U S G CORP,28.8796788826,766075,31.8001877934,665625,29.0206460213,538651,32.6486734589,331162,-100450,-126974
2851,U S SILICA HLDGS INC,56.6799498757,744549,47.9898303672,1199650,35.4891364638,631010,31.0700154271,1334663,455101,-568640
2852,U.S. AUTO PARTS NETWORK INC,3.52231253015,109871,3.35392210985,96007,3.22764382001,94806,2.87907869482,37512,-13864,-1201
2853,UBIQUITI NETWORKS INC,57.8255380731,32477,50.256371588,26524,51.9723335614,81832,56.017970895,92149,-5953,55308
2854,UBS GROUP AG,15.6700260642,16087210,15.949966528,18527437,16.9800154138,15654815,17.1499743992,13644102,2440227,-2872622
2855,UDR INC,36.4802190822,1294126,36.2602248686,1433637,38.9698983581,1534800,38.0302232733,1988997,139511,101163
2856,UGI CORP NEW,46.0796959722,2048234,49.4003889112,2099194,48.4103032433,2045453,46.8594627355,1483329,50960,-53741
2857,ULTIMATE SOFTWARE GROUP INC,182.347205464,224599,195.210012035,299959,210.059669449,517015,189.601064106,577386,75360,217056
2858,ULTRA CLEAN HLDGS INC,9.70523658503,94279,16.8734392566,100513,18.7504283714,102131,30.6228072586,109167,6234,1618
2859,ULTRAGENYX PHARMACEUTICAL IN,70.3103086207,402857,67.7798006899,417440,62.1089704517,539761,53.2602038425,618811,14583,122321
2860,ULTRAPAR PARTICIPACOES S A,20.7407556604,397189,22.7301010269,530354,23.5309849997,433726,23.8222622702,355130,133165,-96628
2861,UMB FINL CORP,77.1220680021,212611,75.3093939889,269236,74.8582038304,196585,74.4931107875,187467,56625,-72651
2862,UMPQUA HLDGS CORP,18.7805618689,1182233,17.7401497537,1128119,18.3604557042,993276,19.510590408,866350,-54114,-134843
2863,UNDER ARMOUR INC,26.35708077,4203766,19.0124132225,3268128,21.1393048798,3293675,16.0754501729,2738337,-935638,25547
2864,UNIFI INC,32.6159307744,31549,28.3747233833,20335,30.8221985409,12199,35.620597658,89583,-11214,-8136
2865,UNIFIRST CORP MASS,143.638923571,37643,141.461732935,26106,140.706695902,23716,151.487164417,47641,-11537,-2390
2866,UNILEVER N V,41.0600806552,842351,49.6795761994,882113,55.2696105351,1456768,59.0394392887,945656,39762,574655
2867,UNILEVER PLC,40.7001799883,867834,49.3403083488,1244824,54.1203095668,1837277,57.9597072614,1311204,376990,592453
2868,UNION BANKSHARES CORP NEW,35.7797213676,28927,35.1862803075,50730,33.8823699579,55309,35.3040157913,61806,21803,4579
2869,UNION PAC CORP,103.680039069,5348503,105.919844393,6595072,108.909915841,5390859,115.969946713,5594596,1246569,-1204213
2870,UNISYS CORP,14.9482350689,73119,13.9538991433,67938,12.8061668532,64344,8.48570921356,28165,-5181,-3594
2871,UNIT CORP,26.8702687461,230515,24.1581669865,178242,18.7284496384,205623,20.5811801507,237207,-52273,27381
2872,UNITED BANKSHARES INC WEST V,46.2505303352,377120,42.2509127467,188990,39.1998480608,437017,37.1500756095,650712,-188130,248027
2873,UNITED CMNTY BKS BLAIRSVLE G,29.6198940544,499124,27.6896121966,523951,27.8019331227,479535,28.5411637604,473912,24827,-44416
2874,UNITED CMNTY FINL CORP OHIO,8.93818824853,62205,8.34236051449,80313,8.31549295775,44375,9.59944035651,77192,18108,-35938
2875,UNITED CONTL HLDGS INC,72.8796931961,3123298,70.6402128407,4081174,75.2501287481,3413642,60.8802167505,3190396,957876,-667532
2876,UNITED FINL BANCORP INC NEW,18.1618709334,92061,17.0104691168,67723,16.6815166815,40404,18.2856953048,60211,-24338,-27319
2877,UNITED FIRE GROUP INC,49.1646181409,72003,42.7762756045,51407,44.0598404763,52406,45.8226080432,95957,-20596,999
2878,UNITED INS HLDGS CORP,15.1346157146,58277,15.9563633072,44183,15.7246507785,77458,16.3056919761,56606,-14094,33275
2879,UNITED MICROELECTRONICS CORP,1.75291292884,67887,1.9327695199,93648,2.44041443206,479017,2.49814988116,510778,25761,385369
2880,UNITED NAT FOODS INC,47.7237242173,194704,43.2302023095,219268,36.7011525137,420559,41.5907077353,685129,24564,201291
2881,UNITED PARCEL SERVICE INC,114.639991683,4405426,107.30021857,3572304,110.589735136,3915707,120.089863774,4124020,-833122,343403
2882,UNITED RENTALS INC,105.579433688,720557,125.049885199,771772,112.709679366,894759,138.740793018,950773,51215,122987
2883,UNITED STATES ANTIMONY CORP,0.249180759484,212697,0.49526744442,127204,0.392882711415,114538,0.287306786186,87015,-85493,-12666
2884,UNITED STATES CELLULAR CORP,43.7442817932,17488,37.3352577006,26329,38.3012113187,20391,35.380166695,5879,8841,-5938
2885,UNITED STATES NATL GAS FUND,9.33807189674,249302,7.56996578325,8311134,6.77996257508,10667758,6.57001831473,7215505,8061832,2356624
2886,UNITED STATES OIL FUND LP,11.7201619893,2664127,10.6399587677,6719011,9.50003379486,4349774,10.4299657695,5428781,4054884,-2369237
2887,UNITED STATES STL CORP NEW,33.0105350028,853061,33.8099493595,1033956,22.1401488158,2897677,25.6599222833,2059788,180895,1863721
2888,UNITED TECHNOLOGIES CORP,109.620018427,2725369,112.20985453,2745864,122.10994603,3859530,116.080081392,3769415,20495,1113666
2889,UNITED THERAPEUTICS CORP DEL,143.430297775,871866,135.379422439,1154821,129.729626797,1575415,117.189971789,1134679,282955,420594
2890,UNITEDHEALTH GROUP INC,160.039829871,4647768,164.009841499,4690749,185.419904794,5215206,195.850341528,4984362,42981,524457
2891,UNITIL CORP,45.3801169591,8550,45.045045045,9324,48.3196789834,29905,49.4592722817,93855,774,20581
2892,UNIVAR INC,28.370367296,2313012,30.6599408907,2350559,29.199993075,2310480,28.929918493,2396481,37547,-40079
2893,UNIVERSAL CORP VA,63.7549385723,92385,70.7447363677,105393,64.6928568702,52386,57.2928030869,87079,13008,-53007
2894,UNIVERSAL DISPLAY CORP,56.3110209169,62581,86.102652755,113957,109.250372692,183798,128.851363093,489145,51376,69841
2895,UNIVERSAL ELECTRS INC,64.5599830821,33101,68.5063889187,9313,66.8160404458,17406,63.3994061064,39401,-23788,8093
2896,UNIVERSAL FST PRODS INC,102.188142884,106940,98.5483376124,61929,87.3001471804,49599,98.1699649216,60436,-45011,-12330
2897,UNIVERSAL HEALTH RLTY INCM T,65.5834035921,39141,64.4861150873,27944,79.5880149813,14952,75.5086345522,28606,-11197,-12992
2898,UNIVERSAL HLTH SVCS INC,106.380416799,672699,124.450504964,586675,122.080612964,607148,110.940285205,852720,-86024,20473
2899,UNIVERSAL INS HLDGS INC,28.4016738444,81967,24.5029980318,65543,25.1996418325,54723,22.9968712878,119538,-16424,-10820
2900,UNIVERSAL TECHNICAL INST INC,2.90520105481,67121,3.45527980762,42833,3.56196709633,44919,3.44403444034,16260,-24288,2086
2901,UNUM GROUP,43.9298740667,2214188,46.8900030947,2517189,46.6300216082,3516254,51.1299101109,3113168,303001,999065
2902,UQM TECHNOLOGIES INC,0.442924284554,40639,0.473548910838,29564,0.854876213924,29244,1.16402478688,29209,-11075,-320
2903,URBAN EDGE PPTYS,27.5108378142,429976,26.2976606229,209030,23.7297603344,658793,24.1200077763,663557,-220946,449763
2904,URBAN OUTFITTERS INC,28.4794572094,1700840,23.7600094773,1705134,18.5407576106,1254048,23.8996563135,877544,4294,-451086
2905,URSTADT BIDDLE PPTYS INC,24.1078978522,118260,20.5655821193,87379,19.7998041997,150153,21.6969516957,208739,-30881,62774
2906,US BANCORP DEL,51.3698772434,6257422,51.5000135809,6185144,51.9199366653,7303418,53.5900195156,7938773,-72278,1118274
2907,US ECOLOGY INC,49.1626363963,25019,46.8229898661,13519,50.5045864535,130602,53.8010509228,561792,-11500,117083
2908,US FOODS HLDG CORP,27.4789210436,475237,27.9802899399,1680969,27.2200935958,4043557,26.6999872251,7311202,1205732,2362588
2909,USA COMPRESSION PARTNERS LP,17.2993001958,569445,16.8895517477,923944,16.3594208215,1003214,16.7193394791,1051776,354499,79270
2910,USA TRUCK INC,8.71346626605,36610,7.35483870968,31000,8.66801502456,51915,14.0932458784,11282,-5610,20915
2911,USANA HEALTH SCIENCES INC,61.1884899489,27211,57.5984957338,56373,64.0886100263,62476,57.6954134367,49536,29162,6103
2912,V F CORP,53.3499459838,2390949,54.9700299472,2192522,57.5994468591,1426038,63.5704479214,1315454,-198427,-766484
2913,VAALCO ENERGY INC,1.04110976674,35539,0.913516705101,89763,0.930196997885,78478,0.842412669887,17806,54224,-11285
2914,VAIL RESORTS INC,161.308971998,885611,191.899612876,739298,202.830181563,662855,228.119733339,628363,-146313,-76443
2915,VALE S A,7.3159303368,8201691,9.27344444813,8766969,8.4957581799,7592024,10.0341753367,15217992,565278,-1174945
2916,VALEANT PHARMACEUTICALS INTL,14.5201071368,4424623,11.0299839108,4973534,17.2998512563,4597843,14.3299509314,3988290,548911,-375691
2917,VALERO ENERGY CORP NEW,68.3198797216,3898953,66.2899272192,4970544,67.4600474836,5703020,76.9299367446,6414161,1071591,732476
2918,VALERO ENERGY PARTNERS LP,44.2701170366,4926235,47.9097944716,4898059,45.6400370845,4737288,43.7200581102,4541714,-28176,-160771
2919,VALIDUS HOLDINGS LTD,55.0103559917,833334,56.3897186196,827243,51.9706264364,878477,49.2101276249,815828,-6091,51234
2920,VALLEY NATL BANCORP,11.6399486211,2949068,11.7999651187,2614584,11.8097666158,2515037,12.0501365224,2051678,-334484,-99547
2921,VALMONT INDS INC,140.898610739,153103,155.497326366,131282,149.603379337,124048,158.099974063,111809,-21821,-7234
2922,VALVOLINE INC,21.5002023299,2404489,24.5499491655,2798295,23.7202182932,5135661,23.4498818592,4689320,393806,2337366
2923,VANDA PHARMACEUTICALS INC,15.9480999516,472909,13.9995378085,328868,16.2976112616,321090,17.9015648615,426108,-144041,-7778
2924,VANECK VECTORS ETF TR,48.7204174531,6586992,42.212045772,11785380,46.8566619906,6859046,49.3197579488,6619923,5198388,-4926334
2925,VANGUARD ADMIRAL FDS INC,111.106684726,50204,100.28,25000,104.917840146,51059,110.767554751,62419,-25204,26059
2926,VANGUARD BD INDEX FD INC,81.2924467969,4931762,82.3572239593,5378581,81.562043213,2831599,81.7685538068,3119023,446819,-2546982
2927,VANGUARD INDEX FDS,129.44520569,11568756,134.172101144,10894791,131.59412073,10808416,137.775350784,10544368,-673965,-86375
2928,VANGUARD INTL EQUITY INDEX F,39.351137013,26909718,43.183534393,27334261,45.7918662052,27820028,48.4893359433,28405091,424543,485767
2929,VANGUARD MALVERN FDS,49.1599476582,5294432,49.4700824779,3599145,49.2302652812,4139608,49.4498404613,4270125,-1695287,540463
2930,VANGUARD SCOTTSDALE FDS,87.2043453896,1375803,83.109825886,2546895,81.7724343625,1969111,81.7435376227,1774966,1171092,-577784
2931,VANGUARD SPECIALIZED PORTFOL,85.1800793189,694916,89.9406078857,466897,92.6709883597,494405,94.7906238408,501442,-228019,27508
2932,VANGUARD STAR FD,45.881884313,258577,49.6846383406,156487,51.9711437723,167035,54.7267406673,160269,-102090,10548
2933,VANGUARD TAX MANAGED INTL FD,36.5400429689,12210221,39.3000273754,12814444,41.3198901741,12673509,43.4099825632,12846400,604223,-140935
2934,VANGUARD WHITEHALL FDS INC,75.9323040163,821969,77.6497125245,670318,78.1605798975,541475,81.0842594226,680280,-151651,-128843
2935,VANGUARD WORLD FD,99.824381745,215809,99.5733738531,171110,108.118889323,255700,105.633333016,104929,-44699,84590
2936,VANGUARD WORLD FDS,110.417480928,276324,119.487335094,290014,125.591022283,463815,126.179696356,431361,13690,173801
2937,VANTIV INC,59.6201064611,1178646,64.1199630534,968965,63.3401960645,912659,70.4701812686,1990913,-209681,-56306
2938,VARIAN MED SYS INC,89.7786408429,469644,91.1322636288,445232,103.190536376,532481,100.059629882,581923,-24412,87249
2939,VASCO DATA SEC INTL INC,13.6457001681,69619,13.505488984,65677,14.3580495249,57668,12.0497653529,337102,-3942,-8009
2940,VECTOR GROUP LTD,22.7395215787,96484,20.8006984926,116823,21.3169729898,153868,20.4710931293,244198,20339,37045
2941,VECTREN CORP,52.1509743998,542847,58.6096682636,1190162,58.4415709792,517919,65.7689941,414405,647315,-672243
2942,VECTRUS INC,23.8490434175,80129,22.3384932361,73774,32.3271980694,55526,30.8806709874,10492,-6355,-18248
2943,VEDANTA LTD,12.4210288369,256581,17.172207393,247260,15.5192609283,256971,19.3622257811,262883,-9321,9711
2944,VEECO INSTRS INC DEL,29.1466669859,83543,29.8487254287,81243,27.8506038595,116335,21.399148048,199307,-2300,35092
2945,VEEVA SYS INC,40.6995924762,1667142,51.2799642115,1560278,61.3098849042,1448967,56.4095155874,872211,-106864,-111311
2946,VENTAS INC,62.5200594575,4293486,65.039856713,4076854,69.4799533646,4624816,65.1299082501,4815591,-216632,547962
2947,VERA BRADLEY INC,11.721377832,263109,9.31188935747,76354,9.76722025592,58768,8.80976243295,266409,-186755,-17586
2948,VERACYTE INC,7.73928290707,16539,9.21149594694,13570,8.33199439943,43567,8.76770733049,29084,-2969,29997
2949,VERASTEM INC,1.12156121321,62413,2.05823293173,19920,2.19876868953,18192,4.67758102239,14965,-42493,-1728
2950,VEREIT INC,8.46001925787,3436517,8.49002634077,4453932,8.13999306937,4293984,8.28987998458,6771630,1017415,-159948
2951,VERIFONE SYS INC,17.7298784861,3087218,18.7300980504,4609159,18.0998320244,4516727,20.2798926237,3388085,1521941,-92432
2952,VERINT SYS INC,35.249941074,3321963,43.3751155496,3145836,40.7001531954,2340802,41.8496820671,2422838,-176127,-805034
2953,VERISIGN INC,76.0697458406,623349,87.1100261697,1541097,92.9600984819,1517436,106.39034217,1774146,917748,-23661
2954,VERISK ANALYTICS INC,81.1710364537,752325,81.1393812526,689813,84.3703050951,534489,83.1920715373,591691,-62512,-155324
2955,VERITIV CORP,53.7584719655,25968,51.7883067177,37885,44.9885128416,29163,32.4918186068,34224,11917,-8722
2956,VERIZON COMMUNICATIONS INC,53.3800183857,21267621,48.7499773821,14479658,44.6599731621,16692800,49.490065731,20893183,-6787963,2213142
2957,VERMILION ENERGY INC,42.1830964575,65998,37.5062662352,65829,31.7351810431,182857,35.5817400145,81643,-169,117028
2958,VERSARTIS INC,14.9036754261,90112,21.3525956501,100784,17.448856799,103044,2.4515161925,64042,10672,2260
2959,VERSO CORP,7.0999863913,213099,5.9993417934,331203,4.68932390549,149062,5.09126727614,162435,118104,-182141
2960,VERSUM MATLS INC,28.0689913922,927536,30.5994596641,919428,32.4998711141,678895,38.8200490291,627382,-8108,-240533
2961,VERTEX PHARMACEUTICALS INC,73.6700217709,3882244,109.3501857,3655906,128.870419033,2779544,152.0396751,2696704,-226338,-876362
2962,VIACOM INC NEW,35.1074103703,6913811,46.6235693982,8102447,33.5793328926,6996625,27.8576212849,7782933,1188636,-1105822
2963,VIAD CORP,44.109702627,79597,45.1934252034,60230,47.2519365548,54220,60.8977035491,95800,-19367,-6010
2964,VIASAT INC,66.218221706,309960,63.8215057611,413638,66.1997097363,531241,64.3205375067,488180,103678,117603
2965,VIAVI SOLUTIONS INC,8.18001234117,15171982,10.7200146651,13321437,10.5299614189,8962426,9.46007977888,9973066,-1850545,-4359011
2966,VICON INDS INC,0.588532032958,47576,0.360406198987,47169,0.57929969104,46608,0.384749912557,28590,-407,-561
2967,VICOR CORP,15.0935570099,43396,16.1147835623,32827,17.8933153275,32582,23.6058785595,58926,-10569,-245
2968,VIDEOCON D2H LTD,8.21047370864,28013,11.48476721,29082,9.74005479175,475254,8.89865421587,72820,1069,446172
2969,VILLAGE SUPER MKT INC,30.9617918314,7590,26.5112440685,9694,25.8916502028,9617,24.7420629281,70366,2104,-77
2970,VIPER ENERGY PARTNERS LP,16.0005320411,661603,17.9796692733,1596303,15.7006488206,1136832,18.6398555164,3878088,934700,-459471
2971,VIPSHOP HLDGS LTD,11.0099735496,21851097,13.3399908077,20658485,10.5499731283,20877020,8.79004385728,18938017,-1192612,218535
2972,VIRNETX HLDG CORP,2.17978899643,11469,2.32203758798,13781,4.52348494237,16138,3.87250521299,13428,2312,2357
2973,VIRTU FINL INC,15.9503388648,1126998,16.9996711458,1052138,17.6498415157,1001992,16.2000436385,1003701,-74860,-50146
2974,VIRTUS INVT PARTNERS INC,118.052301059,21338,105.923981281,17522,110.949471438,20622,116.054794521,27375,-3816,3100
2975,VIRTUSA CORP,25.1168152663,81539,30.217266661,81973,29.3983706927,19763,37.7742048752,54111,434,-62210
2976,VISA INC,78.0200308444,16951557,88.8699865185,17110141,93.7800334711,17314016,105.239972186,17699197,158584,203875
2977,VISHAY INTERTECHNOLOGY INC,16.1996675411,1623058,16.4501490743,1683389,16.6002312298,2491893,18.8000898809,2496637,60331,808504
2978,VISTA GOLD CORP,0.959410215194,118823,1.01952388235,19617,0.862790874718,39407,0.765853160421,58758,-99206,19790
2979,VISTA OUTDOOR INC,36.9000277087,5189698,20.5899153801,2104234,22.5106274163,394969,22.9399988244,578422,-3085464,-1709265
2980,VISTEON CORP,80.3415855229,620401,97.947172984,228368,102.057676519,194880,123.772898895,143020,-392033,-33488
2981,VITAL THERAPIES INC,4.35413642961,63388,3.99721124797,64545,2.89817792069,233250,5.03263348274,12717,1157,168705
2982,VITAMIN SHOPPE INC,23.747095299,80473,20.1567579062,65834,11.6459940198,124077,5.35302751562,150569,-14639,58243
2983,VIVUS INC,1.15004692106,467807,1.12037768094,492691,1.22086428219,312074,0.993449693484,123811,24884,-180617
2984,VMWARE INC,78.7298985666,1222674,92.1407183717,1174573,87.4291414464,1374393,109.18944159,1374904,-48101,199820
2985,VOCERA COMMUNICATIONS INC,18.4898385563,960149,24.8223319065,48827,26.4113298881,61148,31.3782602939,60424,-911322,12321
2986,VODAFONE GROUP PLC NEW,24.4301052507,4005959,26.4299177601,5451852,28.7299175026,6985436,28.460067221,8602369,1445893,1533584
2987,VONAGE HLDGS CORP,6.8466590222,239825,6.31994332407,623898,6.54076973365,1190074,8.1404443395,1626324,384073,566176
2988,VORNADO RLTY TR,104.370023832,4159451,100.310282272,3724673,93.899922666,3974966,76.8798460386,3777570,-434778,250293
2989,VOXX INTL CORP,4.70620487983,65658,5.18975765889,43740,8.18944925954,14653,8.52676456656,12666,-21918,-29087
2990,VOYA FINL INC,39.2199780148,2261526,37.9593495377,1166432,36.8897877455,896942,39.8899366605,810079,-1095094,-269490
2991,VOYA GLBL EQTY DIV & PREM OP,6.76447333743,11383,7.33604383949,22628,7.54079178314,15383,8.10968494749,17140,11245,-7245
2992,VOYAGER THERAPEUTICS INC,12.7387290578,307095,13.22768228,15649,8.97465978414,17048,20.5878176913,28172,-291446,1399
2993,VULCAN MATLS CO,125.150190021,530994,120.480086269,471082,126.680346028,464934,119.600010072,675117,-59912,-6148
2994,VWR CORP,25.0300619517,4158080,28.2000442289,3974781,33.0098874362,3303283,33.1097930989,3594133,-183299,-671498
2995,W & T OFFSHORE INC,2.76354812618,59344,2.77007519183,350171,1.95788918255,216049,3.04744547144,168994,290827,-134122
2996,W P CAREY INC,59.089632019,281183,62.2212265016,343693,66.0082617514,268224,67.3913178045,323098,62510,-75469
2997,WABASH NATL CORP,15.8197486749,703551,20.6917842235,372515,21.9800019562,582757,22.8199135079,1062756,-331036,210242
2998,WABCO HLDGS INC,106.148803109,221783,117.419866603,895070,127.509840288,1301029,148.000245638,1139890,673287,405959
2999,WABTEC CORP,83.0201311883,1920751,77.9997405554,1719057,91.5006119849,1437127,75.7500771512,1578071,-201694,-281930
3000,WADDELL & REED FINL INC,19.5098485184,496826,16.9991263832,274720,18.8795704478,565426,20.0706032298,773619,-222106,290706
3001,WAGEWORKS INC,72.5024045498,191304,72.3001007716,211369,67.201122943,239371,60.7046250353,241036,20065,28002
3002,WAL-MART STORES INC,69.1199846905,9259623,72.0801092417,9786736,75.6800074531,9166701,78.1400141375,9526438,527113,-620035
3003,WALGREENS BOOTS ALLIANCE INC,82.7600236721,6326424,83.0499496061,5989817,78.310115331,7120983,77.220167727,5503109,-336607,1131166
3004,WALKER & DUNLOP INC,31.1961050656,65521,41.6855429263,147893,48.8278421676,186451,52.3313080877,410156,82372,38558
3005,WASHINGTON FED INC,34.3500666105,1440463,33.099777047,1754181,33.200139805,1971317,33.649924124,2060599,313718,217136
3006,WASHINGTON PRIME GROUP NEW,10.4098314341,2424631,8.6900369905,2251659,8.37034700495,703794,8.33019655336,733236,-172972,-1547865
3007,WASHINGTON REAL ESTATE INVT,32.6918646246,164934,31.2807574774,232667,31.9000649303,451253,32.7621551414,319515,67733,218586
3008,WASHINGTON TR BANCORP,56.0669456067,14340,49.2996853212,16207,51.6039051604,6453,57.1703098727,4163,1867,-9754
3009,WASTE CONNECTIONS INC,78.5897106422,1151792,88.2163162107,361101,64.4213550939,386999,69.9602155926,586662,-790691,25898
3010,WASTE MGMT INC DEL,70.9096323748,2266575,72.9199566023,2124535,73.3498333037,2603237,78.2698918159,4726479,-142040,478702
3011,WATERS CORP,134.389339768,628279,156.310462505,617118,183.839814009,726056,179.518788524,799025,-11161,108938
3012,WATSCO INC,148.120430108,465000,143.181322278,252065,154.203694776,219878,161.070173116,203967,-212935,-32187
3013,WATTS WATER TECHNOLOGIES INC,65.199742945,732917,62.3504326736,682385,63.200520645,719108,69.2004635618,742943,-50532,36723
3014,WAYFAIR INC,35.0506286859,44935,40.4918495904,201769,76.8798049878,309314,67.3996025111,380388,156834,107545
3015,WD-40 CO,116.902819522,34935,108.950605493,26177,110.343211901,17074,111.890124264,38225,-8758,-9103
3016,WEATHERFORD INTL PLC,4.98996552197,15692894,6.64999909094,18260604,3.87004125436,9303260,4.58004465748,8197955,2567710,-8957344
3017,WEB COM GROUP INC,21.1257128688,20165,19.2987664984,74098,25.2984806046,255628,25.0009949745,276389,53933,181530
3018,WEBSTER FINL CORP CONN,54.2799502154,3348824,50.0398598036,3558723,52.2201271505,3236166,52.5501776364,2794472,209899,-322557
3019,WEC ENERGY GROUP INC,58.6494459443,1167121,60.6307549743,1225896,61.380509231,1217797,62.7801886701,1450362,58775,-8099
3020,WEIBO CORP,40.5986893949,192888,52.1835626573,218977,66.4699307299,258553,98.9405767971,180098,26089,39576
3021,WEIGHT WATCHERS INTL INC NEW,11.4507893781,140427,15.5693320814,155498,33.4190796561,136449,43.5522136657,363334,15071,-19049
3022,WEINGARTEN RLTY INVS,35.7904273606,1075064,33.3903964951,1065486,30.1001974312,1147235,31.740017263,778544,-9578,81749
3023,WEIS MKTS INC,66.7992047714,10060,59.6343873518,20240,48.7344654825,15369,43.5052827843,27353,10180,-4871
3024,WELLCARE HEALTH PLANS INC,137.079841935,1680320,140.210219787,1486254,179.559596272,1800121,171.739587906,1820023,-194066,313867
3025,WELLTOWER INC,66.9300395269,4760045,70.8201519519,4805073,74.8501882699,5091891,70.2802592398,4567200,45028,286818
3026,WENDYS CO,13.5200790633,1265821,13.6102635817,1887840,15.5101429176,2095403,15.5301273281,2395151,622019,207563
3027,WERNER ENTERPRISES INC,26.9494483931,438265,26.1996807444,424738,29.3478121432,311812,36.549984438,918906,-13527,-112926
3028,WESBANCO INC,43.0517522271,28849,38.1116230244,34294,39.5760887564,18117,41.0557184751,16027,5445,-16177
3029,WESCO AIRCRAFT HLDGS INC,14.9500014164,141204,11.3999275672,121492,10.8515847284,45339,9.39491092082,49282,-19712,-76153
3030,WESCO INTL INC,66.5500063538,857761,69.5497727715,997674,57.3000417963,485689,58.2496689118,686373,139913,-511985
3031,WEST BANCORPORATION INC,24.7009880395,23076,22.9675061986,22989,23.644307376,23346,24.4070720138,23190,-87,357
3032,WEST CORP,24.7470047691,34388,24.4168158174,167057,23.3198008959,919519,23.4702260397,983544,132669,752462
3033,WEST PHARMACEUTICAL SVSC INC,84.8296839085,925808,81.6100030247,849663,94.520057498,935685,96.2589507377,981623,-76145,86022
3034,WESTAMERICA BANCORPORATION,62.930186824,97632,55.8238636364,77440,56.0454748973,51369,59.5389555313,66024,-20192,-26071
3035,WESTAR ENERGY INC,56.3496837362,2911019,54.2700575388,1693291,53.0200634906,1831137,49.6001678682,1353443,-1217728,137846
3036,WESTERN ALLIANCE BANCORP,48.7127087868,375323,49.0922677603,277009,49.198246001,308324,53.0814992319,526643,-98314,31315
3037,WESTERN ASSET MTG CAP CORP,10.0656760911,214690,9.77155754303,189632,10.2976464178,258797,10.4715282119,161581,-25058,69165
3038,WESTERN DIGITAL CORP,67.9498999577,2358002,82.5294754716,1626013,88.5998014088,2139068,86.400129456,4078605,-731989,513055
3039,WESTERN GAS EQUITY PARTNERS,42.3503914199,1292857,46.1003504387,1546062,43.0198414392,1452818,41.1801989209,1230640,253205,-93244
3040,WESTERN GAS PARTNERS LP,58.7600661292,4267405,60.4497473626,4186039,55.9400366612,4412296,51.2800264466,4419479,-81366,226257
3041,WESTERN REFNG LOGISTICS LP,21.3499616235,3250685,25.4498759227,2941311,25.6498525299,2855494,25.7997733214,2188120,-309374,-85817
3042,WESTERN UN CO,21.7202176024,4197748,20.3500234011,6803088,19.0499951567,5595382,19.2000424644,2976608,2605340,-1207706
3043,WESTLAKE CHEM CORP,55.990508003,1368732,66.0502503779,961147,66.2100371885,1077752,83.0902865838,1419480,-407585,116605
3044,WESTLAKE CHEM PARTNERS LP,21.6475277986,241829,25.1491936836,238616,24.7532358816,188743,22.7003805385,242551,-3213,-49873
3045,WESTMORELAND COAL CO,17.6604134305,41845,14.5100972326,46795,4.87042489005,82539,2.51848241124,12309,4950,35744
3046,WESTPAC BKG CORP,23.4797317278,760869,26.720101393,852130,23.4000850994,883672,25.2198931038,1021178,91261,31542
3047,WESTPORT INNOVATIONS INC,1.13278625904,75919,0.965786995678,41417,2.35366510268,65005,3.27258080757,39724,-34502,23588
3048,WESTROCK CO,50.769835878,1398350,52.0301014414,2474433,56.6600740299,2349591,56.7297832523,2368791,1076083,-124842
3049,WEX INC,111.601829956,258804,103.501417365,266692,104.267912183,158649,112.218097516,204459,7888,-108043
3050,WEYERHAEUSER CO,30.0899699735,8221743,33.9799273675,12625748,33.5000024042,14557790,34.0299737856,9127042,4404005,1932042
3051,WGL HLDGS INC,76.2798428913,1334363,82.5319988661,183444,83.4246566353,152389,84.2000539804,637268,-1150919,-31055
3052,WHIRLPOOL CORP,181.769354715,495254,171.33064149,406413,191.619856333,441854,184.440905945,297678,-88841,35441
3053,WHITE MTNS INS GROUP LTD,836.077660359,8138,879.841470005,5551,868.524813052,7355,856.9967457,10755,-2587,1804
3054,WHITESTONE REIT,14.3950375889,29663,13.834447775,34696,12.2569502479,53847,13.0473177265,170993,5033,19151
3055,WHITING PETE CORP NEW,12.0199698182,12584391,9.45996240177,12614955,5.50997136515,9364114,5.45997696595,13643281,30564,-3250841
3056,WILDHORSE RESOURCE DEV CORP,14.5976371621,145503,12.4406367444,199829,12.3806154935,11308,13.3194626953,273960,54326,-188521
3057,WILEY JOHN & SONS INC,54.5027409935,804088,53.7999773474,697491,52.7509301332,825957,53.5004668814,699321,-106597,128466
3058,WILLBROS GROUP INC DEL,3.23082445854,16714,2.75491700377,28676,2.482283701,24977,3.23682151241,28114,11962,-3699
3059,WILLDAN GROUP INC,22.6116449972,19459,32.2490900239,43133,30.549898167,65794,32.4566804468,56845,23674,22661
3060,WILLIAMS COS INC DEL,31.1400157919,21718743,29.589952795,27662937,30.2800496715,23885727,30.0099779374,22779257,5944194,-3777210
3061,WILLIAMS PARTNERS L P NEW,38.0300215416,15036936,40.8299722268,12748282,40.1099926539,12591750,38.8999919333,11256172,-2288654,-156532
3062,WILLIAMS SONOMA INC,48.3898630709,752141,53.6205354531,598185,48.4989844046,464752,49.8602191872,954709,-153956,-133433
3063,WILLIS TOWERS WATSON PUB LTD,122.279212103,464020,130.891994532,487929,145.460046193,677595,154.230081885,921046,23909,189666
3064,WINDSTREAM HLDGS INC,7.33306885522,161324,5.4506930629,247308,3.87686363015,233952,1.77023420795,603310,85984,-13356
3065,WINGSTOP INC,29.5898570318,860261,28.280847092,929958,30.8996821366,1453769,33.2498541382,1506563,69697,523811
3066,WINNEBAGO INDS INC,31.6547954282,60370,29.2508324898,477183,35.0002505387,678538,44.7498042305,629567,416813,201355
3067,WINS FIN HLDGS INC,180.236171535,1609,144.982589427,3159,210.036156459,9127,209.980910826,11001,1550,5968
3068,WINTRUST FINL CORP,72.5706656246,245664,69.1199023164,137587,76.4354197632,210583,78.3112326505,155048,-108077,72996
3069,WIPRO LTD,9.67883965262,395192,10.2321668602,218722,5.2002727033,401902,5.68050033977,491506,-176470,183180
3070,WIRELESS TELECOM GROUP INC,1.92102454642,37480,1.47107805041,36028,1.600160016,39996,1.67292464404,26899,-1452,3968
3071,WISDOMTREE INVTS INC,11.1405631747,364434,9.07955043761,665892,10.1699101057,1012300,10.1798298164,1276151,301458,346408
3072,WISDOMTREE TR,56.4415319111,10865226,62.1986353409,10955996,62.962582254,12004892,65.2922565845,11700147,90770,1048896
3073,WISDOMTREE TRUST,47.501074746,6482927,49.384360227,7170833,48.6990075872,7514917,50.0436041342,6297568,687906,344084
3074,WIX COM LTD,44.557198262,68586,67.9058879543,100816,69.6009297563,267597,71.8518497646,354883,32230,166781
3075,WMIH CORP,1.54887884609,196271,1.44768081533,155421,1.24996044429,252808,0.949905009499,280028,-40850,97387
3076,WOLVERINE WORLD WIDE INC,21.9484036014,240792,24.9697804894,1854762,28.009805997,1384051,28.8498999554,1511825,1613970,-470711
3077,WOODWARD INC,69.0512714814,739885,67.9211372908,556410,67.5798969609,623647,77.6097442458,588573,-183475,67237
3078,WORKDAY INC,66.0897576568,1207585,83.2797897464,1635739,97.0000049581,1613536,105.389950961,1842206,428154,-22203
3079,WORKHORSE GROUP INC,7.0770671801,19217,2.62627634766,44169,3.69127951405,77209,2.76341806227,41977,24952,33040
3080,WORLD ACCEP CORP DEL,64.2700298407,35522,51.8037614617,29882,74.910857481,64223,82.8980279389,58771,-5640,34341
3081,WORLD FUEL SVCS CORP,45.9091502288,927179,36.2500481518,726868,38.4499222273,1235009,33.9103504373,1187602,-200311,508141
3082,WORLD WRESTLING ENTMT INC,18.4063991515,135768,22.2223528824,340153,20.367734669,276123,23.550621962,370521,204385,-64030
3083,WORTHINGTON INDS INC,47.4406244637,769172,45.0896157612,750705,50.2209522829,582705,46.0003049445,518127,-18467,-168000
3084,WPCS INTL INC,1.2602650622,24598,1.38222619725,24598,1.38222619725,24598,1.74188440222,18945,0,0
3085,WPP PLC NEW,110.660098522,76125,109.406712357,67994,105.408186194,84557,92.795687013,54162,-8131,16563
3086,WPX ENERGY INC,14.5700943292,9000079,13.3900269906,12092358,9.65993222234,10648936,11.5142010734,11090218,3092279,-1443422
3087,WRIGHT MED GROUP N V,22.9801325091,1127017,31.119911418,1919125,27.4895772605,2041210,25.8694940086,1285259,792108,122085
3088,WSFS FINL CORP,46.3488518406,875793,45.9499314382,812406,45.3494831657,806448,48.748746507,803754,-63387,-5958
3089,WYNDHAM WORLDWIDE CORP,76.3696166101,642114,84.2897851401,1100857,100.410360253,930402,105.410068779,1046105,458743,-170455
3090,WYNN RESORTS LTD,86.5103580688,654176,114.609702377,954797,134.120878216,728932,148.91989856,1034301,300621,-225865
3091,XBIOTECH INC,10.1257311907,74365,16.4880211338,98799,4.69758516709,80254,4.36209726181,46308,24434,-18545
3092,XCEL ENERGY INC,40.7001304517,2956649,44.4499387076,2798879,45.8796694273,3081561,47.3198507019,2666344,-157770,282682
3093,XCERRA CORP,7.63358778626,25807,8.89509574495,79482,9.77006581759,701940,9.8504126239,947473,53675,622458
3094,XENCOR INC,26.3212079616,174840,23.9179390258,262439,21.1082901446,142977,22.9327142907,56862,87599,-119462
3095,XENIA HOTELS & RESORTS INC,19.419393862,329001,17.0681203236,453477,19.3698532044,754110,21.0496822425,785190,124476,300633
3096,XERIUM TECHNOLOGIES INC,5.61091225694,20674,6.3920795886,20807,7.15793337616,10897,4.78252000272,88238,133,-9910
3097,XEROX CORP,8.72994550485,9811516,7.33998745213,10591435,28.7299299953,4455841,33.2900771565,4967306,779919,-6135594
3098,XILINX INC,60.3699740165,1908134,57.889871718,2432999,64.3197449624,3114207,70.8299790927,2935339,524865,681208
3099,XINYUAN REAL ESTATE CO LTD,4.95696052241,67380,4.40798334762,16334,5.15132002576,12424,5.68828213879,14943,-51046,-3910
3100,XL GROUP LTD,37.2599925822,4591681,39.8599853286,2859986,43.7999406016,2828360,39.4497480744,1317651,-1731695,-31626
3101,XO GROUP INC,19.4441372701,54258,17.2077185017,66075,17.6194421431,54315,19.6728624535,67250,11817,-11760
3102,XPO LOGISTICS INC,43.1601561229,2703512,47.8900413034,2800979,64.6299996814,2196890,67.7799894283,3043981,97467,-604089
3103,XUNLEI LTD,3.85924839378,184751,4.04759714504,184801,3.2375600275,184707,4.25042829571,184452,50,-94
3104,XYLEM INC,49.5200187842,6597029,50.220052971,6065585,55.4299715949,5817268,62.6299280997,4008467,-531444,-248317
3105,YAMANA GOLD INC,2.80990874056,4393737,2.76010312749,3825944,2.43004251885,7612624,2.6500511573,4067846,-567793,3786680
3106,YANDEX N V,20.1301330626,535913,21.9301489156,2217632,26.239584445,2501907,32.9497102775,3091924,1681719,284275
3107,YELP INC,38.1288489078,451102,32.7498703956,1954023,30.0204284435,1300148,43.2999799226,1070855,1502921,-653875
3108,YORK WTR CO,38.2419574082,11035,35.0716681915,9837,34.8208248817,14790,33.9213865676,16155,-1198,4953
3109,YPF SOCIEDAD ANONIMA,16.5000323835,10483737,24.2799779543,8714629,21.8999955565,10037034,22.2800226489,9109506,-1769108,1322405
3110,YRC WORLDWIDE INC,13.2608280862,31446,11.0103963051,115618,11.1151414654,38596,13.7993975201,145731,84172,-77022
3111,YUM BRANDS INC,63.3298184104,3006230,63.8998571789,3570900,73.7599924713,4207918,73.6098051443,3959391,564670,637018
3112,YUM CHINA HLDGS INC,26.1202377024,3160423,27.199747182,3575695,39.4300722847,2055208,39.9701162471,1675827,415272,-1520487
3113,YUME INC,3.57747493086,130539,4.09288699324,116055,4.69493089427,98617,4.62816037237,75624,-14484,-17438
3114,YY INC,39.4206407648,320492,46.1094408934,583091,58.0305776222,816087,86.7808438452,527893,262599,232996
3115,ZAFGEN INC,3.18532818533,31080,4.65710893982,10951,3.50758032714,197287,3.50525788683,11982,-20129,186336
3116,ZAGG INC,7.08830851019,23701,7.19793611654,70159,8.64593021253,87093,15.7512369262,31934,46458,16934
3117,ZAYO GROUP HLDGS INC,32.8600285264,1280218,32.9002841484,2333992,30.8999762878,2926766,34.4202442402,3296345,1053774,592774
3118,ZEBRA TECHNOLOGIES CORP,85.7597342941,543157,91.2511292228,503665,100.519963341,424453,108.580599487,290982,-39492,-79212
3119,ZENDESK INC,21.2026270498,262043,28.0379095779,337329,27.779734456,610445,29.1076301501,358394,75286,273116
3120,ZILLOW GROUP INC,36.4559152492,94772,33.6788563733,4590239,49.0060666422,1596435,40.2085120852,2332143,4495467,-2993804
3121,ZIMMER BIOMET HLDGS INC,103.199668771,1415334,122.110432255,1363569,128.40001568,1250031,117.090158021,1191996,-51765,-113538
3122,ZIONS BANCORPORATION,43.039982518,3715824,42.000116381,3127658,43.9097921514,1867465,47.1804548516,2019120,-588166,-1260193
3123,ZIOPHARM ONCOLOGY INC,5.34706317289,221804,6.33905883832,111373,6.22717662887,26015,6.13780689034,159992,-110431,-85358
3124,ZIX CORP,4.94223018926,316861,4.81279719311,259932,5.68722069031,168272,4.88984271006,257677,-56929,-91660
3125,ZOETIS INC,53.5299792251,4489559,53.3698596701,4949123,62.3798854196,4604978,63.7599713434,4662110,459564,-344145
3126,ZOGENIX INC,12.1499617094,873583,10.8498540383,878998,14.5002708715,867570,35.0495865201,1255079,5415,-11428
3127,ZTO EXPRESS CAYMAN INC,12.0806924057,60427,13.0879889972,90159,13.9628652496,40178,14.0423741218,437248,29732,-49981
3128,ZUMIEZ INC,21.8502192503,173774,18.2984363767,89024,12.3533178407,138991,18.097952404,167367,-84750,49967
3129,ZYNGA INC,2.56985933001,1970925,2.85007352181,2775367,3.63964652729,1721321,3.78015593447,2880569,804442,-1054046
