,Company,0216price,0216amt,0516price,0516amt,0816price,0816amt,1116price,1116amt,0216-0516chng,0516-0816chng
0,1 800 FLOWERS COM,7.30425285002,14649,7.89679703189,29379,9.01724393498,80956,9.17506734264,85013,14730,51577
1,1ST SOURCE CORP,30.8688283182,35991,31.8422633677,18309,32.3845327605,55860,35.7055647503,36857,-17682,37551
2,21VIANET GROUP INC,21.1402683522,218966,19.9788023317,18870,10.2104202478,843550,7.94304057947,48596,-200096,824680
3,2U INC,27.9932449838,34937,22.5949848957,40717,29.3990613032,34729,38.2888333199,37191,5780,-5988
4,3-D SYS CORP DEL,8.68996986799,1790455,15.4694215832,778245,13.6895666283,634790,17.9495061823,484693,-1012210,-143455
5,3M CO,150.640054473,2069277,166.63001345,2078035,175.119614605,2556544,176.230090725,2476484,8758,478509
6,500 COM LTD,20.1328133235,9487,16.7098941282,23519,16.5936355147,13921,17.6347249171,63908,14032,-9598
7,58 COM INC,65.9623400106,183059,55.6500332642,1043162,45.8910524329,1073085,47.660258096,627441,860103,29923
8,8X8 INC NEW,11.4741284977,31985,10.0634205147,76316,14.6054278036,97498,15.4313796672,184559,44331,21182
9,A H BELO CORP,5.006842685,29959,4.79784681996,17091,5.02183406114,13740,7.34689499839,55942,-12868,-3351
10,A10 NETWORKS INC,6.55007314803,30076,5.92094735158,74988,6.46588813768,81350,10.6903488543,509525,44912,6362
11,AAON INC,23.2337434095,28450,27.9548351848,10982,27.5445960126,7624,28.8237085152,9853,-17468,-3358
12,AAR CORP,26.2757143226,38743,23.2859363307,34742,23.3556411816,29586,31.3143669688,95643,-4001,-5156
13,AARONS INC,22.3881943317,332586,25.0995624626,539611,21.8892417191,701943,25.4201546711,893897,207025,162332
14,ABAXIS INC,55.6669572799,22940,45.3382603752,7036,47.278338945,7128,51.5733272748,8803,-15904,92
15,ABB LTD,17.7307341199,865390,19.4205857867,583762,19.8305649855,659840,22.5091868184,674880,-281628,76078
16,ABBOTT LABS,44.9100532873,20757290,41.8300575133,20158973,39.3099867726,22061722,42.2899859762,23323252,-598317,1902749
17,ABBVIE INC,59.2398180688,6963070,57.1197422358,5985006,61.9100336226,6231817,63.0700311478,6826491,-978064,246811
18,ABEONA THERAPEUTICS INC,3.37518563521,22221,2.55585786132,12129,2.33684810487,17545,6.00420732776,68452,-10092,5416
19,ABERCROMBIE & FITCH CO,26.9999588928,1070372,31.5393972833,1362962,17.8097422978,1065765,15.8898850629,1067975,292590,-297197
20,ABIOMED INC,90.2769248553,276826,94.8084430004,513372,109.290967761,550384,128.580836072,587677,236546,37012
21,ABM INDS INC,28.4699101897,2256312,32.3100761094,2067157,36.4798947243,2021360,39.6999692492,1973931,-189155,-45797
22,ABRAXAS PETE CORP,1.05830028936,149296,1.00023689821,37991,1.12908523567,146136,1.67421705732,20308,-111305,108145
23,ACACIA RESH CORP,4.29499266709,66822,3.79336730541,122846,4.39665770665,95982,6.52014417119,530203,56024,-26864
24,ACADIA HEALTHCARE COMPANY IN,62.4598121415,555205,55.1100541197,1066339,55.3999968361,1074621,49.5497977484,1760431,511134,8282
25,ACADIA PHARMACEUTICALS INC,35.6494188746,122779,27.9621912262,304268,32.4586819753,332361,31.8099442754,1179191,181489,28093
26,ACADIA RLTY TR,33.1499575368,3246339,35.1301270862,3165175,35.5197645965,3049063,36.2400360639,3218733,-81164,-116112
27,ACCELERON PHARMA INC,48.7760209999,16381,26.3888058088,217327,33.9790920038,416874,36.1905856356,835383,200946,199547
28,ACCENTURE PLC IRELAND,104.500108251,3270188,115.399807179,3060863,113.289983055,3326084,122.170388728,3815851,-209325,265221
29,ACCO BRANDS CORP,7.13087011307,176977,8.97616936499,182706,10.3315062398,247205,9.63830831938,676156,5729,64499
30,ACCURAY INC,6.7480501865,265410,5.77991948438,297582,5.1877856758,115078,6.35740826753,34448,32172,-182504
31,ACCURIDE CORP NEW,1.66726702002,97165,1.55041430516,58049,1.24259395991,166587,2.55673656995,34810,-39116,108538
32,ACETO CORP,26.9968837133,30485,23.5571506072,47926,21.8725368765,35524,18.9964411134,42429,17441,-12402
33,ACHAOGEN INC,5.74088440652,19335,2.75492489999,26498,3.80863549804,25731,4.79598336393,26689,7163,-767
34,ACHILLION PHARMACEUTICALS IN,10.7900175313,2628448,7.72014912986,2590494,7.79996657229,3978735,8.09984652425,5499240,-37954,1388241
35,ACI WORLDWIDE INC,21.4036191721,123951,20.7917442057,177330,19.5119208277,213408,19.3783507993,308695,53379,36078
36,ACORDA THERAPEUTICS INC,42.7813232917,214042,26.4472390052,284680,25.5069611039,292626,20.8796697444,724772,70638,7946
37,ACTIVISION BLIZZARD INC,38.7099439477,2880526,33.8397356316,3072985,39.6296517196,2850290,44.3000146783,4550924,192459,-222695
38,ACTUA CORP,11.4300558514,15398,9.04490576563,25097,9.03139986698,28567,12.9533678756,28950,9699,3470
39,ACTUANT CORP,23.9593973521,813543,24.7110492594,221318,22.6090129703,443938,23.2400229819,325473,-592225,222620
40,ACUITY BRANDS INC,233.799790277,464423,218.138321792,277975,247.957341231,153966,264.599429609,192850,-186448,-124009
41,ACXIOM CORP,20.9210051701,66536,21.4321391273,66069,21.9844951455,95067,26.6553720175,177075,-467,28998
42,ADCARE HEALTH SYSTEMS INC,2.4893584949,696565,2.32028416844,1130034,1.83966809801,1129008,2.07969511952,1130935,433469,-1026
43,ADECOAGRO S A,12.2929560651,140731,11.5478548489,104002,10.9692299038,71108,11.3760217984,14680,-36729,-32894
44,ADEPTUS HEALTH INC,54.5202419749,1989628,55.5400852504,1052195,51.6596637048,653295,43.050519975,439925,-937433,-398900
45,ADOBE SYS INC,93.9400576579,2081934,93.7993664179,1773093,95.7902263252,2050324,108.539838697,2194374,-308841,277231
46,ADTRAN INC,17.2119931824,83314,20.2225932109,179700,18.6531349214,148983,19.1436204155,184918,96386,-30717
47,ADURO BIOTECH INC,28.1362154462,36501,12.8037518936,48189,11.2921852945,23379,12.4398992597,26206,11688,-24810
48,ADVANCE AUTO PARTS INC,150.509818703,1337142,160.338947165,1086305,161.630198397,764226,149.119831504,902100,-250837,-322079
49,ADVANCED ENERGY INDS,28.22884976,257042,34.7898361434,421100,37.9603810852,344280,47.319588354,284322,164058,-76820
50,ADVANCED MICRO DEVICES INC,2.87004804467,7884537,2.84943461865,732426,5.13986873711,2114840,6.90995831565,6544902,-7152111,1382414
51,ADVANCED SEMICONDUCTOR ENGR,5.67238807538,47599,5.84482284689,69121,5.58273614974,49259,5.90756399861,77697,21522,-19862
52,ADVANTAGE OIL & GAS LTD,5.08074759572,170841,5.48666739822,63791,5.58744155992,78927,7.02725093943,67594,-107050,15136
53,ADVISORSHARES TR,28.0720597569,20483,27.6326709955,20483,26.5936054695,19892,27.5746496039,19692,0,-591
54,ADVISORY BRD CO,49.6100677826,370449,32.2397166421,38679,35.3905110533,69934,44.7394199658,404252,-331770,31255
55,AECOM,30.0294609471,569907,30.7912283931,282548,31.7703049371,740251,29.730608831,860830,-287359,457703
56,AEGEAN MARINE PETROLEUM NETW,8.35946668719,103954,7.56989147896,86527,5.49814972075,161327,9.99727400946,168746,-17427,74800
57,AEGERION PHARMACEUTICALS INC,10.0999949751,99505,3.69878957959,294691,1.49070874171,282416,2.97051002147,218481,195186,-12275
58,AEGION CORP,19.3104169738,210301,21.0875663314,223876,19.5096550815,295751,19.0705576224,232505,13575,71875
59,AEGON N V,5.66937423633,520516,5.50156237723,661812,4.00965046698,556657,3.86002529721,840409,141296,-105155
60,AEMETIS INC,2.89817528294,61763,2.03412471917,32938,2.27665253572,25476,1.06230659092,21651,-28825,-7462
61,AERCAP HOLDINGS NV,43.1601235277,1394667,38.7602376963,1783116,33.5902449403,1362985,38.4890428074,613889,388449,-420131
62,AERIE PHARMACEUTICALS INC,24.3663414851,22449,12.1602713791,420961,17.5994306325,455242,37.7401664585,257842,398512,34281
63,AEROHIVE NETWORKS INC,5.0967282293,18247,4.99532956991,24623,6.61179328026,14822,6.07449856734,17450,6376,-9801
64,AEROVIRONMENT INC,29.4705120226,629816,28.3200127332,615713,27.799713809,842095,24.4103688117,1255573,-14103,226382
65,AES CORP,9.57019355556,4875241,11.7999769327,7092302,12.4799321437,7210536,12.8498674371,6604037,2217061,118234
66,AETNA INC NEW,108.119744191,3932316,112.350032211,2340836,122.130239968,2027565,115.450358201,1854546,-1591480,-313271
67,AFFILIATED MANAGERS GROUP,159.760017362,2137988,162.39944421,1491212,140.770474832,1701003,144.700534705,1671763,-646776,209791
68,AFFIMED N V,7.12778878732,31286,3.72192783245,15852,2.482740946,62431,2.77219617474,53748,-15434,46579
69,AFLAC INC,59.8999474503,3602307,63.1398594771,1487729,72.1597876798,1767896,71.8698431129,3059016,-2114578,280167
70,AG MTG INVT TR INC,12.8366788218,88029,13.0719930681,66937,14.4323284157,31180,15.7677902622,26700,-21092,-35757
71,AGCO CORP,45.3902651989,584090,49.6999867619,649638,47.1308903896,900471,49.3195537525,849663,65548,250833
72,AGENUS INC,4.54816178461,18469,4.16304589455,49483,4.06182143313,39145,7.18417186926,43568,31014,-10338
73,AGILENT TECHNOLOGIES INC,41.810044527,4997866,39.8500135638,4814302,44.3598467702,4276976,47.0900862965,4709229,-183564,-537326
74,AGIOS PHARMACEUTICALS INC,64.8934037292,14963,40.5835610257,39893,41.8990452784,42316,52.8234415956,57607,24930,2423
75,AGNICO EAGLE MINES LTD,26.2806474729,746595,36.1604656021,689344,53.4998659138,928507,54.180988503,472472,-57251,239163
76,AGREE REALTY CORP,33.9816276733,27868,38.4938319447,15483,48.2660602615,17590,49.4342695753,57713,-12385,2107
77,AGRIUM INC,89.3375796423,520923,88.2892383878,436180,90.4195827017,337073,90.6881542645,602394,-84743,-99107
78,AIR LEASE CORP,33.4814180713,135508,32.1163925538,110660,26.7806938711,416158,28.5802527158,372355,-24848,305498
79,AIR METHODS CORP,41.9299449086,2347010,36.2200191268,1994063,35.8299748497,1861207,31.4902579724,1810814,-352947,-132856
80,AIR PRODS & CHEMS INC,130.110641128,589383,144.049449472,1453605,142.039657417,1051657,150.340215283,1725819,864222,-401948
81,AIR TRANSPORT SERVICES GRP I,10.0832659944,142315,15.3752917939,44552,12.9902417801,16089,14.3508263522,360258,-97763,-28463
82,AIRCASTLE LTD,20.895827652,58672,22.2325922469,60002,19.5579048534,62430,19.8621634348,256971,1330,2428
83,AIXTRON SE,4.36110041947,306574,4.84881425752,279656,6.08101569607,258345,6.04686318972,17199,-26918,-21311
84,AK STL HLDG CORP,2.24012685475,1437865,4.12831739791,111910,4.66024027628,918193,4.83010064183,396058,-1325955,806283
85,AKAMAI TECHNOLOGIES INC,52.63044531,1346388,55.5702413187,809552,55.9307333996,615708,52.9907590259,726655,-536836,-193844
86,AKEBIA THERAPEUTICS INC,12.9187839118,11611,8.99697757784,14227,7.47460087083,13780,9.03282661379,18156,2616,-447
87,AKORN INC,37.3132587729,171494,23.5277981286,298923,28.4831192047,319979,27.2597977244,847952,127429,21056
88,ALAMO GROUP INC,52.1005958186,439899,55.7067276809,138547,65.9364731654,4565,65.8885633339,41297,-301352,-133982
89,ALAMOS GOLD INC NEW,3.2881805401,300166,5.29720713207,88726,8.60061124555,1408272,8.19903123037,791313,-211440,1319546
90,ALASKA AIR GROUP INC,80.5099461902,1143101,82.0205407027,780207,58.2899730161,1327827,65.8591094312,1734779,-362894,547620
91,ALASKA COMMUNICATIONS SYS GR,1.74127310062,60875,1.76151761518,14760,1.70357751278,14675,1.73637710025,19581,-46115,-85
92,ALBANY INTL CORP,36.5667254556,8505,37.5362669246,16544,39.9380804954,29070,42.376709235,24353,8039,12526
93,ALBANY MOLECULAR RESH INC,19.8439868929,81788,15.2819663422,63997,13.4388405516,82522,16.5136402669,75695,-17791,18525
94,ALBEMARLE CORP,56.0105320095,447398,63.9300055957,770233,79.3102029641,704903,85.4902745291,779808,322835,-65330
95,ALCOA INC,9.87012658776,5539240,9.58004956768,5382540,9.38989412406,4699840,10.3183517724,5404933,-156700,-682700
96,ALCOBRA LTD,6.24194986624,10093,3.79042611726,16357,4.47730818805,29482,2.47055190365,22667,6264,13125
97,ALDER BIOPHARMACEUTICALS INC,33.0295924939,562102,24.4913051517,367804,24.9697347275,988757,32.7705198615,705207,-194298,620953
98,ALERE INC,39.0880049524,171229,50.6102884062,872866,41.6806790514,743390,43.2395534624,612356,701637,-129476
99,ALEXANDER & BALDWIN INC NEW,35.3081795578,156451,36.6841220674,143986,36.1460717798,121009,38.4175147239,96102,-12465,-22977
100,ALEXANDERS INC,384.176587302,4032,380.428488709,3454,409.387222947,3068,419.705694178,3126,-578,-386
101,ALEXANDRIA REAL ESTATE EQ IN,90.3595981443,880316,90.8905101448,689863,103.521200407,516358,108.768719121,678651,-190453,-173505
102,ALEXCO RESOURCE CORP,0.348735832607,11470,0.959023539669,11470,1.5931177314,12554,1.78697865741,29659,0,1084
103,ALEXION PHARMACEUTICALS INC,190.749374114,1362070,139.220249284,934196,116.759913773,1449196,122.539783664,2065672,-427874,515000
104,ALIBABA GROUP HLDG LTD,81.2698960253,9589541,79.0299945921,10774909,79.5298544826,7677708,105.790059978,13667475,1185368,-3097201
105,ALIGN TECHNOLOGY INC,65.8499310537,401762,72.6883907404,477903,80.5495004499,1081273,93.7496177554,1226309,76141,603370
106,ALIMERA SCIENCES INC,2.4201819655,1615581,1.74977551293,2124844,1.23014166927,1625829,1.49013224153,973068,509263,-499015
107,ALKERMES PLC,79.3800253608,2067762,34.1901586621,2365593,43.2194434278,1841486,47.0300317931,2566913,297831,-524107
108,ALLEGHANY CORP DEL,477.915536614,41296,496.215131111,23911,549.591319727,41842,525.015708451,50928,-17385,17931
109,ALLEGHENY TECHNOLOGIES INC,11.2454385225,201415,16.2998298202,229757,12.7492520384,973312,18.0701364484,2501752,28342,743555
110,ALLEGIANT TRAVEL CO,167.824904167,40435,178.069645537,51317,151.504211793,74790,132.075715319,77448,10882,23473
111,ALLEGION PUB LTD CO,65.9202729834,736162,63.7102790739,790830,69.4318394717,410993,68.9100285899,506472,54668,-379837
112,ALLERGAN PLC,314.684019827,2624690,269.348127905,3648906,233.296723872,2787986,230.387638512,3397908,1024216,-860920
113,ALLETE INC,50.84275233,75645,56.0704733857,232939,64.6308724832,178800,59.6173850474,255714,157294,-54139
114,ALLIANCE DATA SYSTEMS CORP,276.57033208,306432,220.001203713,398766,195.921512834,236166,214.530817766,321730,92334,-162600
115,ALLIANCE HEALTHCARE SRVCS IN,9.15264245645,16935,7.17640230067,18951,6.24456564698,37953,6.86439205237,34526,2016,19002
116,ALLIANCE RES PARTNER L P,13.4904525194,1534122,11.6534839925,132750,15.7595854342,571779,22.1804208271,843672,-1401372,439029
117,ALLIANCEBERNSTEIN HOLDING LP,23.8505598051,1040898,23.4306509817,392392,23.2989869891,379759,22.8015313653,313707,-648506,-12633
118,ALLIANT ENERGY CORP,62.4508486109,537879,74.278294181,525214,39.7001522017,1738482,38.3103607385,1629768,-12665,1213268
119,ALLIED HEALTHCARE PRODS INC,1.12243135901,23164,0.689164044015,43531,0.595282387082,40317,0.82231206743,43779,20367,-3214
120,ALLIED WRLD ASSUR COM HLDG A,37.1903844623,917307,34.9399904222,1213223,35.1403205499,1516207,40.4198114427,1469898,295916,302984
121,ALLISON TRANSMISSION HLDGS I,25.8895236747,2033757,26.9798660442,1971396,28.2298955119,1750343,28.6806279415,1171383,-62361,-221053
122,ALLSCRIPTS HEALTHCARE SOLUTN,15.3799598384,4682587,13.2101142931,5856346,12.7000073885,4371651,13.169930462,3761827,1173759,-1484695
123,ALLSTATE CORP,62.0895554388,1865660,67.370001197,1854594,69.950695039,2088228,69.179710082,2440759,-11066,233634
124,ALLY FINL INC,18.6401736006,7446980,18.7199787254,3609940,17.069967003,5417468,19.4700074904,5564456,-3837040,1807528
125,ALNYLAM PHARMACEUTICALS INC,94.1381459295,393135,62.770886498,641874,55.4901553447,693168,67.7800180091,942859,248739,51294
126,ALON USA ENERGY INC,14.8401485535,1841491,10.320045115,2287490,6.4804507109,944996,8.0597196355,921372,445999,-1342494
127,ALPHA & OMEGA SEMICONDUCTOR,9.19876652903,38266,11.8557650961,32558,13.9259803869,92489,21.7170665695,76852,-5708,59931
128,ALPHABET INC,772.45110191,4357481,757.852022586,4226618,699.947246949,4058533,795.658750049,4085920,-130863,-168085
129,ALPHATEC HOLDINGS INC,0.29667721519,70784,0.240868503002,58123,0.351270917695,102485,9.396295518,33311,-12661,44362
130,ALPINE TOTAL DYNAMIC DIVID F,7.6610828426,17491,7.48204911603,16573,7.24069269293,16573,7.62554769127,23736,-918,0
131,ALPS ETF TR,12.2668592882,16452296,11.0285666156,38598307,12.8624981983,31539674,12.7334135876,38201932,22146011,-7058633
132,ALTISOURCE PORTFOLIO SOLNS S,27.813364889,102253,24.1469191177,75579,27.8411753148,66161,32.3953087028,141965,-26674,-9418
133,ALTISOURCE RESIDENTIAL CORP,12.409720833,144967,12.0116927983,37630,9.19708623286,49146,10.906735361,66381,-107337,11516
134,ALTRA INDL MOTION CORP,25.0761884194,41673,27.7699485247,67411,26.9791725782,88105,28.9732088738,74241,25738,20694
135,ALTRIA GROUP INC,58.2100857391,6784649,62.6600650536,6870644,68.959846602,7333601,63.2299736448,6066743,85995,462957
136,AMAG PHARMACEUTICALS INC,30.1948974374,175990,23.3985851516,278051,23.9218289601,85863,24.5112343157,65113,102061,-192188
137,AMARIN CORP PLC,1.89052834115,446965,1.52957471479,283739,2.15967978856,366258,3.19044338468,598036,-163226,82519
138,AMAYA INC,12.5931276887,92749,13.382813852,52007,15.307752636,34427,16.2209302326,17200,-40742,-17580
139,AMAZON COM INC,675.890532537,2999357,593.640178484,2949957,715.619626498,3063063,837.31003414,2922104,-49400,113106
140,AMBAC FINL GROUP INC,14.0893574284,763697,15.7998193051,1638120,16.459956691,1487914,18.3897084449,1317041,874423,-150206
141,AMBARELLA INC,55.7403136119,223716,44.6988080073,272401,50.8117413113,134772,73.6121690295,87961,48685,-137629
142,AMBEV SA,4.45997169636,13006809,5.17990618739,6080419,5.91001701637,4681374,6.08999853717,10746308,-6926390,-1399045
143,AMC NETWORKS INC,74.6803938299,564914,64.9405772496,431148,60.4195675439,868990,51.8605343849,1037417,-133766,437842
144,AMDOCS LTD,54.5700724858,1293218,60.4199097618,1492273,57.719893238,1351042,57.8503199131,1590432,199055,-141231
145,AMEC FOSTER WHEELER PLC,6.44306752874,44544,6.39839654641,155664,6.52967159593,114554,7.43306160456,122426,111120,-41110
146,AMEDISYS INC,39.3268246398,40049,48.3404780462,61584,50.4798499445,109826,47.4338587283,121369,21535,48242
147,AMERCO,389.492981793,71457,357.310676429,109812,374.556833975,105773,324.226037467,116317,38355,-4039
148,AMEREN CORP,43.2298794326,4117615,50.0999122191,4735657,53.5800085891,4468439,49.1797303814,3210164,618042,-267218
149,AMERICA MOVIL SAB DE CV,14.0601663321,2987518,15.5303264473,1504347,12.2601617608,1701772,11.4402224163,2498378,-1483171,197425
150,AMERICAN AIRLS GROUP INC,42.3498696724,1892922,41.0095334902,2260767,28.3103953869,1623220,36.6098494238,2238933,367845,-637547
151,AMERICAN ASSETS TR INC,38.3711824589,22986,39.8924401784,29379,42.4430641822,38640,43.3886607984,62597,6393,9261
152,AMERICAN AXLE & MFG HLDGS IN,18.940345212,1150771,15.3902961803,346647,14.4801109525,248755,17.2191180072,449210,-804124,-97892
153,AMERICAN CAMPUS CMNTYS INC,41.3414024956,574533,47.0885188886,616456,52.870645603,419174,50.8699435161,1044723,41923,-197282
154,AMERICAN CAP LTD,13.7899563259,2480646,15.239943845,7282704,15.8299156083,3993641,16.9101197676,4375723,4802058,-3289063
155,AMERICAN CAP MTG INVT CORP,13.9605551042,1410474,14.6803345023,370700,15.7908859696,514284,17.1916386121,220107,-1039774,143584
156,AMERICAN CAPITAL AGENCY CORP,17.3398872336,3859483,18.6301177771,2938092,19.8200248213,2865284,19.5400199128,2698769,-921391,-72808
157,AMERICAN EAGLE OUTFITTERS NE,15.4996088349,1625912,16.6700244176,1861365,15.9300084375,4180161,17.8598962945,4766769,235453,2318796
158,AMERICAN ELEC PWR INC,58.2702162312,1812504,66.4001876421,2246831,70.0903894593,1938611,64.2100373316,2725306,434327,-308220
159,AMERICAN EQTY INVT LIFE HLD,24.0300644697,3114640,16.7997629274,3371119,14.2503257484,1125869,17.7303996655,915941,256479,-2245250
160,AMERICAN EXPRESS CO,69.5501748729,2972444,61.4000580583,8536246,60.7600553663,8405835,64.0399994563,6547689,5563802,-130411
161,AMERICAN FINL GROUP INC OHIO,72.0805397607,471320,70.369812695,571154,73.9305500265,482304,75.0002353318,637398,99834,-88850
162,AMERICAN HOMES 4 RENT,16.6586958504,537377,15.8999779216,1123272,20.4799720945,1215529,21.6402079444,1589079,585895,92257
163,AMERICAN INTL GROUP INC,61.8572744239,11688795,53.8089580512,5055162,52.5934966017,4768061,58.8547470719,3246654,-6633633,-287101
164,AMERICAN NATL INS CO,102.250560457,34347,115.484292877,41287,113.12859068,28198,121.952225752,24239,6940,-13089
165,AMERICAN RAILCAR INDS INC,46.292651912,33029,40.7487066209,17203,39.4813614263,15425,41.4852320675,29625,-15826,-1778
166,AMERICAN SOFTWARE INC,10.2138804016,11455,9.00292595093,35544,10.4882552057,38996,11.0824066794,26709,24089,3452
167,AMERICAN STS WTR CO,41.956434973,82681,39.3619225192,178599,43.8131688765,124369,40.0479616307,133440,95918,-54230
168,AMERICAN SUPERCONDUCTOR CORP,6.38286063163,18017,7.56227758007,2248,8.45002414293,4142,7.03729767769,12789,-15769,1894
169,AMERICAN TOWER CORP NEW,96.9732980163,9500605,102.370001669,8898095,113.606365083,7458693,113.321651752,7205075,-602510,-1439402
170,AMERICAN VANGUARD CORP,14.0226628895,14120,15.7644259369,13448,15.1238158551,24068,16.0385500575,13904,-672,10620
171,AMERICAN WOODMARK CORP,79.9929984246,17139,74.6030595229,13793,66.373163612,41794,80.5686029075,80689,-3346,28001
172,AMERICAN WTR WKS CO INC NEW,59.7499975251,707113,68.9302883108,1993855,84.5100216461,1441829,74.8402880098,1798550,1286742,-552026
173,AMERIGAS PARTNERS L P,34.2694016741,1006408,43.4703051408,1071145,46.7002250584,1663568,45.6600847748,1850785,64737,592423
174,AMERIPRISE FINL INC,106.420398887,1855866,94.0104893876,1507619,89.8499125469,1446490,99.7706125685,1354477,-348247,-61129
175,AMERIS BANCORP,33.9834618471,85983,29.5794385482,597273,29.6996997328,908191,34.9503559103,959933,511290,310918
176,AMERISAFE INC,50.9015178925,464328,52.5397883859,428894,61.2187517714,441025,58.7774954139,475352,-35434,12131
177,AMERISOURCEBERGEN CORP,103.710142071,2231990,86.5499165618,1315345,79.3196133112,1189794,80.7800032204,1701634,-916645,-125551
178,AMETEK INC NEW,53.5903568206,2334002,49.9800585245,2484771,46.2299299195,5742254,47.7800752978,5528183,150769,3257483
179,AMGEN INC,162.330491873,2896985,149.929853495,3402878,152.150347463,3412309,166.810077469,2980947,505893,9431
180,AMICUS THERAPEUTICS INC,9.6999987141,1399794,8.45052734964,1067034,5.46106712063,192087,7.39922458901,374769,-332760,-874947
181,AMIRA NATURE FOODS LTD,9.11368477902,133316,9.76932281175,132046,7.39634220195,123845,8.2976425459,134255,-1270,-8201
182,AMKOR TECHNOLOGY INC,6.08180956447,276398,5.89123172317,239169,5.74993765706,208524,9.72075959273,761566,-37229,-30645
183,AMN HEALTHCARE SERVICES INC,31.0468684107,68767,33.6122365803,208555,39.9697566531,214262,31.8705952848,328767,139788,5707
184,AMPCO-PITTSBURGH CORP,10.2546215556,14335,13.9015113265,29709,11.3047085667,19284,11.0823790174,10828,15374,-10425
185,AMPHASTAR PHARMACEUTICALS IN,14.2366747386,37579,11.9902617164,49290,16.129640098,53070,18.9693821575,147659,11711,3780
186,AMPHENOL CORP NEW,52.2302074373,4424566,57.8200806677,4548783,57.329905421,4302327,64.9201278247,4375053,124217,-246456
187,AMSURG CORP,75.99972501,770937,74.6004191177,1028828,77.5403536912,1051143,67.0499097057,1305177,257891,22315
188,AMTRUST FINL SVCS INC,61.580388017,1498594,25.8800403749,2562979,24.5004637745,1928739,26.8299941698,1639732,1064385,-634240
189,AMYRIS INC,1.62177129069,25281,1.11106741131,101704,0.444958618848,22474,0.602300789014,16603,76423,-79230
190,ANADARKO PETE CORP,47.8888347824,4899806,46.5699957623,7494568,53.2499722007,7347309,63.3600216894,5267091,2594762,-147259
191,ANALOG DEVICES INC,55.3197369471,1541439,59.1903774528,2383901,56.6402458068,1066203,64.450467864,1832477,842462,-1317698
192,ANALOGIC CORP,82.6331555491,13687,78.9998670036,15038,79.4204453984,18635,88.5850489811,19089,1351,3597
193,ANDERSONS INC,31.6174470272,33083,31.4134097688,25817,35.5231309447,29333,36.1496624156,21328,-7266,3516
194,ANGIES LIST INC,9.34690014198,16904,8.03571428571,10080,6.51306285351,40841,9.90541446339,40281,-6824,30761
195,ANGLOGOLD ASHANTI LTD,7.09988037922,672124,13.6903731222,1524648,18.0602379654,2205951,15.9203345043,1128117,852524,681303
196,ANHEUSER BUSCH INBEV SA/NV,125.0,406600,124.659139012,507905,131.67790147,377102,131.410486585,598765,101305,-130803
197,ANI PHARMACEUTICALS INC,45.1151962752,12457,33.6710932091,15889,55.7989153108,9588,66.3176265271,12606,3432,-6301
198,ANIKA THERAPEUTICS INC,38.1745120551,17420,44.7339190144,9903,53.715308863,6702,47.8561677836,64464,-7517,-3201
199,ANIXTER INTL INC,60.3907074245,725095,52.1097119965,631034,53.2794139456,627109,64.4995588511,751447,-94061,-3925
200,ANNALY CAP MGMT INC,9.3800060928,2412685,10.2599955898,4095031,11.0699207574,5264717,10.5000365262,7843687,1682346,1169686
201,ANSYS INC,92.5000919557,543740,89.4599563578,605377,90.7496070475,635573,92.6086395657,713184,61637,30196
202,ANTARES PHARMA INC,1.20773952807,120059,0.87305744718,22908,1.05063524831,297915,1.68025004731,306502,-97151,275007
203,ANTERO MIDSTREAM PARTNERS LP,22.8199573916,11411371,22.1100361738,12933674,27.8699688112,11139912,26.6999370661,9966016,1522303,-1793762
204,ANTERO RES CORP,21.7999787387,6989227,24.8696453592,1391013,25.979844563,4184975,26.95008219,5607738,-5598214,2793962
205,ANTHEM INC,139.439743298,1489353,138.415126332,1797607,131.339950402,1678286,123.888583762,1813452,308254,-119321
206,ANTHERA PHARMACEUTICALS INC,4.63861485806,124175,3.64342968181,16468,3.11510570932,19582,3.13202402447,27139,-107707,3114
207,ANWORTH MORTGAGE ASSET CP,4.35003597526,1211944,4.66005205805,945483,4.70019019958,875922,4.91931347944,879391,-266461,-69561
208,AON PLC,92.2098591749,703710,104.450620749,869272,109.23157113,803861,112.491591727,878599,165562,-65411
209,APACHE CORP,44.4704495378,2873796,48.8101242755,4609515,55.6702073301,1107702,63.8702971845,2283127,1735719,-3501813
210,APARTMENT INVT & MGMT CO,40.0300154523,1664476,41.8202040319,1941167,43.8406715642,1404244,45.9101758424,1748327,276691,-536923
211,APOGEE ENTERPRISES INC,43.5084197943,67757,43.8795474523,70534,46.3605198118,25086,44.6909865864,127632,2777,-45448
212,APOLLO COML REAL EST FIN INC,17.230228999,3421893,16.2999596549,3841850,16.0704452486,2033920,16.3703039257,379040,419957,-1807930
213,APOLLO ED GROUP INC,7.67018123228,1025921,8.2138840189,340521,9.11920600091,461663,7.94986241742,858757,-685400,121142
214,APOLLO GLOBAL MGMT LLC,15.1799221967,6138042,17.1199004021,4959141,15.1500919065,4833172,17.9600886918,4794130,-1178901,-125969
215,APOLLO INVT CORP,5.21912578801,296793,5.5483063344,94263,5.53665648431,57616,5.79813819524,212482,-202530,-36647
216,APPLE HOSPITALITY REIT INC,19.9694439487,638826,19.8110436192,527635,18.8110296884,558130,18.5087367153,378632,-111191,30495
217,APPLE INC,105.260023651,47808055,108.989998625,55306093,95.6000051621,47577874,113.050002362,48190543,7498038,-7728219
218,APPLIED INDL TECHNOLOGIES IN,40.4948163387,36943,43.3952246234,126189,45.1398489256,180838,46.7419336352,87245,89246,54649
219,APPLIED MATLS INC,18.670026767,4545896,21.1801881449,5653302,23.9701631607,5136469,30.1501521439,6506667,1107406,-516833
220,APPLIED MICRO CIRCUITS CORP,6.38469245428,50903,6.46241289368,25687,6.41921038577,97364,6.95025562162,633358,-25216,71677
221,APPROACH RESOURCES INC,1.84150602913,514253,1.16268827623,113530,2.09821316167,119149,3.38553627784,134986,-400723,5619
222,APTARGROUP INC,72.6499867165,319945,78.4118095115,93213,79.1319713121,432935,77.4152786467,161441,-226732,339722
223,AQUA AMERICA INC,29.7995563953,632996,31.8197470428,429796,35.6577143127,338384,30.4816836577,391481,-203200,-91412
224,AQUINOX PHARMACEUTICALS INC,12.4688279302,18045,8.81979806599,970317,6.61954143795,957166,13.3602663179,991597,952272,-13151
225,ARADIGM CORP,3.97173794891,23919,4.455298505,30301,4.39426304547,16385,6.8536261277,14299,6382,-13916
226,ARAMARK,32.2501067706,1297174,33.1198221109,1446294,33.4206044443,1433846,38.0303712614,1674346,149120,-12448
227,ARATANA THERAPEUTICS INC,5.58627800169,53345,5.51191952597,14514,6.30277084077,25227,9.36378104297,81057,-38831,10713
228,ARBOR RLTY TR INC,7.12825619791,19079,6.76886139071,108290,7.18583679464,63319,7.42398806193,53610,89211,-44971
229,ARBUTUS BIOPHARMA CORP,4.45000118509,675056,4.1296540413,748731,3.47955905993,680546,3.44009645375,610448,73675,-68185
230,ARC DOCUMENT SOLUTIONS INC,4.43592552026,18260,4.50878550116,45245,3.89320562316,122778,3.73442116472,66677,26985,77533
231,ARC LOGISTICS PARTNERS LP,13.2697794705,778762,10.2296161445,786051,13.0000865951,739072,15.0495124447,686999,7289,-46979
232,ARCADIA BIOSCIENCES INC,3.01507537688,11940,2.79552715655,15024,2.63281617301,10635,1.93067134708,22790,3084,-4389
233,ARCBEST CORP,21.3936615106,99235,21.5910638878,88092,16.2558885075,97011,19.0220531373,112501,-11143,8919
234,ARCELORMITTAL SA LUXEMBOURG,4.31159057503,11604998,4.58002113841,20590953,4.66020963394,728508,6.03976330492,1961004,8985955,-19862445
235,ARCH CAP GROUP LTD,69.7492628446,623003,71.1002382738,722698,71.9994464731,708186,79.2606542281,723234,99695,-14512
236,ARCHER DANIELS MIDLAND CO,36.6797527843,3055146,36.309661553,1763112,42.8898861242,2673614,42.1700526238,2732413,-1292034,910502
237,ARCHROCK INC,7.52030844399,1661501,8.0,1706125,9.42014077928,879817,13.0812795426,615001,44624,-826308
238,ARCHROCK PARTNERS L P,12.3095199418,609447,11.080997207,725025,13.5396190255,2416907,14.7199723314,2995454,115578,1691882
239,ARCOS DORADOS HOLDINGS INC,3.0935808198,27153,3.75450999066,54601,4.73022143674,19238,5.26879417434,23345,27448,-35363
240,ARDMORE SHIPPING CORP,12.7078339611,26283,8.45630509774,41744,6.77071079392,38253,7.03041108657,49357,15461,-3491
241,ARENA PHARMACEUTICALS INC,1.89980751479,279502,1.96839650273,274843,1.71048381887,387025,1.74988301811,361167,-4659,112182
242,ARES CAP CORP,14.2497767739,3188471,14.8406456798,532524,14.1997824219,1083749,15.4998608822,700845,-2655947,551225
243,ARES COML REAL ESTATE CORP,11.4369501466,54560,10.9497650079,80641,12.2877458171,160892,12.6019273536,110618,26081,80251
244,ARES MGMT L P,12.9224652087,60360,15.4053153275,81011,14.0886735939,81129,17.4063329424,81005,20651,118
245,ARGO GROUP INTL HLDGS LTD,59.8396671062,219169,57.3903857309,212039,51.8997942604,303296,56.4201425764,321091,-7130,91257
246,ARIAD PHARMACEUTICALS INC,6.24990230457,383846,6.38991162852,590462,7.39019971909,1769235,13.6899192251,3362182,206616,1178773
247,ARISTA NETWORKS INC,77.8489477018,28414,63.1000654022,38225,64.3823599777,112857,85.0807386819,263009,9811,74632
248,ARMADA HOFFLER PPTYS INC,10.4743405885,55087,11.2471341437,23117,13.7442089007,71230,13.4021357414,55812,-31970,48113
249,ARMOUR RESIDENTIAL REIT INC,21.7600562744,216084,21.5313346165,183918,19.9989134306,165659,22.5405240672,347818,-32166,-18259
250,ARMSTRONG WORLD INDS INC NEW,45.7300217478,3134571,48.3701559854,1035866,39.1508195386,712169,41.3215313613,432922,-2098705,-323697
251,ARQULE INC,2.1634468889,32818,1.61157904339,32887,1.9016740967,32077,1.77594657953,28154,69,-810
252,ARRAY BIOPHARMA INC,4.21872959206,689070,2.95136142312,568890,3.5571520965,256666,6.74857089087,340072,-120180,-312224
253,ARROW ELECTRS INC,54.1796299888,732194,64.4101887662,1037103,61.9003139699,1262223,63.9697546679,1459002,304909,225120
254,ARTISAN PARTNERS ASSET MGMT,36.0603197136,459286,30.8396393912,580130,27.6816895233,725317,27.2006857206,613661,120844,145187
255,ASANKO GOLD INC,1.46165777229,380390,2.12835859271,70007,3.82884048223,19327,4.18969284154,38905,-310383,-50680
256,ASBURY AUTOMOTIVE GROUP INC,67.4403417373,614039,59.839469332,222512,52.7404095406,333691,55.6715539816,346748,-391527,111179
257,ASCENA RETAIL GROUP INC,9.8499019977,1006609,11.0597645765,501819,6.99078396032,695201,5.5898967229,4206160,-504790,193382
258,ASCENT CAP GROUP INC,16.7137951929,19804,14.8073088615,30593,15.3825180069,44011,23.1698739147,95253,10789,13418
259,ASHFORD HOSPITALITY PRIME IN,14.4940423262,56230,11.661040726,45622,14.1391920969,394577,14.1016431424,463563,-10608,348955
260,ASHFORD HOSPITALITY TR INC,6.30653196404,179655,6.37755102041,170128,6.57754844563,141086,5.89012110389,266548,-9527,-29042
261,ASHFORD INC,53.2427973093,15758,45.607367344,6841,49.9532273152,5345,47.6616692772,4469,-8917,-1496
262,ASML HOLDING N V,88.7719754753,122978,100.391328573,154346,99.2091163201,167787,109.579251089,187499,31368,13441
263,ASPEN INSURANCE HOLDINGS LTD,48.2993993944,358638,47.7018425985,383046,46.3786160341,411224,46.5901293071,540651,24408,28178
264,ASPEN TECHNOLOGY INC,37.762125138,211111,36.1299204029,849905,40.2408242036,679832,46.79018204,767084,638794,-170073
265,ASSOCIATED BANC CORP,10.3876046523,859871,11.5459853934,1092934,9.4513716254,917962,12.0873059024,1009737,233063,-174972
266,ASSURANT INC,80.5403717193,842087,77.149603966,762687,86.3102216771,887056,92.2500969665,822449,-79400,124369
267,ASSURED GUARANTY LTD,26.4300445547,2074306,25.3001383919,2161253,25.3701136737,1913196,27.7495332553,2112504,86947,-248057
268,ASTEC INDS INC,40.6967898981,13146,46.7246196833,6442,56.150712831,98200,59.8712446352,74560,-6704,91758
269,ASTORIA FINL CORP,15.8489578926,129977,15.8408714956,908599,15.3287545894,172682,14.6004457723,819701,778622,-735917
270,ASTRAZENECA PLC,33.9502954779,1668822,28.1592172081,2008401,30.1900810343,2304333,32.8597954172,1936135,339579,295932
271,ASTRONICS CORP,40.6992440605,14816,38.1531767455,49642,33.2652242825,52367,45.0507991207,67324,34826,2725
272,AT&T INC,34.4100124312,23802171,39.1700124236,24710153,43.210037847,19402089,40.6100403652,18218401,907982,-5308064
273,ATHENAHEALTH INC,160.934658981,25849,138.780883569,65326,137.998148632,42131,126.119786431,89526,39477,-23195
274,ATHERSYS INC,1.03860648684,33699,2.24703266418,127724,2.17060437827,507232,2.14068426785,26627,94025,379508
275,ATLANTIC PWR CORP,1.96974374807,161950,2.46151688348,285190,2.48441814168,184349,2.46409674981,132300,123240,-100841
276,ATLANTICUS HLDGS CORP,3.19616460248,27533,3.003003003,39627,2.90551689504,55756,3.00152805064,54972,12094,16129
277,ATLAS AIR WORLDWIDE HLDGS IN,41.3415290686,169031,42.2714784882,187455,41.4154287734,93371,42.8134112902,68927,18424,-94084
278,ATLASSIAN CORP PLC,30.0893276916,10635,25.1574584148,55729,25.8941324546,70711,29.9625468165,6942,45094,14982
279,ATMOS ENERGY CORP,63.0401747837,840353,74.2602136973,1567919,81.3200868016,1649740,74.4700142883,2145105,727566,81821
280,ATRICURE INC,22.4603462889,16518,16.8363952715,19541,14.1140668451,19059,15.7945893407,12346,3023,-482
281,ATRION CORP,381.112984823,5930,395.239637306,6176,427.936962751,6980,426.632092739,6556,246,804
282,ATWOOD OCEANICS INC,10.2291245765,972615,9.16900453474,482277,12.5215652231,182006,8.68691485143,297574,-490338,-300271
283,ATYR PHARMA INC,9.81199910119,13351,3.92954880359,42753,2.76966155345,32856,3.17838696861,93129,29402,-9897
284,AU OPTRONICS CORP,2.90867436324,89044,2.94862146815,146170,3.5001600683,46855,3.64809507903,113758,57126,-99315
285,AUTODESK INC,60.9293078843,1048264,58.3104580103,1515097,54.1404606066,946187,72.330380727,1199731,466833,-568910
286,AUTOHOME INC,34.9203679057,606351,27.9371996654,102802,20.1044819967,78291,24.24676532,131234,-503549,-24511
287,AUTOLIV INC,124.769379044,326835,118.477153998,241574,107.448622763,232204,106.797792456,196961,-85261,-9370
288,AUTOMATIC DATA PROCESSING IN,84.7197695786,1674497,89.7101039397,1622961,91.8698371796,1326431,88.199907211,1547598,-51536,-296530
289,AUTONATION INC,59.6604231607,1160032,46.6795832723,867617,46.9804903636,709188,48.709903221,861447,-292415,-158429
290,AUTOZONE INC,741.905293484,177369,796.693239566,83042,793.829934757,119707,768.339102404,168138,-94327,36665
291,AVALONBAY CMNTYS INC,184.130217194,1427707,190.200122638,1040462,180.390089615,1460690,177.84056463,1860616,-387245,420228
292,AVANGRID INC,38.4003092769,636323,40.1095708475,120470,46.0617154576,444686,41.7803321535,446119,-515853,324216
293,AVERY DENNISON CORP,62.6602865358,1473533,72.1101371427,2004628,74.7498991563,2389836,77.789982224,3492352,531095,385208
294,AVG TECHNOLOGIES N V,20.0484203365,49979,20.7520876319,92569,18.9894486981,69091,25.0099511365,582848,42590,-23478
295,AVIANCA HLDGS SA,4.27018207949,2006706,4.96962888128,1908392,6.16021506282,1900096,6.47996103608,1901246,-98314,-8296
296,AVID TECHNOLOGY INC,7.29288214702,13712,6.76180204099,48212,5.80494834808,74247,7.9392322087,270933,34500,26035
297,AVIS BUDGET GROUP,36.2916001973,362949,27.359436666,925348,32.2299274809,693610,34.2099988865,1122625,562399,-231738
298,AVISTA CORP,35.3747954582,80057,40.7745030843,145900,44.8051261618,122977,41.7891760033,231615,65843,-22923
299,AVIVA PLC,15.2091176319,484775,13.0602971744,460403,10.690341249,451342,11.5110259876,361827,-24372,-9061
300,AVNET INC,42.8399406553,1459946,44.3002198391,1627554,40.5097309998,1950519,41.0598972303,2729208,167608,322965
301,AVON PRODS INC,4.05012174664,2181169,4.80987988593,977987,3.77997862182,2989964,5.65990588722,5038423,-1203182,2011977
302,AVX CORP NEW,12.1323714877,39646,12.5695629591,67385,13.5795207529,78206,13.7950116605,177093,27739,10821
303,AXALTA COATING SYS LTD,26.6500387062,12611689,29.2000404371,8556495,26.5301010023,5872047,28.2698058866,5610226,-4055194,-2684448
304,AXCELIS TECHNOLOGIES INC,2.60926288324,9198,2.80139103555,41408,2.68537293802,91235,13.2905013857,31752,32210,49827
305,AXIS CAPITAL HOLDINGS LTD,56.2204409918,1056573,55.460014694,858853,55.0003627482,1033775,54.3304379027,1003305,-197720,174922
306,AZZ INC,55.566073457,73948,56.6016022096,156409,59.9832697636,130303,65.2660412952,193485,82461,-26106
307,B & G FOODS INC NEW,35.0017399374,34484,34.8156997007,81199,48.2002138771,385268,49.1792249731,356736,46715,304069
308,B2GOLD CORP,1.02160383758,372943,1.6575679108,242524,2.51017440985,2157619,2.63243043358,432680,-130419,1915095
309,BABCOCK & WILCOX ENTERPRIS I,20.8695585566,261098,21.4035471863,54804,14.6878824969,157681,16.5012691408,614983,-206294,102877
310,BAIDU INC,189.040498394,1416871,190.879701153,2068748,165.150276531,1094815,182.068700235,1299850,651877,-973933
311,BAKER HUGHES INC,46.1499203268,3205596,43.830344955,1397023,45.1300624722,4485037,50.4697979774,3945845,-1808573,3088014
312,BALCHEM CORP,60.7746104454,24451,62.0073327223,21820,59.6257532509,18918,77.5371960808,16534,-2631,-2902
313,BALL CORP,72.7301918035,2840251,71.2899095452,3268485,72.2904551519,1271136,81.9498872813,2261382,428234,-1997349
314,BALLARD PWR SYS INC NEW,1.56045749827,904222,1.39940924268,851788,1.25115564758,523516,2.21133556845,434579,-52434,-328272
315,BANCO BILBAO VIZCAYA ARGENTA,7.33005264206,3660001,6.52017282037,3590549,5.73975259817,2384946,5.96005485081,1901157,-69452,-1205603
316,BANCO BRADESCO S A,4.81039034701,16643140,7.4541984866,4584128,7.81112460434,4453264,9.0693599735,11289220,-12059012,-130864
317,BANCO DE CHILE,59.405642331,66391,64.4490309265,62018,64.139702947,97693,67.3022058312,143710,-4373,35675
318,BANCO MACRO SA,58.1182526632,279740,64.4696996687,280690,74.2196364497,304057,78.2512233397,258718,950,23367
319,BANCO SANTANDER BRASIL S A,3.88947758497,1959132,4.64937528785,983573,5.69971644387,629505,6.70006146281,1627000,-975559,-354068
320,BANCO SANTANDER CHILE NEW,17.6366968813,140219,19.353230583,168499,19.3689953742,168620,20.6918933632,191041,28280,121
321,BANCO SANTANDER SA,4.8698531094,4528268,4.35990107726,4339548,3.91989532019,4645022,4.41020110526,4408189,-188720,305474
322,BANCOLOMBIA S A,26.7446064843,165940,34.1811606056,220092,34.9208222324,220327,39.0410740843,219871,54152,235
323,BANCORPSOUTH INC,23.9899110719,3030649,21.3099843111,2657299,22.6902249066,1844054,23.2001388462,1872575,-373350,-813245
324,BANK AMER CORP,16.963385232,67684957,13.4793164588,73379166,13.3033047283,74052502,15.7023874304,59203736,5694209,673336
325,BANK HAWAII CORP,62.9026263627,193728,68.2848637509,109175,68.798216491,124698,72.6184053656,150141,-84553,15523
326,BANK MONTREAL QUE,56.419697448,548071,60.6902182506,1467304,63.3898762472,1674952,65.5700518885,811163,919233,207648
327,BANK N S HALIFAX,40.4398676178,606728,48.8596455301,2026519,49.0101967699,1914724,52.9893775743,896123,1419791,-111795
328,BANK NEW YORK MELLON CORP,41.2201031617,4776383,36.8301715107,4316814,38.849905802,5016563,39.8801182919,5912495,-459569,699749
329,BANK OF THE OZARKS INC,49.4599909064,1693490,41.9697278196,1753359,37.519745825,1680102,38.4000542255,2449033,59869,-73257
330,BANKRATE INC DEL,13.3151979383,13969,9.16808149406,135470,7.47947082813,361924,8.48155332519,426337,121501,226454
331,BANKUNITED INC,36.0581176986,378611,34.4393218658,354856,30.7213458688,406102,30.1988918109,405346,-23755,51246
332,BANNER CORP,45.8600063896,2256803,42.0397764973,2244089,42.5402022825,2244089,43.7403126995,1685196,-12714,0
333,BANRO CORP,0.199942238909,90026,0.258801747907,100463,0.28866348805,100463,0.321930225859,236076,10437,0
334,BARCLAYS BANK PLC,32.8417513563,65435,27.5481611208,57100,26.4668318279,194961,27.7841331579,69932,-8335,137861
335,BARCLAYS BK PLC,19.3609690119,529364,17.5177250686,3122837,14.0090591975,2250972,33.7472138481,1534823,2593473,-871865
336,BARCLAYS PLC,12.9594552656,1308234,8.62044858872,1180101,7.59966155175,1361508,8.68964128721,1490050,-128133,181407
337,BARD C R INC,189.439553373,702868,202.66884455,1137496,235.161189639,1294376,224.280478045,1053373,434628,156880
338,BARNES & NOBLE ED INC,9.95120157503,130537,9.79668666645,93501,10.1509812615,85706,9.56952801407,318929,-37036,-7795
339,BARNES & NOBLE INC,8.71005557312,249941,12.3617334218,381419,11.3488750404,418015,11.3011145287,417127,131478,36596
340,BARNES GROUP INC,35.3903234748,1406910,35.030369278,1357622,33.1194356381,1243741,40.5497999665,1266788,-49288,-113881
341,BARRETT BILL CORP,3.92921212121,515625,6.2201446704,293080,6.38937478397,286413,5.5594724566,395721,-222545,-6667
342,BARRETT BUSINESS SERVICES IN,43.5207823961,6135,28.7482806052,7270,41.3353279269,12701,49.6075185561,18727,1135,5431
343,BARRICK GOLD CORP,7.37983886881,4743464,13.5797927489,3172287,21.3499209485,5984706,17.7198168925,4914272,-1571177,2812419
344,BASIC ENERGY SVCS INC NEW,2.68040062885,1334502,2.76176381346,161491,1.68235822736,191398,0.828807733993,172537,-1173011,29907
345,BAXTER INTL INC,38.1499123249,2952379,41.0802628664,2437740,45.220156909,3019074,47.6002388645,5015395,-514639,581334
346,BAYTEX ENERGY CORP,3.24078881874,279253,3.9695937305,195486,5.79070439558,190305,4.2539151338,84863,-83767,-5181
347,BAZAARVOICE INC,4.37904315064,70335,3.14827279241,46057,4.0002400144,49997,5.90905700189,375356,-24278,3940
348,BB&T CORP,37.8102235213,2088615,33.269639232,2683137,35.6103728942,3301875,37.7200636914,3445991,594522,618738
349,BBVA BANCO FRANCES S A,19.0799700269,663261,19.9707245072,653106,20.6301690675,650746,19.8904841317,626028,-10155,-2360
350,BCE INC,38.6202540993,1814566,45.5398492348,2410636,47.3097421307,2418783,46.1812389186,799762,596070,8147
351,BE AEROSPACE INC,42.3696861945,2983855,46.1198898373,1279925,46.174875944,1109781,51.6595755116,1223355,-1703930,-170144
352,BEACON ROOFING SUPPLY INC,41.1801662072,1426172,41.0102102484,1571950,45.4703137843,1654640,42.0693871,1464105,145778,82690
353,BEASLEY BROADCAST GROUP INC,3.57524012807,18740,3.52832685137,24941,4.2101645401,23277,5.83221175415,11145,6201,-1664
354,BEAZER HOMES USA INC,11.4891203795,530763,8.7205869653,567393,7.75044359037,736603,11.6598862843,534139,36630,169210
355,BEBE STORES INC,0.562703264633,104851,0.557180665831,100506,0.50562714076,183930,0.7023810172,183661,-4345,83424
356,BECTON DICKINSON & CO,154.09035982,426185,151.819315433,535696,169.590708858,445844,179.729863181,445552,109511,-89852
357,BED BATH & BEYOND INC,48.249805661,1749520,49.6395513096,1851165,43.2200793601,1916077,43.1100671766,1891136,101645,64912
358,BELDEN INC,47.6724258722,92779,61.3805685117,111273,60.373367666,152236,68.9880035962,259161,18494,40963
359,BELLATRIX EXPLORATION LTD,1.20908848445,393685,1.00952243005,1366983,0.989005325306,717893,0.854592446734,480931,973298,-649090
360,BELMOND LTD,9.50317682827,54929,9.48811937283,146499,9.90922990575,51669,12.7094383013,424409,91570,-94830
361,BEMIS INC,44.6896372283,983897,51.7801628456,1151889,51.490025818,1069411,51.0101163746,2991289,167992,-82478
362,BENCHMARK ELECTRS INC,20.6721199764,371273,23.0504488175,370752,21.1492907126,440724,24.9482747113,449490,-521,69972
363,BENEFICIAL BANCORP INC,13.322585373,68230,13.6905951284,155143,12.7223212394,320932,14.7084583854,342524,86913,165789
364,BENEFITFOCUS INC,36.3900312449,6242946,33.349960099,6242946,38.120078806,6274646,39.920020986,6274646,0,31700
365,BERKLEY W R CORP,54.7501113704,3400815,56.2000359941,3428343,59.9202520801,3201839,57.7597639452,2145265,27528,-226504
366,BERKSHIRE HATHAWAY INC DEL,136.315539318,3235882,145.830415624,3941448,149.552435899,3642495,148.716420257,4579770,705566,-298953
367,BERKSHIRE HILLS BANCORP INC,29.1107644306,32050,26.9339456023,11324,26.9250241635,65181,27.7098766584,160773,-20726,53857
368,BERRY PLASTICS GROUP INC,36.1803328412,2380354,36.1499530237,3169686,38.8499086661,2387393,43.8499165419,2862514,789332,-782293
369,BEST BUY INC,30.4499201358,2630089,32.4398786341,4006396,30.6001100423,2635350,38.1799133562,3884870,1376307,-1371046
370,BGC PARTNERS INC,9.80999260952,1235373,9.05033727787,1220507,8.70941400717,890301,8.7511160281,412176,-14866,-330206
371,BHP BILLITON LTD,25.7595715875,1856902,25.9001641323,1667557,28.5598944679,1748851,34.6499427966,1576828,-189345,81294
372,BHP BILLITON PLC,22.6480129765,246600,22.7289953698,303445,25.3808483462,405542,30.3800352535,315997,56845,102097
373,BIG LOTS INC,38.5374059621,351321,45.2908389063,1160058,50.1090247693,660859,47.7500569535,803287,808737,-499199
374,BIGLARI HLDGS INC,326.059850374,1604,371.921182266,1218,403.409090909,1056,435.947204969,5152,-386,-162
375,BIO PATH HOLDINGS INC,1.25177634245,194923,2.5920062328,200231,2.01399194403,18868,1.41674744613,26822,5308,-181363
376,BIO RAD LABS INC,138.648739162,80621,136.721753367,110553,143.012514099,74476,163.809582065,65393,29932,-36077
377,BIO TECHNE CORP,90.0026326181,121552,94.5205130977,314482,112.767197228,293463,109.499234235,293171,192930,-21019
378,BIOCRYST PHARMACEUTICALS,10.3198325764,1082285,2.83008651886,1237418,2.84011587324,1146080,4.41041012911,896742,155133,-91338
379,BIODEL INC,0.330223726575,24226,0.331643530582,21107,0.293754773515,17021,0.41336955238,16934,-3119,-4086
380,BIODELIVERY SCIENCES INTL IN,4.7892943359,128829,3.23012454895,103092,2.35941801022,188182,2.69999061501,138519,-25737,85090
381,BIOGEN INC,306.350185877,1541073,260.321018782,1438109,241.819089307,1131995,313.030908131,1157333,-102964,-306114
382,BIOLASE INC,0.841897462695,34446,1.31124729053,37369,1.1834970963,36333,1.74815154468,34894,2923,-1036
383,BIOMARIN PHARMACEUTICAL INC,104.760966271,1065540,82.4806616551,844307,77.8005565352,690702,92.5198978826,1331800,-221233,-153605
384,BIOSCRIP INC,1.74810481905,118986,2.13564213564,69300,2.54913609118,318147,2.89760703239,61430,-49686,248847
385,BIOSPECIFICS TECHNOLOGIES CO,42.982044361,34084,34.8090073096,33928,39.9484536082,36472,45.6764139537,44662,-156,2544
386,BIOTELEMETRY INC,11.6646598435,13288,11.7114934173,12381,16.2841056735,11545,18.5698180061,62090,-907,-836
387,BITAUTO HLDGS LTD,28.2860968534,17924,24.8007401082,28104,26.9561505153,16397,29.0751815905,48323,10180,-11707
388,BJS RESTAURANTS INC,43.4674946189,209996,41.5728842943,203041,43.8273376239,170761,35.5459347419,119648,-6955,-32280
389,BLACK BOX CORP DEL,9.54722985679,20739,13.4758907891,42743,13.0842338237,92172,13.9075704896,39403,22004,49429
390,BLACK DIAMOND INC,4.41752760955,14035,4.52768855694,25841,4.12826420891,41664,5.14900471752,34764,11806,15823
391,BLACK HILLS CORP,46.4302954476,1116577,60.1298352436,1116800,63.0407052434,1065391,61.2716899155,1103854,223,-51409
392,BLACK KNIGHT FINL SVCS INC,33.0599556829,5706148,31.0300215849,5317141,37.6001350817,4601659,40.9000283318,3794325,-389007,-715482
393,BLACK STONE MINERALS L P,14.4301047017,479553,14.0095991698,508794,15.5005242506,462565,17.8091600528,513949,29241,-46229
394,BLACKBAUD INC,65.8507434144,104585,62.8863794617,165155,67.8960743663,119624,66.3423228299,123737,60570,-45531
395,BLACKBERRY LTD,9.28025762244,3507769,8.090120188,1946201,6.70991200158,1147407,7.97988269152,784598,-1561568,-798794
396,BLACKHAWK NETWORK HLDGS INC,44.2015811948,47306,34.3018858718,163956,33.4918988519,139795,30.1685253569,486633,116650,-24161
397,BLACKROCK CAPITAL INVESTMENT,9.41763945772,45659,9.41256714127,58645,7.7680329336,55870,8.28413486384,63857,12986,-2775
398,BLACKROCK CR ALLCTN INC TR,12.3777373842,11553,12.5361620058,15555,13.0312024904,13813,13.3817625693,10462,4002,-1742
399,BLACKROCK ENH CAP & INC FD I,14.1644908616,15320,13.5254151988,15896,13.421668856,17509,13.7850315365,15379,576,1613
400,BLACKROCK ENHANCED EQT DIV T,7.6229269712,17185,7.53230198737,17259,7.8768673608,22090,7.86516853933,16020,74,4831
401,BLACKROCK GLOBAL OPP EQTY TR,12.7557018575,17012,11.8739713144,17012,11.872575526,17014,12.2369981894,16017,0,2
402,BLACKROCK INC,340.518912879,608580,340.572077062,331319,342.529696304,366123,362.462054227,347206,-277261,34804
403,BLACKROCK RES & COMM STRAT T,7.10921934432,22084,7.23910550459,13952,7.70836678979,24908,8.15709969789,26480,-8132,10956
404,BLACKSTONE GROUP L P,29.2401186644,3814793,28.0499832445,5663818,24.5400681728,5110540,25.5299485835,5754379,1849025,-553278
405,BLACKSTONE MTG TR INC,26.7600037751,4291255,26.8601605936,4138769,27.6699620288,3916919,29.450015875,2815754,-152486,-221850
406,BLDRS INDEX FDS TR,23.120961203,81398,22.6786898941,81398,22.6541192658,81398,34.8565939344,21861,0,0
407,BLOCK H & R INC,33.3098636694,1856297,26.4203154859,1319742,22.9998848601,1815183,23.1496985934,2245472,-536555,495441
408,BLOOMIN BRANDS INC,16.8897429473,2318863,16.8699046785,2841332,17.8697113126,1383850,17.2391447946,956776,522469,-1457482
409,BLUCORA INC,9.80150672258,332908,5.15935214211,168432,10.3617452738,76435,11.2064905596,93428,-164476,-91997
410,BLUE BUFFALO PET PRODS INC,18.7099188895,3980990,25.6598958447,4840082,23.3400063183,4792458,23.7598747492,5473177,859092,-47624
411,BLUEBIRD BIO INC,64.2211145944,266034,42.4992617384,406360,43.2921088944,155086,67.782267907,184355,140326,-251274
412,BMC STK HLDGS INC,16.7509103756,91995,16.6192543794,153617,17.817899644,168819,17.7298321487,373664,61622,15202
413,BNC BANCORP,25.3804859478,338843,21.1199392313,784614,22.7097540945,1070289,24.3200947426,1300365,445771,285675
414,BOARDWALK PIPELINE PARTNERS,12.9799846164,7934447,14.7399166347,5503966,17.4500624346,4677691,17.1600416205,4507390,-2430481,-826275
415,BOB EVANS FARMS INC,38.8492327702,64583,46.6891901948,201567,37.9473088875,230741,38.3028110119,292955,136984,29174
416,BOEING CO,144.589980457,4435252,126.939858047,2793890,129.86973929,4555326,131.739948783,4170117,-1641362,1761436
417,BOFI HLDG INC,21.0444058772,110053,21.3364154043,154009,17.7118731336,184509,22.3914736829,80879,43956,30500
418,BOINGO WIRELESS INC,6.60934981193,18610,7.72395590747,25764,8.93108478133,39077,10.2597174181,17057,7154,13313
419,BOK FINL CORP,59.7874043816,171123,54.6176583407,221595,62.7014108396,259420,68.9675147613,241679,50472,37825
420,BON-TON STORES INC,2.09929482503,659269,2.27270421363,98561,1.40948381251,69529,1.70561394813,68597,-560708,-29032
421,BONANZA CREEK ENERGY INC,5.27036446923,401680,1.58917294637,599683,2.00985917406,662733,1.01955649293,600261,198003,63050
422,BOOT BARN HLDGS INC,12.2904293546,1567073,9.39994829329,1930117,8.61993935166,1447690,11.3799135687,1476549,363044,-482427
423,BOOZ ALLEN HAMILTON HLDG COR,30.8505687694,386800,30.2779813818,309697,29.6401779658,400976,31.6097071173,466091,-77103,91279
424,BORGWARNER INC,43.2299761901,8172246,38.4003197978,7119498,29.5202094094,1763436,35.17972813,1686909,-1052748,-5356062
425,BOSTON BEER INC,201.882210079,23058,185.064371055,51809,171.026601364,104130,155.258311196,117823,28751,52321
426,BOSTON PRIVATE FINL HLDGS IN,11.3402087816,2779843,11.4503647858,2711180,11.7800611585,2674689,12.8300295746,2803423,-68663,-36491
427,BOSTON PROPERTIES INC,127.541007053,1132671,127.080252587,1043443,131.899708348,1138001,136.290493477,1590287,-89228,94558
428,BOSTON SCIENTIFIC CORP,18.4401713893,4853046,18.809991707,3627168,23.3700389503,6587366,23.799965846,5609882,-1225878,2960198
429,BOTTOMLINE TECH DEL INC,29.7303945843,939039,30.4901165584,888911,21.5300452839,1249231,23.3104653452,1249782,-50128,360320
430,BOULDER GROWTH & INCOME FD I,7.73947649667,677436,7.84942956721,554053,8.12989879716,534570,8.38085033102,365834,-123383,-19483
431,BOX INC,13.9650964344,54493,12.2560699928,81837,10.3291557637,36305,15.7555869004,104217,27344,-45532
432,BOYD GAMING CORP,19.871169983,261585,20.6600865263,231606,18.3997841366,466962,19.7794009392,665642,-29979,235356
433,BP PLC,31.2601325059,7281639,30.1799347429,10050088,35.5099995797,7542467,35.1600887964,7046683,2768449,-2507621
434,BRADY CORP,23.0009337986,20347,26.8389021112,356721,30.5596049847,425300,34.6096280576,447650,336374,68579
435,BRANDYWINE RLTY TR,13.6601224328,5789626,14.0299504749,5878638,16.8000077958,6464997,15.6198755896,5387815,89012,586359
436,BRASKEM S A,13.5399685879,268686,12.9137684198,69151,11.847605061,70816,15.3817265714,63907,-199535,1665
437,BRF SA,13.8199380175,1022870,14.2181971326,277813,13.9294991119,937435,17.0624385961,382712,-745057,659622
438,BRIDGEPOINT ED INC,7.60392689213,101658,10.0760794891,117903,7.23863170105,197413,6.86914561453,193765,16245,79510
439,BRIGGS & STRATTON CORP,17.3052130508,60502,23.9163373838,134636,21.1760356983,75746,18.6490397778,127835,74134,-58890
440,BRIGHT HORIZONS FAM SOL IN D,66.7993451674,93459,64.7808830244,85411,66.3071517072,196932,66.8895240389,340427,-8048,111521
441,BRIGHTCOVE INC,6.20022920279,34031,6.23629719854,41050,8.80350022935,56682,13.0465279401,128310,7019,15632
442,BRINKER INTL INC,47.9499470235,686153,45.9494251141,796245,45.5308368977,701854,50.430130297,552507,110092,-94391
443,BRINKS CO,28.8690004752,50504,33.5892387584,151358,28.4884311276,226513,37.0816229212,299879,100854,75155
444,BRISTOL MYERS SQUIBB CO,68.7901583185,4987603,63.8800438581,5249652,73.5499385011,5933438,53.9201112296,6831273,262049,683786
445,BRISTOW GROUP INC,25.8925415341,33948,18.9248578007,95113,11.4103402054,90269,14.0203636837,30741,61165,-4844
446,BRITISH AMERN TOB PLC,110.451212051,251722,116.908248795,266645,129.477175474,270148,127.650278749,276952,14923,3503
447,BRIXMOR PPTY GROUP INC,25.819924287,10330588,25.6199258201,8535739,26.4600115113,14969608,27.790025957,12101572,-1794849,6433869
448,BROADRIDGE FINL SOLUTIONS IN,53.7301066279,1069326,59.3105323947,1117761,65.2003700867,1532614,67.7897571399,1483941,48435,414853
449,BROADSOFT INC,35.3690054561,20894,40.362225097,27055,41.0219503418,22232,46.550997048,165990,6161,-4823
450,BROCADE COMMUNICATIONS SYS I,9.18003405297,27390857,10.5799737178,21877181,9.17996212654,16587868,9.22999471272,17634788,-5513676,-5289313
451,BROOKDALE SR LIVING INC,18.4599488875,1093665,15.8800931164,1765103,15.4405326547,1134093,17.4502889277,1927991,671438,-631010
452,BROOKFIELD ASSET MGMT INC,31.5303262308,1737819,34.7904654461,1807363,33.0696430491,1367387,35.17998232,799773,69544,-439976
453,BROOKFIELD INFRAST PARTNERS,37.9106992418,28488,42.1212121212,6600,45.2912175148,11967,34.6648742078,10414,-21888,5367
454,BROOKFIELD PPTY PARTNERS L P,23.2409036146,425801,23.1805100613,266517,22.4607000329,279644,22.9192164137,263098,-159284,13127
455,BROOKFIELD RENEWABLE ENRGY P,26.1831577996,88492,29.9447858224,89832,29.7928285163,94318,30.7550462643,91107,1340,4486
456,BROOKLINE BANCORP INC DEL,11.5002302391,2132566,11.0100411468,2245859,11.0298122744,2221434,12.1900412733,2292281,113293,-24425
457,BROWN & BROWN INC,32.0937778685,93071,35.7999908632,372123,37.4692144769,858358,37.7099402747,873165,279052,486235
458,BROWN FORMAN CORP,99.3517726545,2444667,98.5315422099,2277900,99.8900579669,1081479,47.4650049837,2918487,-166767,-1196421
459,BRUKER CORP,24.2702480262,653681,28.0001211674,957353,22.7401555979,1070837,22.6501169756,1914074,303672,113484
460,BRUNSWICK CORP,50.5077983315,143364,47.9793782037,439147,45.3190058001,439992,48.7797448497,1050518,295783,845
461,BRYN MAWR BK CORP,28.7446046469,10889,25.6835128418,9656,29.2272874232,15465,31.9919299636,27757,-1233,5809
462,BT GROUP PLC,34.61011531,525540,32.0791805044,548923,27.8497852818,408908,25.4292025928,523296,23383,-140015
463,BUCKEYE PARTNERS L P,65.9598978675,5138031,67.9400691948,5967215,70.3299364176,5798299,71.5999913979,5161509,829184,-168916
464,BUCKLE INC,30.7813733228,54481,33.8879200641,21217,25.9932933645,49205,24.0164920117,29105,-33264,27988
465,BUFFALO WILD WINGS INC,159.648955191,73267,148.118230713,148557,138.95308642,101250,140.736763081,191812,75290,-47307
466,BUILDERS FIRSTSOURCE INC,11.074168798,78200,11.2703790577,172665,11.2440871611,38687,11.5101329539,797645,94465,-133978
467,BUNGE LIMITED,68.2796588372,828109,56.6692772772,560533,59.150009588,1011682,59.2316246096,1053964,-267576,451149
468,BURLINGTON STORES INC,42.8998700182,2729612,56.2399654995,3079376,66.7099172501,2637344,81.0201216179,3316781,349764,-442032
469,BWX TECHNOLOGIES INC,31.7683416172,225539,33.5583684112,335207,35.7706231128,945832,38.3693236038,881303,109668,610625
470,C D I CORP,6.76255261426,50129,6.27702901289,95268,6.10470413662,76826,5.67552187846,66778,45139,-18442
471,C H ROBINSON WORLDWIDE INC,62.0196712152,1703911,74.2303981987,955754,74.2499004874,1331490,70.4602720851,1622801,-748157,375736
472,CA INC,28.5600002479,5485119,30.7900628999,4870435,32.8300155224,5112608,33.0801718322,5302149,-614684,242173
473,CABELAS INC,46.7295948388,525149,48.6887320695,515951,50.0612367181,569103,54.9307032835,546707,-9198,53152
474,CABLE ONE INC,433.623729517,9642,437.154696133,20272,511.415211113,14542,583.968236935,9319,10630,-5730
475,CABOT CORP,40.8777598277,185700,48.325333564,208131,45.6586000074,326116,52.4101363039,841135,22431,117985
476,CABOT MICROELECTRONICS CORP,43.7804740925,684803,40.9092862361,698130,42.3394284025,690066,52.9101453021,572669,13327,-8064
477,CABOT OIL & GAS CORP,17.6899985013,3963426,22.7099756931,4610617,25.7400855325,4132698,25.8000669522,4092470,647191,-477919
478,CACI INTL INC,92.7719122884,16007,106.70141435,189557,90.4129485162,181766,100.896993381,186289,173550,-7791
479,CADENCE DESIGN SYSTEM INC,20.8098012168,3857317,23.5800052708,7072984,24.3001955401,3934742,25.5301806902,3538322,3215667,-3138242
480,CAE INC,11.090638119,454257,11.5793337084,828286,12.0898167241,772551,14.2388408435,259361,374029,-55735
481,CAESARS ACQUISITION CO,6.80994776793,1334812,6.12022002999,1355997,11.2202872694,1357541,12.4196454192,1352132,21185,1544
482,CAESARS ENTMT CORP,7.88311527508,24229,6.80000603858,2119704,7.69000072589,5234980,7.44995989548,4693985,2095475,3115276
483,CAESARSTONE SDOT-YAM LTD,43.3378431458,45826,34.3500553849,87569,34.7681028995,45559,37.7030288535,45991,41743,-42010
484,CAL MAINE FOODS INC,46.3418552211,168077,51.9103112553,203370,44.3227578605,112493,38.538063355,121127,35293,-90877
485,CALAMOS ASSET MGMT INC,9.68833897514,17134,8.49317295189,73824,7.32183534006,61460,6.81134561364,40227,56690,-12364
486,CALATLANTIC GROUP INC,37.9200125773,1806434,33.420070441,1750116,36.7097925592,2336570,33.4401192468,2203162,-56318,586454
487,CALERES INC,26.8275729476,67617,28.2893855248,67163,24.2080529125,137888,25.2887262935,181227,-454,70725
488,CALGON CARBON CORP,17.2422614479,19545,14.0058629194,21491,13.1419328751,54406,15.1669826455,27428,1946,32915
489,CALIFORNIA RES CORP,2.32999194621,2925332,1.03005784102,5602598,12.1981659341,368580,12.5001405647,444635,2677266,-5234018
490,CALIFORNIA WTR SVC GROUP,23.2731378745,127529,26.7199762425,1104492,34.9305407458,1336395,32.0904133964,1135230,976963,231903
491,CALIX INC,7.87024511661,369620,7.09253524627,358123,6.91099029043,374476,7.34990980014,380821,-11497,16353
492,CALLAWAY GOLF CO,9.414177905,130654,9.1175185092,377515,10.2122590427,277020,11.6097427138,903896,246861,-100495
493,CALLIDUS SOFTWARE INC,18.5655517796,55910,16.6792823659,75303,19.9789213215,65469,18.3513564945,241726,19393,-9834
494,CALLON PETE CO DEL,8.3409634877,498024,8.84973662623,741152,11.2298219889,1086393,15.7000212752,2110443,243128,345241
495,CALPINE CORP,14.4700929277,7785299,15.1699584589,13218230,14.7507905522,1401552,12.6396809713,1628443,5432931,-11816678
496,CALUMET SPECIALTY PRODS PTNR,19.9091926281,216282,11.7526084007,185746,4.8994836867,136545,4.51005440598,308422,-30536,-49201
497,CAMBREX CORP,47.0920451814,83220,43.9973325092,61481,51.7239477023,90635,44.4617211057,190366,-21739,29154
498,CAMDEN PPTY TR,76.7600281433,1913066,84.0900702048,2164667,88.4197609417,1892258,83.7401270975,1540707,251601,-272409
499,CAMECO CORP,12.3289100421,1006415,12.8401590497,1497645,10.9705517751,1213248,8.56308815355,257267,491230,-284397
500,CAMPBELL SOUP CO,52.5509896468,879051,63.7904474647,988659,66.5297478123,905159,54.7001912755,1692846,109608,-83500
501,CANADIAN NAT RES LTD,21.8304235842,2087637,26.9998471492,2721608,30.8302138747,1659476,32.0399272692,937705,633971,-1062132
502,CANADIAN NATL RY CO,55.8800748908,1763634,62.4600725985,1964503,59.0600542978,1205942,65.3980621317,600660,200869,-758561
503,CANADIAN PAC RY LTD,127.60060445,418893,132.691505407,467415,128.78917233,439245,152.700838803,445158,48522,-28170
504,CANADIAN SOLAR INC,28.9605549143,363011,19.2795348178,705100,15.1218928301,25063,13.743317759,47514,342089,-680037
505,CANON INC,30.1293997595,208733,29.8224450037,288474,28.6090963702,248033,29.0303279088,287458,79741,-40441
506,CANTEL MEDICAL CORP,62.1355628914,97239,71.3655403519,89525,68.7218253693,144190,77.983859427,230599,-7714,54665
507,CAPELLA EDUCATION COMPANY,46.2323861121,38393,52.6435474702,35180,52.6289206526,59397,58.0422595947,69570,-3213,24217
508,CAPITAL BK FINL CORP,31.9982956966,23470,30.8701215611,18756,28.8096637982,18709,32.1266968326,8840,-4714,-47
509,CAPITAL ONE FINL CORP,72.1802583546,2308997,69.3100725084,1953843,63.5099459003,4210931,71.830205116,5341221,-355154,2257088
510,CAPITAL PRODUCT PARTNERS L P,5.52003910515,5472425,3.15992211311,472480,2.98016086628,512724,3.2602017933,795963,-4999945,40244
511,CAPITAL SR LIVING CORP,20.8602337377,333793,18.5202622538,371701,17.6697312747,445734,16.8005892895,445282,37908,74033
512,CAPITOL FED FINL INC,12.5563320489,122488,13.2527149342,109487,13.9503030564,185444,14.0700624337,222316,-13001,75957
513,CAPRICOR THERAPEUTICS INC,3.07782370368,112742,2.53795352025,107961,3.9490132202,105596,3.24260002975,100845,-4781,-2365
514,CAPSTEAD MTG CORP,8.74016139156,442898,9.88849952214,156950,9.70186820096,494647,9.43130828633,142186,-285948,337697
515,CARBO CERAMICS INC,17.1905493502,24083,14.1978539649,15284,13.0964789052,44134,10.9565026843,9127,-8799,28850
516,CARBYLAN THERAPEUTICS INC,3.62258998668,90819,0.643938099956,585460,0.659375163536,95545,0.460839146191,95478,494641,-489915
517,CARDINAL FINL CORP,22.7518036698,35206,20.3482210447,33025,21.9462057384,34539,26.0915042808,206504,-2181,1514
518,CARDINAL HEALTH INC,89.2697779668,3069135,81.9495305736,1907967,78.0096848202,1926107,77.7002386616,1974344,-1161168,18140
519,CARE CAP PPTYS INC,30.5700562687,2267513,26.8399719072,5138679,26.2100507565,6059126,28.4998623855,6881542,2871166,920447
520,CAREDX INC,6.39500756897,64738,4.95557074504,58520,4.30357769528,54141,3.55014844188,48167,-6218,-4379
521,CAREER EDUCATION CORP,3.63445186066,43748,4.55505677317,30296,5.94177064765,35343,6.792365796,86715,-13452,5047
522,CARETRUST REIT INC,10.9381237525,25050,12.6976744186,43000,13.7939604822,16094,14.7779284056,74503,17950,-26906
523,CARLISLE COS INC,88.6897067203,816115,99.5013436628,682835,105.679270716,825687,102.569997833,830740,-133280,142852
524,CARLYLE GROUP L P,15.6193428211,610397,16.8801803299,1708868,16.2301694662,1796346,15.5701192852,1655864,1098471,87478
525,CARMAX INC,53.9700657555,1578727,51.0997631466,1650810,49.0302437327,2160646,53.3504654373,1828925,72083,509836
526,CARMIKE CINEMAS INC,22.9394562209,842217,30.0364574799,97648,30.1224199529,118118,32.6909567573,414243,-744569,20470
527,CARNIVAL CORP,54.4799600545,4702408,52.770107704,3096450,44.2000044046,3087692,48.8200868416,3681415,-1605958,-8758
528,CARNIVAL PLC,56.9212833899,295935,54.2919531103,191428,44.7889101848,172699,49.0813983159,156760,-104507,-18729
529,CARPENTER TECHNOLOGY CORP,30.2715222831,354888,34.2287386997,309506,32.9253750078,79665,41.2614787985,136665,-45382,-229841
530,CARRIZO OIL & GAS INC,29.5799137137,2244158,30.919964618,1552201,35.8497410819,1527124,40.6200934585,1606274,-691957,-25077
531,CARTER INC,89.0299463973,1392655,105.380237115,724206,106.468364551,515308,86.7094845663,772107,-668449,-208898
532,CARVER BANCORP INC,3.75069738666,181033,5.22004275464,181033,3.71755425806,181033,5.12061336883,181033,0,0
533,CASCADE BANCORP,6.07122738937,15977,5.70898980538,26975,5.5405597386,21117,6.04316546763,20850,10998,-5858
534,CASELLA WASTE SYS INC,5.96985591274,81409,6.70424666971,103069,7.8468637036,204158,10.2976022714,191598,21660,101089
535,CASEYS GEN STORES INC,120.449763442,164442,113.320278044,360518,131.509664446,226759,120.150417316,643277,196076,-133759
536,CASTLE A M & CO,1.59789453896,42556,2.70149432308,158801,1.64590330653,74731,0.80687265651,63207,116245,-84070
537,CASTLE BRANDS INC,1.21107266436,28900,0.940881292144,70147,0.734305042011,153887,0.874988364516,161145,41247,83740
538,CATALENT INC,25.0296637202,659897,26.6692934012,923834,22.9901544681,1952053,25.84003547,3008742,263937,1028219
539,CATALYST BIOSCIENCES INC,3.12653030474,53094,1.68121695801,49369,1.52405834966,50523,1.19954840531,42516,-3725,1154
540,CATALYST PHARMACEUTICALS INC,2.43753808653,27897,1.16832752442,101855,0.711999029572,189607,1.08996539792,173400,73958,87752
541,CATERPILLAR INC DEL,67.9593202331,1957730,76.5394640329,2216778,75.8100726717,2067654,88.7702123435,2699588,259048,-149124
542,CATHAY GEN BANCORP,31.3322019516,377120,28.3288259024,264748,28.2000141299,368014,30.7771158476,316079,-112372,103266
543,CATO CORP NEW,36.8206659612,206949,38.547925064,197235,37.7216396568,209800,32.8897167411,344667,-9714,12565
544,CAVCO INDS INC DEL,83.3125135329,60039,93.4538241128,31759,93.6952454489,33673,99.0660834614,8459,-28280,1914
545,CAVIUM INC,65.7053938088,54303,61.1597060893,1543598,38.599975643,1863939,58.1999026434,1840656,1489295,320341
546,CBIZ INC,9.86551742043,38518,10.0992700101,46439,10.4152283263,50695,11.1908895847,131893,7921,4256
547,CBL & ASSOC PPTYS INC,12.3699963317,7472193,11.899957301,8032970,9.30999642085,8080132,12.1401289677,5130588,560777,47162
548,CBOE HLDGS INC,64.8998195363,864440,65.3299926521,830170,66.6193317954,740821,64.8499719658,829345,-34270,-89349
549,CBRE GROUP INC,34.5798425704,1737920,28.8201854615,688337,26.4795015395,824940,27.9783804607,768379,-1049583,136603
550,CBS CORP NEW,47.1297584954,4605710,55.0899793842,3968798,54.440011545,3461241,54.7402824688,2665569,-636912,-507557
551,CDK GLOBAL INC,47.4684756148,365590,46.5497646313,824451,55.4919816632,436063,57.3616571797,408984,458861,-388388
552,CDN IMPERIAL BK COMM TORONTO,65.8704322899,226399,74.7091374199,840861,75.0701165196,1303901,77.5302918922,1262384,614462,463040
553,CDW CORP,42.0400264009,1698429,41.5000487151,954529,40.0797718312,825354,45.7294415469,596093,-743900,-129175
554,CEB INC,61.38819673,75047,64.7462007819,61131,61.6765757402,101254,54.4715200437,164765,-13916,40123
555,CECO ENVIRONMENTAL CORP,7.679892123,1355618,6.20888047722,410541,8.73268287424,18551,11.2853344908,36862,-945077,-391990
556,CEDAR FAIR L P,55.8394712496,899328,59.4492648316,374336,57.8204667709,698801,57.2897810812,541388,-524992,324465
557,CEDAR REALTY TRUST INC,7.07939305876,209905,7.23006739996,165282,7.42651019309,122534,7.19904112668,133490,-44623,-42748
558,CELANESE CORP DEL,67.3299508251,2738796,65.4999831031,2633619,65.449935086,2464800,66.5602463221,2447527,-105177,-168819
559,CELESTICA INC,11.026921897,172759,10.9802238952,205096,9.29577314471,187397,10.8260140136,101330,32337,-17699
560,CELGENE CORP,119.759959511,3250285,100.089979946,3599691,98.6302956976,4522728,104.529792548,4201252,349406,923037
561,CELLDEX THERAPEUTICS INC NEW,15.6798033177,299366,3.78057145902,450461,4.38918863773,431287,4.0388824817,212435,151095,-19174
562,CEMEX SAB DE CV,5.57009517244,1351862,7.27952080814,1329071,6.17009556843,1711967,7.94011305764,2124403,-22791,382896
563,CEMPRA INC,31.1299467118,1549312,17.520572454,1121767,16.4890886121,866755,24.2003807473,902961,-427545,-255012
564,CENOVUS ENERGY INC,12.6198812301,1504927,13.0000229572,2395765,13.819781618,3520895,14.3697353337,1003150,890838,1125130
565,CENTENE CORP DEL,65.8101724778,921742,61.5700448294,2360060,71.3698456981,2808455,66.9600317897,2959452,1438318,448395
566,CENTERPOINT ENERGY INC,18.3601719575,4050071,20.9198762978,4947687,23.9999739962,5845298,23.2300582933,5786942,897616,897611
567,CENTERSTATE BANKS INC,15.6493612883,189209,14.888337469,170066,15.7499516221,635621,17.7291386291,710356,-19143,465555
568,CENTRAL EUROPEAN MEDIA ENTRP,2.68576544315,14521,2.57155635063,17888,2.11271952105,210629,2.31375985977,57050,3367,192741
569,CENTRAL FD CDA LTD,9.9857204198,100143,11.9928502242,100143,13.9001228244,100143,13.8302227814,100143,0,0
570,CENTRAL FED CORP,1.33813215209,21672,1.34661998384,22278,1.36261202243,19081,1.43122183939,18865,606,-3197
571,CENTRAL GARDEN & PET CO,13.5806151633,113986,16.3077664709,170103,22.1889200425,206860,25.0506658276,216122,56117,36757
572,CENTRAL PAC FINL CORP,22.0200854686,289463,21.771385759,204213,23.6005541464,243257,25.190532024,218336,-85250,39044
573,CENTURY ALUM CO,4.40771349862,38115,7.05057643226,493293,6.33454820561,166547,6.94781304338,267998,455178,-326746
574,CENTURYLINK INC,25.1597578998,3877899,31.9600677696,3388541,29.00984773,3926184,27.4300493244,3580380,-489358,537643
575,CEPHEID,36.5299195648,4046984,33.3599661118,2695926,30.7497975814,1850126,52.6899963639,1465857,-1351058,-845800
576,CERNER CORP,60.170196399,6239850,52.9599481542,6243133,58.5999044993,5704668,61.749774418,5663130,3283,-538465
577,CERUS CORP,6.31967402168,65035,5.9265781631,59056,6.24494994453,73019,6.20159969469,62887,-5979,13963
578,CF INDS HLDGS INC,40.8098574725,4687936,31.3398541998,3486551,24.1002064615,2787445,24.3501736127,2477354,-1201385,-699106
579,CHARLES & COLVARD LTD,1.09804934763,15482,1.16438356164,14600,1.03612301606,21233,1.1341252313,16753,-882,6633
580,CHARLES RIV LABS INTL INC,80.3889039544,376134,75.9399461055,545510,82.439408362,655536,83.3402337922,712513,169376,110026
581,CHART INDS INC,17.9351575075,8698,21.7175723919,141176,24.1191702307,34371,32.8274396722,131780,132478,-106805
582,CHATHAM LODGING TR,20.4918032787,19520,21.4346550582,21134,21.9713614668,39597,19.2521843413,46696,1614,18463
583,CHECK POINT SOFTWARE TECH LT,81.3798252697,492874,87.4697595445,1566610,79.6796081346,2098680,77.6099226064,2219175,1073736,532070
584,CHEESECAKE FACTORY INC,46.1096235628,355544,53.0880681039,474099,48.1402667466,500475,50.0595594964,507056,118555,26376
585,CHEETAH MOBILE INC,16.0220994475,161090,16.3204747774,35048,9.49929662198,609203,12.4505356626,10361,-126042,574155
586,CHEGG INC,6.73184805257,99824,4.46439088746,84894,4.99890648921,96021,7.08845710889,134585,-14930,11127
587,CHEMED CORP NEW,149.793840555,43413,135.45460221,48053,136.313071116,50340,141.08175285,74028,4640,2287
588,CHEMICAL FINL CORP,34.2774517309,11757,35.6949702542,72111,37.2858435936,183394,44.1304317046,353135,60354,111283
589,CHEMOCENTRYX INC,8.07654714749,19439,2.48823335432,66714,4.48669066662,56389,6.05054314178,35534,47275,-10325
590,CHEMOURS CO,5.3593729579,1101808,6.99958861667,658753,8.24049559493,1081367,16.0000742032,1509368,-443055,422614
591,CHEMTURA CORP,27.273295754,111941,26.3992179266,471567,26.3802486759,493172,32.8093604591,1038667,359626,21605
592,CHENIERE ENERGY INC,37.2494114663,1434922,33.8299998756,9645640,37.5500128246,4920238,43.6000448165,6310177,8210718,-4725402
593,CHENIERE ENERGY PARTNERS LP,26.0694420633,880763,28.8403260175,1209383,29.9801127476,1253064,29.2597943348,1596867,328620,43681
594,CHENIERE ENERGY PTNRS LP HLD,17.4153026266,21016,18.0718336484,13225,19.8997953567,14171,22.7686089592,14845,-7791,946
595,CHESAPEAKE ENERGY CORP,4.50057271422,1269394,4.11979742004,4407741,4.28001262185,4344847,6.26995707573,6491432,3138347,-62894
596,CHESAPEAKE LODGING TR,25.1600604437,6563458,26.4598363869,6728802,23.2501304448,7606667,22.8999897959,8516161,165344,877865
597,CHEVRON CORP NEW,89.9601697689,5367531,95.4000538745,6960625,104.829953628,6637807,102.919857128,6648202,1593094,-322818
598,CHIASMA INC,19.5927775643,13015,9.13425633366,17407,2.87017579827,19511,2.94466429495,75051,4392,2104
599,CHICAGO BRIDGE & IRON CO N V,38.9857369255,104115,36.5900386722,1605027,34.630394106,1435502,28.0300479072,1104636,1500912,-169525
600,CHICOS FAS INC,10.6704117288,862291,13.2700229553,2162468,10.7099788914,1445381,11.9001751738,1030405,1300177,-717087
601,CHILDRENS PL INC,55.1941278,52723,83.4673778079,141744,80.1840472165,197558,79.8657092232,107230,89021,55814
602,CHIMERA INVT CORP,13.63994191,2496125,13.5900593987,2628171,15.7002847976,2430147,15.9498243423,2470999,132046,-198024
603,CHIMERIX INC,8.92510671323,10308,5.11700193537,68204,3.93550471379,68098,5.54103876579,419055,57896,-106
604,CHINA BIOLOGIC PRODS INC,142.43860405,11605,114.507542147,22540,106.32816274,37262,124.477032256,140066,10935,14722
605,CHINA LIFE INS CO LTD,15.9899439396,643592,12.2893107286,325242,10.7602584361,505657,13.0810566719,553625,-318350,180415
606,CHINA LODGING GROUP LTD,31.2623561484,192212,38.2099774302,321225,36.4282926406,69177,45.0911981628,22643,129013,-252048
607,CHINA MOBILE LIMITED,56.3307925737,334808,55.4496865125,376251,57.8982421921,420410,61.5192647266,519317,41443,44159
608,CHINA PETE & CHEM CORP,59.9692338229,40304,65.1589003704,51290,71.9985469516,82585,73.8538634559,120928,10986,31295
609,CHINA UNICOM (HONG KONG) LTD,12.0592979492,39057,13.1567897433,142892,10.4149715216,43015,12.1736642586,69905,103835,-99877
610,CHIPOTLE MEXICAN GRILL INC,479.848882074,161728,470.972826828,300701,402.761000548,548859,423.500326953,760049,138973,248158
611,CHOICE HOTELS INTL INC,50.4012036108,71784,54.0501829451,76799,47.6130370103,110915,45.0722005384,77631,5015,34116
612,CHRISTOPHER & BANKS CORP,1.65131933534,174406,2.38814356957,170844,2.1793911326,29366,1.45034315119,172373,-3562,-141478
613,CHUNGHWA TELECOM CO LTD,30.0294372592,116519,33.7577186789,146722,36.29633158,146957,35.0293264059,147819,30203,235
614,CHURCH & DWIGHT INC,84.8797823175,1633204,92.1803316503,1365595,102.889715378,1264519,47.9197870092,2536447,-267609,-101076
615,CHURCHILL DOWNS INC,141.471879147,9797,147.832623403,7982,126.351761505,44479,146.355867854,82969,-1815,36497
616,CIBER INC,3.52500550782,31773,2.11685598461,72277,1.50045286396,366556,1.14968641787,435771,40504,294279
617,CIENA CORP,20.6901500595,1309947,19.0199688696,2121402,18.7502784226,2110102,21.8001743513,1597923,811455,-11300
618,CIGNA CORPORATION,146.329433564,1050233,137.240621228,1631157,127.990109935,1189881,130.320187576,652961,580924,-441276
619,CIMAREX ENERGY CO,89.3799397604,529884,97.2702958093,1522839,119.320042391,1343672,134.370130194,1081922,992955,-179167
620,CIMPRESS N V,81.1474152477,19557,90.7008019126,20077,92.5098198564,14766,101.189811818,44797,520,-5311
621,CINCINNATI BELL INC NEW,3.60068196435,623493,3.86989114308,1232076,4.57010651563,665630,4.08062422085,619268,608583,-566446
622,CINCINNATI FINL CORP,59.1710505635,757127,65.3600012417,1159746,74.8900444404,1047696,75.4194938062,1045963,402619,-112050
623,CINEMARK HOLDINGS INC,33.4312850921,190570,35.8301110938,391291,36.4607350478,507450,38.2795159902,606434,200721,116159
624,CINTAS CORP,91.0504784123,1005618,89.8098234054,1069059,98.130519473,1118653,112.599960906,1151075,63441,49594
625,CIRRUS LOGIC INC,29.528590211,288263,36.4106713746,407820,38.789534441,165457,53.1507465556,826931,119557,-242363
626,CISCO SYS INC,27.1550196266,31167976,28.4699677656,25237050,28.6899566421,23650576,31.7200175325,26364708,-5930926,-1586474
627,CIT GROUP INC,39.7001773825,2465858,31.0299307408,2648314,31.9101562659,2456710,36.2999804028,2990222,182456,-191604
628,CITIGROUP INC,51.6956684509,15311012,41.6788587255,10426869,42.2939350671,7838949,47.1563718659,11442653,-4884143,-2587920
629,CITIZENS FINL GROUP INC,26.1900441898,28813888,20.9499549215,13915734,19.9799761699,13020486,24.7100106788,10077009,-14898154,-895248
630,CITRIX SYS INC,75.6500648468,1816588,78.5800991736,3781250,80.0902065386,3103101,85.2199375378,3477942,1964662,-678149
631,CITY HLDG CO,45.6317223997,34121,47.8020658179,20815,45.4830718415,30275,50.2821959979,42878,-13306,9460
632,CIVEO CORP CDA,1.42160423368,192740,1.23331092114,260275,1.80033734476,343269,1.13890169107,451312,67535,82994
633,CLARCOR INC,49.6806168464,828472,57.7897933776,716476,60.8306434593,772341,65.0006224254,875607,-111996,55865
634,CLAYMORE EXCHANGE TRD FD TR,25.7937656863,1208858,23.1614017299,1573998,22.7840906607,1143605,20.7479199011,961012,365140,-430393
635,CLAYMORE EXCHANGE-TRD FD TR,24.9467813726,56841,23.5610830534,89894,23.6328692426,89494,26.9913533708,89399,33053,-400
636,CLEAN ENERGY FUELS CORP,3.60120778969,252693,2.93380711585,109755,3.47214290609,43777,4.46750252198,90207,-142938,-65978
637,CLEAN HARBORS INC,41.6509772007,246981,49.3409782085,329807,52.1102131007,199577,47.9751158144,180677,82826,-130230
638,CLEAR CHANNEL OUTDOOR HLDGS,5.58962392142,36854,4.69747255553,19585,6.21134499509,37673,5.84569923556,15567,-17269,18088
639,CLEARWATER PAPER CORP,45.5160576955,30297,48.5267876572,22977,65.3419204505,30899,64.6719038817,86560,-7320,7922
640,CLIFFS NAT RES INC,1.57979388359,524752,2.9996601234,1806538,5.66995465196,1552217,5.84832623056,501682,1281786,-254321
641,CLOROX CO DEL,126.830425765,1057814,126.059973688,1102150,138.390749185,1211396,125.17985106,1138442,44336,109246
642,CLOUD PEAK ENERGY INC,2.0801078383,464399,1.95575937416,74140,2.05950942654,355910,5.4383011783,254859,-390259,281770
643,CLOVIS ONCOLOGY INC,35.0002033029,1869132,19.2002381911,1021029,13.7197220862,1750327,36.0499870561,849820,-848103,729298
644,CLUBCORP HLDGS INC,18.2732875872,105947,14.0388384108,112260,13.0017119259,246506,14.4708499387,340754,6313,134246
645,CME GROUP INC,90.5987241897,926470,96.0507755842,902481,97.3999174577,1245422,104.520112553,1393483,-23989,342941
646,CMS ENERGY CORP,36.0804255212,1235379,42.4406703118,1009739,45.8600099841,2475948,42.0096978075,943306,-225640,1466209
647,CNA FINL CORP,35.1523510517,55103,32.186147901,121108,31.4269850083,90050,34.4095231436,114416,66005,-31058
648,CNH INDL N V,6.840238419,2254015,6.76002942497,5444355,7.1501306061,1084176,7.21928232502,888731,3190340,-4360179
649,CNO FINL GROUP INC,19.0899245787,5334437,17.9199611018,5322612,17.4599532817,5025443,15.2699966068,4432352,-11825,-297169
650,CNOOC LTD,104.371808407,46411,117.059256533,54340,124.661453366,78645,126.495220231,60777,7929,24305
651,COACH INC,32.7296523768,2217286,40.0896672659,1995377,40.7401422701,2178392,36.5596161791,1570941,-221909,183015
652,COBALT INTL ENERGY INC,5.39981206283,2513606,2.9699952859,2628287,1.33992227152,2617316,1.23998162919,4171836,114681,-10971
653,COBIZ FINANCIAL INC,13.4202429976,1117789,11.8197226541,1185307,11.7000207138,1375895,13.3104393865,1500251,67518,190588
654,COCA COLA BOTTLING CO CONS,182.421227197,4221,159.724612737,2905,147.504621072,13525,148.184347042,13301,-1316,10620
655,COCA COLA CO,42.9600156845,11818059,46.3899798067,13605007,45.3299780911,13242561,42.3199660007,11127301,1786948,-362446
656,COCA COLA FEMSA S A B DE C V,70.838765754,6903,83.0595673464,16133,82.8853046595,4464,74.9929606107,31963,9230,-11669
657,CODEXIS INC,4.2393902494,22173,3.11649172075,58399,4.014878668,16937,4.46355669261,18371,36226,-41462
658,COEUR MNG INC,2.47900209893,292053,5.62114580651,163134,10.6597489833,2393865,11.8298979566,2578805,-128919,2230731
659,COGENT COMMUNICATIONS HLDGS,34.6882011378,119003,39.0305220568,254570,40.0598687382,275937,36.8085993073,347935,135567,21367
660,COGNEX CORP,33.7790985636,50475,38.9486585864,132174,43.0994742401,171371,52.8599013892,266705,81699,39197
661,COGNIZANT TECHNOLOGY SOLUTIO,60.0199401795,3941790,62.7000994921,3283679,57.2397968981,4410987,47.7099081463,4304347,-658111,1127308
662,COHEN & STEERS INC,30.4966090571,45710,38.923172734,176630,40.4404709121,151111,42.7539421002,93161,130920,-25519
663,COHERENT INC,65.1094144694,35233,91.9092718563,45719,91.7654398004,48090,110.539599756,83599,10486,2371
664,COHU INC,12.0735019521,47128,11.8703680442,47766,10.8520610504,83210,11.7439445286,64033,638,35444
665,COLFAX CORP,23.3560681002,96035,28.5894336586,280873,26.4576276267,166795,31.4305483249,747203,184838,-114078
666,COLGATE PALMOLIVE CO,66.619997619,4905464,70.6501629095,4359169,73.1997185353,3335409,74.1399450448,2981699,-546295,-1023760
667,COLLEGIUM PHARMACEUTICAL INC,27.5015918107,40834,18.1444256477,60294,11.8399564507,44088,19.2274380738,11546,19460,-16206
668,COLLIERS INTL GROUP INC,44.5482024792,114797,37.8654424456,56199,34.1215764863,37425,42.0604395604,36400,-58598,-18774
669,COLONY CAP INC,19.4798321004,897441,16.7697402504,959347,15.3497442378,1744003,18.2297164169,1136880,61906,784656
670,COLUMBIA BKG SYS INC,32.5088713522,188810,29.920369083,1582300,28.060191169,1784913,32.7204126641,1941143,1393490,202613
671,COLUMBIA PIPELINE PARTNERS L,17.4795967995,1725097,14.6000859523,1610196,15.0003327787,751250,16.1401478734,2468193,-114901,-858946
672,COLUMBIA PPTY TR INC,23.4809081335,591587,21.9909092594,377747,21.3998737102,720565,22.3900865971,2783464,-213840,342818
673,COLUMBIA SPORTSWEAR CO,48.7525865114,118886,60.0905122015,475516,57.5404978174,620589,56.7404538679,789613,356630,145073
674,COLUMBUS MCKINNON CORP N Y,18.8882892607,12971,15.7670063343,29048,14.1649531643,26262,17.8438470821,38949,16077,-2786
675,COMCAST CORP NEW,56.430078985,14234483,61.0799905257,11297988,65.190024638,13016470,66.3399346909,11431184,-2936495,1718482
676,COMERICA INC,41.8300905585,674371,37.8699809889,3076104,41.1300814358,3612660,47.3199903052,3032545,2401733,536556
677,COMFORT SYS USA INC,28.4230321483,223340,31.7708919483,319884,32.5695631472,291929,29.3076944068,219874,96544,-27955
678,COMMERCE BANCSHARES INC,42.536615028,210501,44.9508734379,361617,47.9002548608,603859,49.2596716464,753517,151116,242242
679,COMMERCIAL METALS CO,13.6900611074,2855137,16.9698753814,3390184,16.9000491935,3724072,16.1899279449,2503223,535047,333888
680,COMMERCIAL VEH GROUP INC,2.76057599045,13403,2.65449522551,83255,5.20423117953,100303,5.78000502609,67647,69852,17048
681,COMMSCOPE HLDG CO INC,25.8897467658,688651,27.9211994721,604666,31.0299432549,530971,30.1099575574,997112,-83985,-73695
682,COMMUNICATIONS SALES&LEAS IN,18.69109657,702527,22.2515747068,576139,28.8998654585,2446828,31.409950888,2702392,-126388,1870689
683,COMMUNITY BANKERS TR CORP,5.38152860298,32147,5.00367917586,27180,5.17943026267,24327,5.39933480195,23151,-4967,-2853
684,COMMUNITY BK SYS INC,39.9396868194,1151987,38.2098552435,1138947,41.0895996229,1154112,48.1103592591,1169852,-13040,15165
685,COMMUNITY HEALTH SYS INC NEW,24.4672105182,1310039,15.5341987195,1281817,10.1873545963,1332927,10.4434392479,2168730,-28222,51110
686,COMMUNITY HEALTHCARE TR INC,18.429764222,523501,18.4892860369,608785,21.1392604346,647894,21.9204040051,217423,85284,39109
687,COMMVAULT SYSTEMS INC,39.3501855402,932143,43.1703596702,1348541,43.1900468244,1450311,53.1301094638,1262975,416398,101770
688,COMPANHIA DE SANEAMENTO BASI,4.59912756157,852553,6.60218867076,364879,8.96022695573,1308449,9.26017844236,1863571,-487674,943570
689,COMPANHIA ENERGETICA DE MINA,1.4998382808,2794968,2.26014230042,3828520,2.21005019298,10468993,2.58994364976,11811840,1033552,6640473
690,COMPANHIA SIDERURGICA NACION,0.975732709731,1785325,1.97242140099,226625,2.44971249011,233905,2.75907596345,236311,-1558700,7280
691,COMPANIA CERVECERIAS UNIDAS,21.6610778037,59046,22.4473579658,50340,23.3325025403,52159,20.1900361131,96087,-8706,1819
692,COMPANIA DE MINAS BUENAVENTU,4.28150164455,634824,7.36042319485,593580,11.9505177157,1428390,13.8401678547,1096663,-41244,834810
693,COMPASS DIVERSIFIED HOLDINGS,15.8874445757,99009,15.6531209333,108349,16.591936735,105714,17.3763193796,125343,9340,-2635
694,COMPASS MINERALS INTL INC,75.2835711672,32796,70.8446866485,22387,74.1908412529,44089,73.7026121452,89237,-10409,21702
695,COMPUGEN LTD,6.34690361774,11029,5.57745221983,13447,6.49350649351,14630,6.27556452065,17847,2418,1183
696,COMPUTER PROGRAMS & SYS INC,49.7432693091,36809,52.1258067821,48805,39.9202522255,21568,26.0541041451,28057,11996,-27237
697,COMPUTER SCIENCES CORP,32.6799733418,1308416,34.3904400957,1310306,49.6501489968,1338284,52.2100727903,2664505,1890,27978
698,COMPUTER TASK GROUP INC,6.62041876524,31569,5.12820512821,11505,4.97060071528,16497,4.68136514648,13244,-20064,4992
699,COMSCORE INC,41.2060301508,7960,30.0320833114,38026,23.8690792975,37580,30.6606417901,383521,30066,-446
700,COMSTOCK MNG INC,0.373412994772,10712,0.365393203686,24631,0.365883405155,24598,0.364225010117,24710,13919,-33
701,COMSTOCK RES INC,1.86930325969,258920,0.765893950098,605828,0.838323353293,141950,7.62369048854,19282,346908,-463878
702,CONAGRA FOODS INC,42.1599663555,7340281,44.620008828,7136350,47.8098798302,6428734,47.1098259844,4298063,-203931,-707616
703,CONCHO RES INC,92.8602170589,2402482,101.040212038,940962,119.269677562,759774,137.350393128,1333662,-1461520,-181188
704,CONE MIDSTREAM PARTNERS LP,9.85001933887,742029,12.5102265559,960734,17.340181856,720350,18.1001002255,638560,218705,-240384
705,CONFORMIS INC,17.2853607462,26265,10.7649720989,22759,7.03537228845,10234,9.92079366349,12499,-3506,-12525
706,CONMED CORP,44.0489853677,486186,41.939857199,990609,47.7299425654,967883,40.0602682123,961701,504423,-22726
707,CONNECTONE BANCORP INC NEW,18.6894860169,675567,16.3498494374,749854,15.6898258324,902177,18.0599040173,1021434,74287,152323
708,CONNECTURE INC,3.57203606055,11758,2.58340714497,13548,2.28155639144,16217,1.90073917635,14205,1790,2669
709,CONNS INC,23.4601921501,26854,12.4610973607,81614,7.51915708812,20880,10.3305177032,33977,54760,-60734
710,CONOCOPHILLIPS,46.6898547779,3031151,40.2698488005,3378781,43.5997321466,5316340,43.4699951407,8826387,347630,1937559
711,CONSOL ENERGY INC,7.90044254359,404028,11.2900847945,1261638,16.0899118836,1060416,19.2002987865,2816727,857610,-201222
712,CONSOLIDATED COMM HLDGS INC,20.9353890579,19393,25.7621852547,61796,27.2364924712,76772,25.2383272736,320148,42403,14976
713,CONSOLIDATED EDISON INC,64.2695274618,1585946,76.6198946908,2005902,80.4398316618,2988507,75.3002965202,1807297,419956,982605
714,CONSTELLATION BRANDS INC,142.439162318,813435,151.091154351,270585,165.399536084,596229,166.489349424,476547,-542850,325644
715,CONSTELLIUM NV,7.71715721464,5572,5.19480519481,61215,4.68262226847,17298,7.17660427008,16721,55643,-43917
716,CONTANGO OIL & GAS COMPANY,6.41217632804,73454,11.8131263942,31829,12.2415022581,75726,10.2195187292,126914,-41625,43897
717,CONTINENTAL BLDG PRODS INC,17.4596657806,1919338,18.5596583212,1568725,22.2300187417,1442239,20.9897292031,1707073,-350613,-126486
718,CONTINENTAL RESOURCES INC,22.9799419106,4026555,30.359615132,890591,45.2706418415,1069236,51.9599486102,1225925,-3135964,178645
719,CONTROLADORA VUELA CIA DE AV,17.159433493,500541,21.0698697763,419509,18.6908124273,120380,17.3921555831,30646,-81032,-299129
720,CONVERGYS CORP,24.8898635628,2522553,27.7702373634,2505020,24.9999898583,2465081,30.4202048933,2418820,-17533,-39939
721,COOPER COS INC,134.196572569,172374,153.971066882,141637,171.568535971,107170,179.262708778,153752,-30737,-34467
722,COOPER STD HLDGS INC,77.5634517766,4925,71.8725378622,11423,78.9874562635,84026,98.8005066693,194999,6498,72603
723,COOPER TIRE & RUBR CO,37.8500764249,1101081,37.0202115977,479873,29.8197275863,423914,38.0199721623,428196,-621208,-55959
724,COPA HOLDINGS SA,48.2636051987,118723,67.7511148864,117725,52.2553347488,65467,87.9364064872,125170,-998,-52258
725,COPART INC,38.0092972382,263304,40.7704404559,307772,49.0106956749,657836,53.5585335541,814268,44468,350064
726,CORCEPT THERAPEUTICS INC,4.96166907294,49177,4.67087961691,50954,5.4678107347,60719,6.49876194979,124793,1777,9765
727,CORE LABORATORIES N V,108.76534296,34625,112.410050443,41829,123.885557313,81543,112.325804901,58268,7204,39714
728,CORE MARK HOLDING CO INC,81.9410677329,398152,81.5606638933,559608,46.8595193069,1072909,35.8002633255,982814,161456,513301
729,CORELOGIC INC,33.8577712538,406022,34.7014073165,424709,38.4814572296,335980,39.2196572221,478969,18687,-88729
730,CORENERGY INFRASTRUCTURE TR,14.8407112428,777456,20.1106673724,519575,28.8485514291,553442,29.3295320802,563323,-257881,33867
731,CORESITE RLTY CORP,56.7197118335,363401,70.0114585605,288867,88.6882962014,259121,74.040955021,447320,-74534,-29746
732,CORINDUS VASCULAR ROBOTICS I,3.21121881991,83146,0.988347069232,62731,1.44965735372,22764,1.10456553756,24444,-20415,-39967
733,CORIUM INTL INC,8.11987861722,1372188,3.85979747995,1341003,3.46999486556,1530838,5.62981493236,1606980,-31185,189835
734,CORNERSTONE ONDEMAND INC,34.5300398522,935707,32.7699982551,1427037,38.05982301,902763,45.9495138923,810520,491330,-524274
735,CORNING INC,18.279974859,10496021,20.8901009124,7242617,20.480004359,9543455,23.6500318595,13040067,-3253404,2300838
736,CORPORATE OFFICE PPTYS TR,21.8300815757,2934208,26.2398315863,3836267,29.5699640681,3454316,28.3502203686,2620156,902059,-381951
737,CORRECTIONS CORP AMER NEW,26.4881430816,192841,32.0486815416,211990,35.0222257712,300552,13.8698894819,2154307,19149,88562
738,CORVEL CORP,43.961352657,16560,39.4191527729,31609,43.174569704,37939,38.4113734185,30668,15049,6330
739,COSAN LTD,3.69024487919,337105,4.92152318505,265365,6.51007988756,614739,7.1493500854,863575,-71740,349374
740,COSI INC,0.445873325042,42613,0.842197198915,32059,0.496621665774,76517,0.0699848832652,71444,-10554,44458
741,COSTAR GROUP INC,206.692782684,150610,188.168058857,168679,218.661961604,137724,216.528528315,112327,18069,-30955
742,COSTCO WHSL CORP NEW,161.499791291,4142123,157.579840986,4552048,157.03975795,3860360,152.509689229,3575104,409925,-691688
743,COTT CORP QUE,10.9885852003,129043,13.8929889299,162600,13.9562798173,98307,14.2509716572,87994,33557,-64293
744,COTY INC,25.6311787337,718695,27.8304226531,697546,25.9896150663,659802,23.5001956008,2313385,-21149,-37744
745,COUSINS PPTYS INC,9.42940669782,1072708,10.3801128604,1248445,10.399855782,2091279,10.439985337,1966861,175737,842834
746,COVANTA HLDG CORP,15.4897376555,1779759,16.8599837199,2143715,16.4499338701,1580979,15.3894974793,1531499,363956,-562736
747,COVISINT CORP,2.48262164846,18126,2.02995940081,14286,2.17727208878,14238,2.1612001017,15732,-3840,-48
748,COWEN GROUP INC NEW,3.84088321013,51811,3.81656539049,66814,2.94530964252,51947,3.62115252544,80085,15003,-14867
749,CPFL ENERGIA S A,7.41891912803,452357,10.9129490224,39586,12.8604085244,339025,14.800292092,1103762,-412771,299439
750,CPI CARD GROUP INC,10.662723952,57490,8.2443423892,72292,5.01313683448,99339,6.05062953241,44954,14802,27047
751,CRA INTL INC,18.6437847092,47898,19.6354776294,41863,25.2284883966,23743,26.599845798,28534,-6035,-18120
752,CRACKER BARREL OLD CTRY STOR,126.827323685,205697,152.662159307,94660,171.467911235,111846,132.213085449,111880,-111037,17186
753,CRANE CO,47.8359506722,113283,53.8611757273,139284,56.7153834204,167362,63.010837002,334133,26001,28078
754,CRAWFORD & CO,5.1261829653,35504,6.00953827071,46759,8.1913458802,80817,11.32677187,18187,11255,34058
755,CRAY INC,32.4537586968,47144,41.9064799702,139692,29.9182242561,271841,23.5403305042,349103,92548,132149
756,CREDICORP LTD,97.319792303,209536,131.010727291,355635,154.329827602,673849,152.2200124,698397,146099,318214
757,CREDIT ACCEP CORP MICH,214.008175821,49414,181.545780304,64744,185.083456581,18932,201.053084032,18612,15330,-45812
758,CREDIT SUISSE GROUP,21.6895666478,1093014,14.1306098779,620780,10.6998524933,1156558,13.1396264224,1047975,-472234,535778
759,CREDIT SUISSE NASSAU BRH,18.8673121653,92435,25.9257910643,27463,24.9960457527,960992,36.2369065319,1073436,-64972,933529
760,CREE INC,26.669659134,472297,29.1019662879,132534,24.4384057971,110400,25.7248912283,131468,-339763,-22134
761,CRESCENT PT ENERGY CORP,11.6485754224,463576,13.8396233606,1023366,15.7899230601,1241488,13.1994344483,309786,559790,218122
762,CRESTWOOD EQUITY PARTNERS LP,20.7797338087,1184712,11.6703421306,896032,20.1589909495,354234,21.2500377792,330870,-288680,-541798
763,CRESUD S A C I F Y A,12.8978593763,99784,11.644905479,99872,14.1261342927,105903,17.8613396005,97865,88,6031
764,CRH PLC,28.8199930507,305066,28.181180553,270890,29.580426264,272038,33.2690837996,651626,-34176,1148
765,CRITEO S A,39.5871842267,12984,41.3887799137,5098,45.9221708663,6707,35.0812859064,16362,-7886,1609
766,CROCS INC,10.2404483605,106343,9.62462391506,63483,11.2901539702,66961,8.29743970964,91474,-42860,3478
767,CROSSAMERICA PARTNERS LP,25.920220463,1605349,24.3302986578,1625874,24.5198219441,1628927,25.3899202285,1191654,20525,3053
768,CROWN CASTLE INTL CORP NEW,87.2282530062,3075609,86.5002583747,2225450,101.429858816,2496750,94.2095429454,1505028,-850159,271300
769,CROWN HOLDINGS INC,50.702529267,247463,49.5868247511,345132,50.6703893193,545131,57.0898659928,1375971,97669,199999
770,CSG SYS INTL INC,36.03719969,7742,45.1603826674,92404,40.3080742824,78942,41.3334674513,119298,84662,-13462
771,CSI COMPRESSCO LP,11.3999786848,3556147,5.75977162193,3259157,8.1600902527,3620058,10.589946657,3623531,-296990,360901
772,CSRA INC,30.0000338429,590966,26.8991831261,771845,23.4317069554,566412,26.9000466288,649813,180879,-205433
773,CSS INDS INC,28.3862229102,51680,27.9301560147,53777,26.8040851446,53462,25.5869561124,53113,2097,-315
774,CST BRANDS INC,39.1403198051,159222,38.2907457963,920144,43.0799696217,741319,48.0902492211,614033,760922,-178825
775,CSW INDUSTRIALS INC,37.6755265797,15952,31.4921018211,39756,32.5996221607,22761,32.3729362253,12356,23804,-16995
776,CSX CORP,25.9501780121,4486212,25.7498881652,4285339,26.0799121445,4578428,30.4999152408,3657420,-200873,293089
777,CTI BIOPHARMA CORP,1.23025943637,323509,0.531208499336,120480,0.340147920737,1490528,0.374438160992,1375394,-203029,1370048
778,CTRIP COM INTL LTD,46.3296391492,2433194,44.2597595364,3126045,41.1997750843,2253289,46.5699371411,2833330,692851,-872756
779,CTS CORP,17.6401419077,1495056,15.7399038275,1472563,17.9199204153,1572161,18.6001111412,1588969,-22493,99598
780,CUBESMART,30.6199620951,4742919,33.2999878318,4980182,30.8799772292,4440774,27.2600109634,4370908,237263,-539408
781,CUBIC CORP,47.2256276318,18761,39.9759090567,13283,40.1423034036,18833,46.8122902823,30398,-5478,5550
782,CULLEN FROST BANKERS INC,59.9968559815,222645,55.1077835466,277547,63.7288235093,408826,71.9397651375,523285,54902,131279
783,CULP INC,25.4963733607,13649,26.2375988316,19857,27.6493558957,22279,29.7715665703,25259,6208,2422
784,CUMMINS INC,88.0093612893,740069,109.939945849,2805468,112.44039837,1040240,128.150372734,797485,2065399,-1765228
785,CUMULUS MEDIA INC,0.330187180717,1920123,0.464914970373,903391,0.310297109482,799234,0.330312270114,759887,-1016732,-104157
786,CURIS INC,2.88766965059,10389,1.61893150521,50033,1.56146910051,45470,2.61448264934,88354,39644,-4563
787,CURRENCYSHARES AUSTRALIAN DL,72.9674150957,226608,76.7501956288,219804,74.639224036,219804,76.6164263871,219744,-6804,0
788,CURRENCYSHARES CDN DLR TR,71.6763652641,17872,76.3061033896,18203,76.6327535281,18282,75.3983463834,18263,331,79
789,CURRENCYSHARES EURO TR,106.399086073,438547,111.180364075,442821,108.169870787,470852,109.351048689,437737,4274,28031
790,CURRENCYSHARES SWISS FRANC T,96.3533818401,23227,100.185129375,23227,98.2907822792,23227,98.5491023378,23227,0,0
791,CURRENCYSHS BRIT POUND STER,144.324324324,7400,140.540540541,7400,130.165567371,7429,126.665769283,7429,0,29
792,CURRENCYSHS JAPANESE YEN TR,80.630081679,429976,86.0188730198,396227,93.580224124,314201,95.2106416839,166515,-33749,-82026
793,CURTISS WRIGHT CORP,68.4996998932,769726,75.6698365786,1139569,84.249808467,1011575,91.1100203352,1069575,369843,-127994
794,CUSTOMERS BANCORP INC,27.2068979951,23891,23.62674855,11724,25.125301048,30726,25.1630847029,98875,-12167,19002
795,CVB FINL CORP,16.9198173077,3180649,17.4498688083,3533379,16.3900454852,3638550,17.6101042259,3773629,352730,105171
796,CVENT INC,34.9182521294,30643,21.3861290866,41569,35.7192480483,582963,31.709780943,436553,10926,541394
797,CVR ENERGY INC,39.3488515758,511527,26.0990440965,326602,15.5001140896,311159,13.7667813898,119999,-184925,-15443
798,CVR REFNG LP,18.9297985292,2727393,12.0799582188,1547108,7.75016564171,1071590,8.76824512719,302341,-1180285,-475518
799,CVS HEALTH CORP,97.7702030623,4192310,103.730198834,3403840,95.7399116987,3885788,88.9901269289,3245596,-788470,481948
800,CYNOSURE INC,44.6909667195,6310,44.1130000632,15823,48.638240102,72186,50.9388423896,90324,9513,56363
801,CYPRESS SEMICONDUCTOR CORP,9.81000675893,4238835,8.65988762876,3960444,10.5499185235,6187062,12.1599384202,6646333,-278391,2226618
802,CYRUSONE INC,37.4496993697,2812092,45.6501096865,3139401,55.6600786997,3101918,47.5700820251,3163543,327309,-37483
803,CYS INVTS INC,7.12961593024,574505,8.13954278884,1618027,8.36993496422,1150905,8.71992966531,1043013,1043522,-467122
804,D R HORTON INC,32.0305788507,2841441,30.2298568214,4017849,31.4798922835,3073994,30.1999122211,3925773,1176408,-943855
805,DANAHER CORP DEL,92.8799778874,2250302,94.8602057529,2432432,100.999917268,2272388,78.3900064492,2829825,182130,-160044
806,DARDEN RESTAURANTS INC,63.6403625269,2134683,66.3000127307,2537179,63.3397250532,1847703,61.3199781735,2047049,402496,-689476
807,DARLING INGREDIENTS INC,10.5218884003,292438,13.1699089214,1047008,14.8999100983,521681,13.5083479153,656631,754570,-525327
808,DATALINK CORP,6.76457498887,11235,9.11161731207,13170,7.49450253557,89132,10.606914625,136609,1935,75962
809,DAVE & BUSTERS ENTMT INC,41.750334672,11952,38.7869354555,39833,46.7856753431,128394,39.1802867757,355051,27881,88561
810,DAWSON GEOPHYSICAL CO NEW,3.45144320428,35927,4.53495336699,11687,8.14877377377,191808,7.62343126326,55618,-24240,180121
811,DBX ETF TR,27.1281253099,70027655,25.4870684649,71720410,24.9655414914,73686445,26.3473150411,59558175,1692755,1966035
812,DCP MIDSTREAM PARTNERS LP,24.670123407,5856963,27.2298745612,6476306,34.4899684095,8116360,35.3300042534,7163741,619343,1640054
813,DCT INDUSTRIAL TRUST INC,37.3711035289,422626,39.4702670743,1336145,48.0400497254,682951,48.5500822804,864118,913519,-653194
814,DDR CORP,16.8399191096,11450055,17.7900212423,16889918,18.1400059337,16691064,17.4299930511,16935176,5439863,-198854
815,DEAN FOODS CO NEW,17.1492955401,768603,17.3201860088,1737337,18.0900237902,1709948,16.3999771351,1959332,968734,-27389
816,DECKERS OUTDOOR CORP,47.1981933706,261260,59.9115291625,407818,57.5251147938,214515,59.5508760473,747277,146558,-193303
817,DEERE & CO,76.2697256225,1740376,76.990251456,1802423,81.0397661024,1706730,85.3496436644,1527212,62047,-95693
818,DEL FRISCOS RESTAURANT GROUP,16.0256410256,18096,16.5804416404,39625,14.3242756883,55570,13.468216214,49821,21529,15945
819,DEL TACO RESTAURANTS INC,7.38780460911,27207,9.10346732974,72390,8.34780759278,112844,9.54307349204,38562,45183,40454
820,DELEK LOGISTICS PARTNERS LP,35.6901119651,1257267,31.4004021761,1147756,26.7104311951,1146743,28.5803802737,1069230,-109511,-1013
821,DELEK US HLDGS INC,24.6001121951,1231783,15.238960451,658247,13.2103634382,913828,17.2901879719,830124,-573536,255581
822,DELPHI AUTOMOTIVE PLC,85.7301349,1013121,75.0196134802,577409,62.5997201699,814780,71.3196992289,1631008,-435712,237371
823,DELTA AIR LINES INC DEL,50.6901072751,2877741,48.6800991958,2515833,36.4303599739,2014007,39.3601058163,3722678,-361908,-501826
824,DELTA APPAREL INC,14.047029703,16160,19.1232972407,22904,22.5456435579,61564,16.4766915096,27372,6744,38660
825,DELTIC TIMBER CORP,58.8392618347,11217,60.1493168052,14198,67.139030502,11573,67.6847517458,13031,2981,-2625
826,DELUXE CORP,54.5416307388,237745,62.4898965406,395904,66.3678712406,379747,66.8188899788,363939,158159,-16157
827,DEMAND MEDIA INC,5.49763033175,10550,4.99795165916,12205,5.15113227719,20578,5.70670205707,15070,1655,8373
828,DENBURY RES INC,2.01971347627,2162683,2.22010762524,1520647,3.58994031604,5706223,3.23009277155,6622720,-642036,4185576
829,DENISON MINES CORP,0.503878694134,85338,0.5540237586,77614,0.546467352983,113456,0.458468176915,37080,-7724,35842
830,DENNYS CORP,9.83061417777,859458,10.3602062981,441497,10.7299788216,170457,10.6876398178,170758,-417961,-271040
831,DEPOMED INC,18.1290017216,384522,13.9267636066,229558,19.6160679037,162112,24.9730682597,173587,-154964,-67446
832,DERMA SCIENCES INC,4.56115201668,15347,3.11073541843,29575,3.93007977475,34096,4.65750986383,33709,14228,4521
833,DERMIRA INC,34.597538834,19828,20.666013712,20420,29.2496218159,98497,33.8193899207,291667,592,78077
834,DESTINATION MATERNITY CORP,8.71714806141,23058,6.84478371501,39300,5.89212274597,25288,7.0913603593,16922,16242,-14012
835,DESTINATION XL GROUP INC,5.50914263968,55181,5.17183850517,59940,4.56590568239,60010,4.33898961223,61996,4759,70
836,DETERMINE INC,2.56904303147,14013,1.85214375788,25376,1.54014308426,20128,1.69351196748,26572,11363,-5248
837,DEUTSCHE BANK AG,24.1499936582,20704022,16.9399869896,19762648,13.7300148604,24069384,13.0899952419,34107881,-941374,4306736
838,DEUTSCHE BK AG LONDON,15.515692626,36737,18.2706766917,13300,18.4280105761,12481,18.1075234356,12481,-23437,-819
839,DEVON ENERGY CORP NEW,32.0000133894,7169872,27.4401796318,2240583,36.2502129599,1913506,44.1099505385,4205491,-4929289,-327077
840,DEVRY ED GROUP INC,25.3032716579,32644,17.2708979533,179898,17.8389341039,265767,23.0591417388,335702,147254,85869
841,DEXCOM INC,81.9006474784,1471246,67.9092412694,1395436,79.3299410076,915203,87.6590851866,925369,-75810,-480233
842,DGSE COMPANIES INC,0.342363161724,23367,0.500062507813,15998,0.694283730618,12963,0.848569004089,12963,-7369,-3035
843,DHI GROUP INC,9.16956583593,386605,8.07100074394,498699,6.22965449946,744022,7.88934890974,639343,112094,245323
844,DHT HOLDINGS INC,8.09067106424,691290,5.76061361365,1001803,5.02912814685,411801,4.19011790392,747473,310513,-590002
845,DHX MEDIA LTD,8.46844986058,19366,5.61497326203,18700,5.15602341694,18619,5.16129032258,18600,-666,-81
846,DIAGEO P L C,109.071366694,187006,107.870712711,434103,112.881974866,149519,116.037918359,232605,247097,-284584
847,DIAMOND OFFSHORE DRILLING IN,21.0999881276,395877,21.7302440929,658069,24.3301911942,603941,17.6100146498,1720839,262192,-54128
848,DIAMONDBACK ENERGY INC,66.9007423877,687242,77.1801495349,821079,91.20906406,765220,96.5387864534,756411,133837,-55859
849,DIAMONDROCK HOSPITALITY CO,9.65051528208,873114,10.1200185407,1188733,9.03025266551,1288779,9.09956639383,1005982,315619,100046
850,DIANA SHIPPING INC,4.27747814767,5377,2.66641862772,32253,2.42684463527,21427,2.62207866236,26315,26876,-10826
851,DICERNA PHARMACEUTICALS INC,11.8994873093,15799,5.35737200051,31172,2.99063700568,43469,5.88767066132,43141,15373,12297
852,DICKS SPORTING GOODS INC,35.3501497611,398301,46.7527543439,411441,45.0596589885,332892,56.7199428378,1329550,13140,-78549
853,DIEBOLD INC,30.0937345831,48648,28.9125799574,46900,24.8284518828,358500,24.7905213573,752344,-1748,311600
854,DIGI INTL INC,11.3811222283,141023,9.42564076716,79358,10.7212614591,70141,11.4019100386,68585,-61665,-9217
855,DIGIRAD CORP,5.78853377671,16239,4.97855392157,13056,5.1657050852,29812,5.08474576271,25960,-3183,16756
856,DIGITAL RLTY TR INC,71.9397436645,1698477,82.3357166641,1777904,108.9906035,1478210,97.1193382718,1000048,79427,-299694
857,DIGITALGLOBE INC,15.6600212339,440804,17.3017609432,263268,21.3898998821,507202,27.49980301,698005,-177536,243934
858,DILLARDS INC,65.7093378476,102786,84.9115522247,118488,60.6007869571,235591,63.0093570782,331300,15702,117103
859,DIME CMNTY BANCSHARES,17.4900989431,1036758,17.6196690895,1017556,17.0099239045,1035278,16.7603070804,1042463,-19202,17722
860,DINEEQUITY INC,84.6705567712,16452,93.4138021517,19055,84.779807777,124959,79.1813055601,79981,2603,105904
861,DIPLOMAT PHARMACY INC,34.2302861876,37423,27.3949494779,59281,35.0088160887,39133,28.0152894402,65143,21858,-20148
862,DIREXION SHS ETF TR,37.2126688267,2662346,33.8886653644,2746405,40.715720491,1771306,33.0726589044,1985235,84059,-975099
863,DISCOVER FINL SVCS,53.6198584136,1718244,50.9196556138,1317939,53.5903440186,1133805,56.5501276192,1516230,-400305,-184134
864,DISCOVERY COMMUNICATNS NEW,26.4506274483,4011247,27.9650136917,4793418,24.2587082905,2652903,26.7052541237,4174759,782171,-2140515
865,DISH NETWORK CORP,57.1806140591,920172,46.260375516,675870,52.4001339225,2201273,54.7803443831,4372572,-244302,1525403
866,DISNEY WALT CO,105.079990942,18918892,99.3099913611,22449574,97.8200229167,25621462,92.8599656596,25210509,3530682,3171888
867,DIVERSIFIED RSTRNT HLDGS INC,2.24630763183,53421,1.92047261557,423854,1.51971761001,309926,1.16686114352,32566,370433,-113928
868,DOCUMENT SEC SYS INC,0.168909408254,195371,0.185721345021,301527,0.199514040801,280682,0.649735052484,69259,106156,-20845
869,DOLBY LABORATORIES INC,33.6467980119,83901,43.4588416357,185831,47.8516299965,130215,54.2908260843,162090,101930,-55616
870,DOLLAR GEN CORP NEW,71.868590176,585527,85.5990076701,663489,93.9996633293,1342558,69.9891605552,1331249,77962,679069
871,DOLLAR TREE INC,77.2201174131,1729109,82.4606050568,1340337,94.2413061447,1173530,78.9307049236,1186015,-388772,-166807
872,DOMINION DIAMOND CORP,10.2333749873,88827,11.0923491711,214382,8.84375472872,59477,9.74195230027,61384,125555,-154905
873,DOMINION MIDSTREAM PARTNERS,30.6599434008,1771758,33.7502576053,1640106,28.1300736911,1388905,23.910080305,804807,-131652,-251201
874,DOMINION RES INC VA NEW,67.6404524099,2117372,75.1200201226,2858479,77.9300898264,2744293,73.1542724927,3470515,741107,-114186
875,DOMINOS PIZZA INC,111.24884189,313010,131.862066385,320676,131.38141038,233001,151.848691131,251935,7666,-87675
876,DOMTAR CORP,36.9510420779,362209,40.5007989914,341055,35.0083465415,403161,37.1294293936,587270,-21154,62106
877,DONALDSON INC,28.6522167107,103622,31.9110138585,137100,34.3625220341,233161,37.3311185732,419007,33478,96061
878,DONNELLEY R R & SONS CO,14.7198267227,823651,16.39908761,818948,16.9198265317,1124125,15.7202306389,2384507,-4703,305177
879,DORMAN PRODUCTS INC,47.5513107092,4921,54.4398532089,34607,57.2013277097,40069,63.9111132214,42121,29686,5462
880,DOUGLAS EMMETT INC,31.1791021198,595046,30.1101572317,389171,35.5192597682,448292,36.6307184676,510364,-205875,59121
881,DOVER CORP,61.30834068,307397,64.3318974259,493068,69.3202392879,999131,73.6397988756,1074161,185671,506063
882,DOW CHEM CO,51.4801549921,7385409,50.8600821773,6887307,49.7100549234,4684163,51.8301668075,4224451,-498102,-2203144
883,DR PEPPER SNAPPLE GROUP INC,93.1998284004,2419586,89.4201326526,2322307,96.6294956423,2922886,91.3099650713,1665678,-97279,600579
884,DR REDDYS LABS LTD,46.2881786704,225846,45.1924155728,44565,51.2425738432,59755,46.4094896082,79919,-181281,15190
885,DRDGOLD LIMITED,1.59741604789,56967,3.96667988893,15126,5.88390850192,15126,4.95724377246,40345,-41841,0
886,DREW INDS INC,60.9555189456,4856,64.4505789433,78246,84.8400820482,105304,98.0139992578,156294,73390,27058
887,DRIL-QUIP INC,59.2301638579,993666,60.5604244668,1003989,58.4303670257,851766,55.7395160519,972129,10323,-152223
888,DSP GROUP INC,9.42961102855,19513,9.13483009216,24631,10.5883992012,21533,12.0226308345,36764,5118,-3098
889,DST SYS INC DEL,114.060815432,172522,112.775820339,219391,116.427428811,468223,117.919041526,618984,46869,248832
890,DSW INC,23.8604978019,611890,27.6395708828,491614,21.1808086438,746336,20.4791388213,443671,-120276,254722
891,DTE ENERGY CO,80.1890990621,1056166,90.6603725137,993091,99.1199405829,973457,93.6693980085,1429090,-63075,-19634
892,DU PONT E I DE NEMOURS & CO,66.600058631,7187321,63.3199917131,6767294,64.7997007077,5557109,66.9700396237,5514884,-420027,-1210185
893,DUCOMMUN INC DEL,16.199973871,22963,15.2613334534,22213,19.7772717347,32057,22.8364252754,42476,-750,9844
894,DUKE ENERGY CORP NEW,71.3899433935,2999302,80.6798181469,4584579,85.7898921235,3940709,80.0400027935,3980722,1585277,-643870
895,DUKE REALTY CORP,21.01995456,3809856,22.5398378418,3145941,26.6599286868,3755824,27.3299861595,7025031,-663915,609883
896,DUN & BRADSTREET CORP DEL NE,103.932985295,259167,103.083112714,191884,121.842325558,182769,136.622206468,174913,-67283,-9115
897,DUNKIN BRANDS GROUP INC,42.5888103927,298670,47.1675767131,325075,43.6206184049,597699,52.0795769549,1089813,26405,272624
898,DUPONT FABROS TECHNOLOGY INC,31.7907361996,535439,40.5302068424,693088,47.53916038,746290,41.2485672552,483338,157649,53202
899,DURECT CORP,2.20773759462,38048,1.34334400648,54342,1.21557246893,91315,1.39024149271,141702,16294,36973
900,DYCOM INDS INC,69.9590968673,379922,64.6676497897,347871,89.7594666002,393251,81.7793380254,528691,-32051,45380
901,DYNAVAX TECHNOLOGIES CORP,24.1607993814,493982,19.2399678637,430666,14.5798062404,480802,10.4904521157,883756,-63316,50136
902,DYNEGY INC NEW DEL,12.610107688,6132065,8.21023536044,3719869,14.958621571,2449223,10.6240206945,2446249,-2412196,-1270646
903,DYNEX CAP INC,6.35201792407,340994,6.64810277156,406883,6.94050461212,347237,7.42150234083,384693,65889,-59646
904,E TRADE FINANCIAL CORP,29.6404727494,2098617,24.4899176371,2649131,23.4896268849,3355694,29.1199743197,3140147,550514,706563
905,EAGLE BANCORP INC MD,50.4701146586,2408455,47.9997781426,2596262,48.1098556149,2717385,49.3303177844,2812976,187807,121123
906,EAGLE MATERIALS INC,60.4308276256,807237,70.1087776928,775067,77.1494815558,859591,77.3000774521,775963,-32170,84524
907,EAGLE PHARMACEUTICALS INC,88.7241114804,7822,40.4987574409,69212,38.7878787879,14850,69.9918355229,26946,61390,-54362
908,EARTHLINK HLDGS CORP,7.43083680023,724952,5.67006710934,959777,6.40004306169,1300460,6.19990525817,1319375,234825,340683
909,EAST WEST BANCORP INC,41.5601509148,802307,32.481318497,453122,34.1802442242,843733,36.7102897521,550091,-349185,390611
910,EASTERLY GOVT PPTYS INC,17.196789037,29773,18.5102586976,22420,19.7416923791,36623,19.080350794,50628,-7353,14203
911,EASTGROUP PPTY INC,55.6136700654,86993,60.3702261565,598391,68.9200212804,845850,73.5598206566,847759,511398,247459
912,EASTMAN CHEM CO,67.5094155514,569802,72.2286917967,601963,67.8993521065,695176,67.6798181166,727499,32161,93213
913,EASTMAN KODAK CO,12.552895402,35211,10.8400470716,44188,16.0959067679,20937,15.0462962963,6048,8977,-23251
914,EATON CORP PLC,52.0404415318,1448412,62.5599736746,1665314,59.730113916,1777713,65.7097479396,1722682,216902,112399
915,EATON VANCE CORP,32.429765017,265466,33.5214132633,330356,35.339090467,396841,39.0497961864,633422,64890,66485
916,EATON VANCE TAX ADVT DIV INC,19.3613276339,19885,19.2110780633,20509,20.1218489743,17891,20.1601954928,14732,624,-2618
917,EATON VANCE TX MNG BY WRT OP,15.3041305536,64035,14.696641765,85938,14.7892900713,46723,15.0980392157,40800,21903,-39215
918,EBAY INC,27.4801036344,10625433,23.8600086436,15148821,23.4100569261,17013628,32.9000022325,14647537,4523388,1864807
919,EBIX INC,32.7956066587,58270,40.7864849517,70440,47.901459854,67952,56.8438668174,92024,12170,-2488
920,ECHO GLOBAL LOGISTICS INC,20.4067370187,14309,27.1527966025,44268,22.3895383396,10094,23.0564957609,183766,29959,-34174
921,ECHOSTAR CORP,39.1071138322,92285,44.2840421381,51260,39.6920153018,41041,43.81245196,46836,-41025,-10219
922,ECLIPSE RES CORP,1.81952372068,605653,1.44027687711,558226,3.33995030951,5382116,3.28849788536,117987,-47427,4823890
923,ECOLAB INC,114.378871642,888512,111.520823302,728967,118.598503032,739495,121.720023718,721804,-159545,10528
924,ECOPETROL S A,7.00929103029,981269,8.60966864748,960548,9.55991670025,1094361,8.76040182955,1143669,-20721,133813
925,EDGEWELL PERS CARE CO,78.369662073,2352224,80.5297166006,1525797,84.4100337817,1219002,79.5210090048,475082,-826427,-306795
926,EDISON INTL,59.21031177,1073259,71.8903274534,1339916,77.6691074711,1013054,72.2499413307,1470105,266657,-326862
927,EDUCATION RLTY TR INC,37.8819576716,160129,41.600415638,573576,46.1419059059,526983,43.1392267446,735850,413447,-46593
928,EDWARDS LIFESCIENCES CORP,78.9800609828,1985805,88.2105196913,1652558,99.7290263508,1212295,120.559769427,2093219,-333247,-440263
929,EGALET CORP,11.0229053952,19777,6.86867684983,40328,4.96105452367,166900,7.62159189125,12727,20551,126572
930,EL PASO ELEC CO,38.4842956462,40562,45.8804744526,219200,47.2689635228,262794,46.7672193294,185707,178638,43594
931,EL POLLO LOCO HLDGS INC,12.6682501979,2526,13.3176366713,13591,13.0576713819,4595,12.5786163522,27984,11065,-8996
932,ELBIT SYS LTD,88.3210779279,73029,93.796464563,96848,90.937105174,64902,95.8283671037,58730,23819,-31946
933,ELDORADO GOLD CORP NEW,2.96979418035,1394036,3.15966711258,2525899,4.50012170647,4473879,3.93000808322,2213227,1131863,1947980
934,ELECTRO SCIENTIFIC INDS,5.18712949075,112008,7.14752742493,178943,5.83937234234,66788,5.64446818889,43051,66935,-112155
935,ELECTRONIC ARTS INC,68.7198255431,1331217,66.1100523879,3579259,75.7601113557,3292511,85.3997399803,4336594,2248042,-286748
936,ELECTRONICS FOR IMAGING INC,46.7397965437,2284520,42.3899522603,2855488,43.0401298727,2828616,48.9200446504,2768170,570968,-26872
937,ELEPHANT TALK COMM CORP,0.26507035409,45271,0.213513000569,42152,0.174768431828,40053,0.173172167769,28873,-3119,-2099
938,ELLIE MAE INC,60.2151931553,46284,90.6395815377,134588,91.651293905,134979,105.300204353,308290,88304,391
939,ELLIS PERRY INTL INC,18.4178231849,100229,18.4120693714,101944,20.1193122003,111137,19.2796783986,134079,1715,9193
940,EMBRAER S A,29.5408259674,476290,26.3594843495,227053,21.7209909114,689103,17.2600367926,277230,-249237,462050
941,EMCOR GROUP INC,48.039646898,1589229,48.6000120949,1620514,49.2600140313,1736114,59.6199671959,1680276,31285,115600
942,EMCORE CORP,6.1260210035,23996,5.02606686854,32033,5.94153427611,77926,5.72693952352,26192,8037,45893
943,EMERGENT BIOSOLUTIONS INC,40.0103068666,294949,36.3497089618,224541,28.1199122248,791112,31.5303884862,835448,-70408,566571
944,EMERGENT CAP INC,3.7011579337,18913,4.01116149285,17202,3.35017574692,18208,2.94515641169,12563,-1711,1006
945,EMERSON ELEC CO,47.8298654056,3355414,54.379871898,4401647,52.1600191249,2710601,54.5096521264,2518875,1046233,-1691046
946,EMPIRE DIST ELEC CO,28.0698157964,68294,33.0491743412,87627,33.9708045717,176740,34.1402890861,174896,19333,89113
947,EMPIRE ST RLTY TR INC,18.0699946915,5374379,17.5299342157,6242522,18.9900216514,7744067,20.9495882836,812331,868143,1501545
948,EMPLOYERS HOLDINGS INC,27.2973730953,21394,28.1052920208,7294,29.0173482289,48247,29.8470277542,20069,-14100,40953
949,EMPRESA DIST Y COMERCIAL NOR,17.5277274785,141376,16.7001823542,138741,17.5084031826,141018,19.8023450339,135691,-2635,2277
950,EMPRESA NACIONAL DE ELCTRCID,37.0574611228,36268,41.6158930616,27081,27.7288462381,114105,19.8377761844,330531,-9187,87024
951,ENABLE MIDSTREAM PARTNERS LP,9.1837787638,29073,8.56060049523,231409,13.4993217521,45706,15.2472448214,69324,202336,-185703
952,ENBRIDGE ENERGY MANAGEMENT L,22.3298021293,757060,17.950668475,708553,23.0102978808,644016,25.4403023711,546613,-48507,-64537
953,ENBRIDGE ENERGY PARTNERS L P,23.0700454224,1003249,18.3204613298,1134633,23.2003027872,1817778,25.4295896176,2779164,131384,683145
954,ENBRIDGE INC,33.1899817231,6492893,38.9099541693,4246060,42.3601252407,3342365,44.2298732519,4891513,-2246833,-903695
955,ENCANA CORP,5.09017619317,1029041,6.08945211654,1255778,7.78992468322,12507438,10.4700023195,12519768,226737,11251660
956,ENCORE CAP GROUP INC,29.0784038418,49143,25.7455601474,17906,23.5403307459,11852,22.4945761809,26273,-31237,-6054
957,ENCORE WIRE CORP,37.0836671626,8737,38.9509793073,9037,37.2628726287,20664,36.7747207845,14684,300,11627
958,ENDO INTL PLC,61.2199094664,7271556,28.1500574418,3237187,15.590937717,743124,20.1494018527,1314977,-4034369,-2494063
959,ENDOCYTE INC,4.02620034854,16641,3.10214590943,128943,3.20432517967,75835,3.09214594929,51744,112302,-53108
960,ENDOLOGIX INC,9.89997007442,4280619,8.35984218097,4003066,12.4597802848,2730626,12.8000969259,1667253,-277553,-1272440
961,ENDURANCE INTL GROUP HLDGS I,10.9299847495,15378521,10.530011306,15378521,8.99000625613,15378521,8.74999617974,15378521,0,0
962,ENDURANCE SPECIALTY HLDGS LT,63.9906010866,797539,65.3403109765,1458181,67.1600925537,2268088,65.450117122,2308277,660642,809907
963,ENDURO RTY TR,2.43035513564,230419,2.73071286907,169919,3.710431494,167905,3.54007154049,135308,-60500,-2014
964,ENERGEN CORP,40.9932912787,149805,36.5906208085,659076,48.2110985574,610710,57.7204738654,748989,509271,-48366
965,ENERGIZER HLDGS INC NEW,34.059037953,349775,40.5095912048,240585,51.4896832673,260693,49.9579313763,347052,-109190,20108
966,ENERGOUS CORP,7.90740822547,22637,10.1128796781,28083,12.9566009956,71315,19.6152857195,81671,5446,43232
967,ENERGY FUELS INC,2.9487771486,123441,2.21543419153,29791,2.2717950336,63386,1.59358171228,72792,-93650,33595
968,ENERGY RECOVERY INC,7.07360807197,131616,10.3410592246,122618,8.8736805475,17242,15.9850103932,34157,-8998,-105376
969,ENERGY TRANSFER EQUITY L P,13.7399934671,54239691,7.13002481131,39710521,14.3700224228,42398890,16.7899981811,50980887,-14529170,2688369
970,ENERGY TRANSFER PRTNRS L P,33.7299764188,12787735,32.3400257317,22336686,38.0700418255,22179776,37.0000060511,19170132,9548951,-156910
971,ENERNOC INC,3.84966417823,85462,7.48759925313,53021,6.33036164108,45653,5.41698910649,67196,-32441,-7368
972,ENERPLUS CORP,3.42028347692,209047,3.92774145939,336071,6.57005077437,235158,6.41170861234,189809,127024,-100913
973,ENERSYS,55.9284659916,493863,55.7195558008,529132,59.4706946908,1339416,69.1932609925,187446,35269,810284
974,ENI S P A,29.7982432348,239645,30.222356561,258054,32.3520830162,315312,28.8703141567,275404,18409,57258
975,ENLINK MIDSTREAM LLC,15.0880508292,403233,11.2437534703,115264,15.9063508731,179991,16.7503363192,121908,-287969,64727
976,ENLINK MIDSTREAM PARTNERS LP,16.5807467224,416085,12.069784459,389485,16.6294459795,396285,17.7105665173,389485,-26600,6800
977,ENNIS INC,19.2562316505,69484,19.5485468825,226513,19.1781826777,245383,16.8490917559,429400,157029,18870
978,ENOVA INTL INC,6.60476950979,73886,6.30785485626,63413,7.36120736121,64935,9.68365665018,63096,-10473,1522
979,ENPHASE ENERGY INC,3.51145038168,216150,2.31366716245,18153,1.98925800676,60324,1.18048050545,60145,-197997,42171
980,ENPRO INDS INC,43.8746016453,13493,57.6088582972,6683,44.3966360258,20452,56.8117473859,26491,-6810,13769
981,ENSCO PLC,15.3900325629,1891419,10.3701841701,3031383,9.71001259258,2345826,8.50022408506,1932302,1139964,-685557
982,ENSERVCO CORP,0.549168924361,27314,0.556999628667,16158,0.621032293679,14492,0.614533722538,13018,-11156,-1666
983,ENSIGN GROUP INC,22.6284030312,28504,22.6345170521,42634,21.0149059216,49108,20.1288612685,43768,14130,6474
984,ENSTAR GROUP LIMITED,150.040357351,797872,162.579962701,797872,161.990895783,797872,164.468111125,449765,0,0
985,ENSYNC INC,0.381198914913,112802,0.281326417993,138629,0.370739584277,121379,0.991510193964,48411,25827,-17250
986,ENTEGRIS INC,13.2700025202,5273473,13.6201956996,5034656,14.4697447672,4954614,17.4199339844,4301107,-238817,-80042
987,ENTERCOM COMMUNICATIONS CORP,11.2318322087,272529,10.5800121375,235633,13.5696539923,243116,12.9402353448,241263,-36896,7483
988,ENTERGY CORP NEW,68.359540829,1048237,79.2799032506,926931,81.3504244121,977352,76.7296341687,1774725,-121306,50421
989,ENTEROMEDICS INC,0.131622244159,91170,0.955160520032,37690,0.276065151376,32601,0.12445937957,32139,-53480,-5089
990,ENTERPRISE PRODS PARTNERS L,25.5800192259,37178940,24.6199945386,45006590,29.2600073189,44309695,27.629997979,36026387,7827650,-696895
991,ENTRAVISION COMMUNICATIONS C,7.72643253235,27050,7.43310208127,12108,6.70745190536,13567,7.6328719853,53322,-14942,1459
992,ENVESTNET INC,29.8549739406,17652,27.1941607319,78914,33.3104366483,117921,36.4485237552,188485,61262,39007
993,ENVISION HEALTHCARE HLDGS IN,25.9701229227,3843147,20.3997322285,1849338,25.3695494209,1432623,22.2701093187,1405157,-1993809,-416715
994,ENVIVA PARTNERS LP,18.1495174066,1028402,21.7198205169,1048121,22.7601362823,1048412,26.9897212688,1086710,19719,291
995,ENZO BIOCHEM INC,4.49928933819,106239,4.55171380667,173561,5.9599953483,34396,5.09371180831,112099,67322,-139165
996,ENZYMOTEC LTD,9.79952054999,969027,9.03023837985,932755,8.36029205428,1133214,6.9997207094,916608,-36272,200459
997,EOG RES INC,70.7899579,1279334,72.5808735027,1871843,83.4201992292,1727759,96.7094320821,1910734,592509,-144084
998,EP ENERGY CORP,4.37994514029,1970116,4.51995429746,3697825,5.17977580736,1942169,4.37938879594,690964,1727709,-1755656
999,EPAM SYS INC,78.6135534539,102247,74.6689906614,125072,64.3068045311,267219,69.3124613249,298965,22825,142147
1000,EPIQ SYS INC,13.0810195957,38682,15.020424733,39413,14.5864106352,59576,16.4997693289,36849,731,20163
1001,EPR PPTYS,58.4502234849,1586461,66.6200783282,2140736,80.6796048555,2343244,78.7397326476,2168524,554275,202508
1002,EQT CORP,52.1297876636,435912,67.260396388,395017,77.430090244,493994,72.6195801661,1142309,-40895,98977
1003,EQT GP HLDGS LP,20.7600522271,5436258,26.9700208166,5042599,25.4901129908,4011830,25.0699569017,3789476,-393659,-1030769
1004,EQT MIDSTREAM PARTNERS LP,75.4600108473,6099204,74.4298984361,5465035,80.300056779,4244530,76.1900525947,3867119,-634169,-1220505
1005,EQUIFAX INC,111.369705885,571035,114.290895079,661785,128.399032801,538462,134.580842754,641919,90750,-123323
1006,EQUINIX INC,302.400066094,2445016,330.709909741,1873379,387.730667685,1363921,360.249983389,1354490,-571637,-509458
1007,EQUITY COMWLTH,27.6710766947,2090992,28.2203656416,2218894,29.1302874296,2292631,30.2200892029,2302839,127902,73737
1008,EQUITY LIFESTYLE PPTYS INC,66.6698267295,1244701,72.7304500455,1556487,80.0497123278,870609,77.1791999977,690173,311786,-685878
1009,EQUITY ONE,27.1506220451,226109,28.6609908829,679495,32.1796776268,676545,30.6102654389,680458,453386,-2950
1010,EQUITY RESIDENTIAL,81.5903780158,1998091,75.0296741918,1727090,68.8799871021,1612660,64.3298063654,2509521,-271001,-114430
1011,ERA GROUP INC,11.1595199878,39249,9.36480656589,28511,9.40016317264,28191,8.05373975225,27689,-10738,-320
1012,ERICSSON,9.61052746821,1561933,10.030535892,1010614,7.68087899523,832587,7.21011450002,953799,-551319,-178027
1013,ERIE INDTY CO,95.6621660442,17405,92.9995237771,29398,99.3610344436,26449,102.068807864,26247,11993,-2949
1014,ERIN ENERGY CORP,3.20350880965,93023,1.87909962717,200628,2.41012357842,188787,2.35120596911,115260,107605,-11841
1015,ESCO TECHNOLOGIES INC,36.1487149304,20388,38.9655774943,28615,39.9389980721,34753,46.4212504271,23416,8227,6138
1016,ESPERION THERAPEUTICS INC NE,22.2692774381,42031,16.9218765239,41012,9.87253186703,48012,13.8570451712,49722,-1019,7000
1017,ESSENDANT INC,32.5171821306,46560,31.9273035286,134587,30.5660408942,119479,20.5233099296,87023,88027,-15108
1018,ESSENT GROUP LTD,21.8899678306,5096764,20.7999519198,4559049,21.8099277882,4064571,26.6099490556,2800306,-537715,-494478
1019,ESSEX PPTY TR INC,239.408798018,399931,233.860886133,282373,228.090345552,233105,222.698141767,248408,-117558,-49268
1020,ESTERLINE TECHNOLOGIES CORP,81.0003496034,1198501,64.0705376344,1162500,62.0399619266,791103,76.0399788648,853551,-36001,-371397
1021,ETFIS SER TR I,29.05,100000,19.05,100000,18.0,100000,22.65,100000,0,0
1022,ETFS TR,24.5519044063,10712,24.0851381628,10712,22.8715459298,10712,23.9917849141,10712,0,0
1023,ETHAN ALLEN INTERIORS INC,27.8209728002,230222,31.8168866939,252696,33.0374564793,209096,31.2716515511,128455,22474,-43600
1024,ETSY INC,8.2602283175,208832,8.71128318584,7232,9.589380174,218158,14.2805623062,551799,-201600,210926
1025,EURONAV NV ANTWERPEN,13.7100451063,1807288,10.2398421245,960757,9.17048385944,867566,7.63011588296,1198278,-846531,-93191
1026,EURONET WORLDWIDE INC,72.4328057057,92679,74.1050027063,64665,69.1890606421,210250,81.8303617438,261981,-28014,145585
1027,EV ENERGY PARTNERS LP,2.79052461863,16126,1.93394414879,72908,2.31260369011,19891,2.42265179428,19813,56782,-53017
1028,EVERBANK FINL CORP,15.9800792184,3115942,15.089968239,3142220,14.8601153552,3067742,19.3597325618,2830411,26278,-74478
1029,EVERCORE PARTNERS INC,54.0755088432,62986,51.7474056494,171912,44.1854056437,181440,51.510015261,627742,108926,9528
1030,EVEREST RE GROUP LTD,183.089956987,1210334,197.429946276,1234838,182.670793166,478210,189.968312853,388170,24504,-756628
1031,EVERI HLDGS INC,4.38632117618,24622,2.26740784084,13672,1.14884715189,174958,2.47296855145,131421,-10950,161286
1032,EVERSOURCE ENERGY,51.0699625401,891620,58.3389791853,1192616,59.8994682171,927070,54.1793759354,1055660,300996,-265546
1033,EVERTEC INC,16.7399929052,981004,13.9806376007,401913,15.5407238591,276435,16.7770226784,183346,-579091,-125478
1034,EVERYDAY HEALTH INC,6.01979672552,2562545,5.59967992647,622357,7.87822479032,157142,7.68787238132,130075,-1940188,-465215
1035,EVINE LIVE INC,1.7777048463,73128,1.16717596204,170497,1.65162332397,302127,2.29017713973,265045,97369,131630
1036,EVOGENE LTD,8.04899788414,480184,6.51006808904,481869,6.24061932222,481042,6.37990029977,481042,1685,-827
1037,EVOLENT HEALTH INC,12.1103831646,901623,10.5593662121,885091,19.2007169255,540084,24.6197831061,490378,-16532,-345007
1038,EXACT SCIENCES CORP,9.22771284546,215438,6.73479859745,46772,12.2495279859,525408,18.5698676108,898714,-168666,478636
1039,EXCO RESOURCES INC,1.23990034744,1129123,0.988950055164,1924263,1.29750544115,310596,1.06887343719,268507,795140,-1613667
1040,EXELIXIS INC,5.64017908937,2904695,3.99999191666,3958758,7.80987418437,4227853,12.7898505932,7158645,1054063,269095
1041,EXELON CORP,28.7773552797,2042613,36.3399512229,3062910,36.8488712489,2918624,33.9741589883,4513136,1020297,-144286
1042,EXETER RES CORP,0.326093285972,85865,0.563046377241,33745,1.29300392519,21655,1.28168612931,14044,-52120,-12090
1043,EXFO INC,2.73829268564,179674,3.71784454067,179674,3.46182530583,179674,3.71784454067,179674,0,0
1044,EXLSERVICE HOLDINGS INC,44.9362340585,26660,51.7966535613,43748,52.4099908111,59855,49.8401133123,161677,17088,16107
1045,EXONE CO,10.0374055834,69241,13.1552152486,24553,10.5680998041,38796,15.2165258548,22607,-44688,14243
1046,EXPEDIA INC DEL,124.299437283,1588366,107.82014014,2854578,106.29962022,3148666,116.719763143,2825674,1266212,294088
1047,EXPEDITORS INTL WASH INC,45.0997401496,2547620,48.810201088,2835227,49.0401489737,2480437,51.5199242723,2011416,287607,-354790
1048,EXPONENT INC,49.964140569,12549,51.0305491941,23143,58.4434778937,23681,51.0742555597,26530,10594,538
1049,EXPRESS INC,17.2813596137,272548,21.4096645396,897632,14.5091096498,838232,11.7895230282,511980,625084,-59400
1050,EXPRESS SCRIPTS HLDG CO,87.4101913311,2467607,68.6896807633,2112821,75.7999557187,2610582,70.5297977808,1962277,-354786,497761
1051,EXTENDED STAY AMER INC,15.9015569464,334244,16.3001081429,597358,14.9495521067,1095685,14.1996599721,1329891,263114,498327
1052,EXTERRAN CORP,16.0506726589,1092976,15.4600318928,1091783,12.8519476988,205961,15.6777453046,88278,-1193,-885822
1053,EXTRA SPACE STORAGE INC,88.2098396031,1475527,93.4597274638,1074206,92.5407791465,678717,79.4097201533,755235,-401321,-395489
1054,EXTREME NETWORKS INC,4.08569296906,28147,3.11023283787,58195,3.38983050847,364325,4.49028499162,406433,30048,306130
1055,EXXON MOBIL CORP,77.9499988987,16117845,83.5899415307,17599139,93.7400498679,15602808,87.2798955564,16703377,1481294,-1996331
1056,EZCORP INC,4.9908723432,306760,2.97080136052,304295,7.55907773098,292496,11.0576886789,264974,-2465,-11799
1057,F M C CORP,39.1309400076,309806,40.369724753,415336,46.3098195154,1031833,48.3396893385,2555064,105530,616497
1058,F5 NETWORKS INC,96.9596710231,1617621,105.849966488,1529325,113.839928078,896522,124.640440992,997750,-88296,-632803
1059,FACEBOOK INC,104.660009022,9255025,114.09995157,10737200,114.28003714,10045289,128.27006079,11662589,1482175,-691911
1060,FACTSET RESH SYS INC,162.570093458,449400,151.53136587,530768,161.419898467,611424,162.100045934,622634,81368,80656
1061,FAIR ISAAC CORP,94.1843404028,149940,106.093163856,164742,113.010335313,171064,124.591953749,272947,14802,6322
1062,FAIRPOINT COMMUNICATIONS INC,16.0792457066,35636,14.8732910017,34962,14.6766085226,88917,15.0294963913,62211,-674,53955
1063,FARMERS NATL BANC CORP,8.59002589106,41327,8.91288172622,63167,8.81934566145,24605,10.7930549038,21310,21840,-38562
1064,FARO TECHNOLOGIES INC,29.6271637816,3004,32.2328931573,16660,33.8721394842,11012,35.9433800889,46768,13656,-5648
1065,FASTENAL CO,40.8196491546,1412702,49.000578807,919132,44.3901744363,1411461,41.7797080703,1520092,-493570,492329
1066,FATE THERAPEUTICS INC,3.37192312015,26691,1.79963662289,173924,1.69604626592,35966,3.13408814976,35417,147233,-137958
1067,FBL FINL GROUP INC,63.7085283941,4913,61.4739783444,5726,60.6370543542,27376,63.9776185938,32527,813,21650
1068,FCB FINL HLDGS INC,35.7901949269,143028,33.2646746577,110207,33.9986512642,114181,38.4301276225,390605,-32821,3974
1069,FEDERAL AGRIC MTG CORP,29.3529988738,27527,37.6072135474,45470,35.3218923091,33039,41.1745466439,82551,17943,-12431
1070,FEDERAL REALTY INVT TR,146.099610571,1525822,156.050442584,1229596,165.549720084,1091219,153.929604317,1158679,-296226,-138377
1071,FEDERAL SIGNAL CORP,15.8490672457,283676,13.258812462,271065,12.8814080394,325275,13.2559684144,108404,-12611,54210
1072,FEDERATED INVS INC PA,28.6498273137,683320,28.8497341882,639174,28.7796442688,542432,29.6302232765,623890,-44146,-96742
1073,FEDEX CORP,148.989707633,1346046,162.719761588,1226784,151.77995114,1468692,174.679724421,1580670,-119262,241908
1074,FELCOR LODGING TR INC,7.30119149405,490057,8.12157842214,354734,6.22837592766,310996,6.42970192561,1182792,-135323,-43738
1075,FEMALE HEALTH CO,1.44761904762,26250,1.86029764762,16664,1.23762376238,16160,1.248049922,16025,-9586,-504
1076,FERRARI N V,48.0034390524,62808,41.6998227898,1118446,40.9292971063,851224,51.8698970367,1050860,1055638,-267222
1077,FERRELLGAS PARTNERS L.P.,16.6013661484,184021,17.4026523702,141760,18.4804173709,217744,11.6421945076,195324,-42261,75984
1078,FERRO CORP,11.1152041258,124874,11.8701390991,227967,13.3795166094,391195,13.8106942448,323445,103093,163228
1079,FERROGLOBE PLC,10.7497835662,2113810,8.81004527895,1904417,8.61093931358,944264,9.03116821813,673667,-209393,-960153
1080,FIAT CHRYSLER AUTOMOBILES N,16.7018609653,8986304,13.4465104541,3047259,16.7470968363,1309003,8.35443048218,2471503,-5939045,-1738256
1081,FIBRIA CELULOSE S A,12.6896688046,384486,8.47864555082,224918,6.76233644688,108986,7.07114014936,312538,-159568,-115932
1082,FIBROCELL SCIENCE INC,4.56240188383,20384,2.50440589927,32343,1.1529864471,141372,0.720751277214,141519,11959,109029
1083,FIBROGEN INC,30.4711963282,373008,21.2904413551,782182,16.4093228641,820692,20.6960416936,139302,409174,38510
1084,FIDELITY,28.6963445965,1397739,29.8460437431,1145780,30.1312956375,854560,28.9315644868,840397,-251959,-291220
1085,FIDELITY & GTY LIFE,25.370925064,458044,26.2397688974,178622,23.1800283204,206212,23.1886144911,208335,-279422,27590
1086,FIDELITY NATIONAL FINANCIAL,30.5817939397,1776024,33.0631003048,1195018,36.1743854914,1265564,35.6712062112,1348006,-581006,70546
1087,FIDELITY NATL INFORMATION SV,60.6000945109,10077146,63.3099765549,9506448,73.6800829914,6181847,77.0299810154,5704610,-570698,-3324601
1088,FIDELITY SOUTHERN CORP NEW,22.3112128146,27968,16.0040923707,13684,15.6643476034,23429,18.3977356633,16252,-14284,9745
1089,FIFTH STREET FINANCE CORP,6.38005034921,2147005,5.01990041157,3878563,4.84992489803,3958618,5.810115379,3983914,1731558,80055
1090,FIFTH THIRD BANCORP,20.0999951992,7894579,16.6900712444,9818592,17.5899737318,8335544,20.4600381724,8123152,1924013,-1483048
1091,FINANCIAL ENGINES INC,33.6725043212,61326,31.4290783288,112730,25.873746952,88584,29.7101112093,42982,51404,-24146
1092,FINISAR CORP,14.5435791645,155120,18.2449664673,137627,17.5097638521,429646,29.7993302218,948075,-17493,292019
1093,FINISH LINE INC,18.0725586389,134126,21.1014401635,203588,20.1910829408,460847,23.0801810138,434442,69462,257259
1094,FIREEYE INC,20.7379659112,133475,17.9910218215,519259,16.4701929876,369091,14.7298227163,1072518,385784,-150168
1095,FIRST AMERN FINL CORP,35.899737415,254013,38.1094200887,594315,40.220084855,639208,39.2800317108,895595,340302,44893
1096,FIRST BANCORP P R,3.25114313976,391247,2.9191161565,98660,3.96804466282,246469,5.19935896663,165982,-292587,147809
1097,FIRST BUSEY CORP,20.63055438,28356,20.4737488265,27694,21.3815789474,71744,22.6029403151,170730,-662,44050
1098,FIRST COMWLTH FINL CORP PA,9.0652561349,175064,8.86048614579,148186,9.19802890262,156664,10.0901854424,226755,-26878,8478
1099,FIRST CTZNS BANCSHARES INC N,258.187528039,31206,251.063616798,19979,258.91402125,15341,293.837591363,14913,-11227,-4638
1100,FIRST DATA CORP NEW,16.0198941639,8090815,12.9403818124,1350192,11.0700979334,1445064,13.1599967298,4256612,-6740623,94872
1101,FIRST FINANCIAL NORTHWEST IN,13.9924207721,24013,13.1775168786,36881,13.3039271485,28112,14.1690474129,34653,12868,-8769
1102,FIRST FINL BANCORP OH,18.0692471513,182188,18.1788687657,191101,19.4523688911,187535,21.8363697618,192935,8913,-3566
1103,FIRST FINL BANKSHARES,30.1701225348,1536951,29.5805101919,1502611,32.7898816337,1520957,36.4396366231,1490904,-34340,18346
1104,FIRST HORIZON NATL CORP,14.5201162056,5730877,13.1003079027,1661564,13.7797584144,1995318,15.2300009455,2072948,-4069313,333754
1105,FIRST INDUSTRIAL REALTY TRUS,22.1300836575,614051,22.7407063441,1104759,27.819761871,1200190,28.2198054791,1162446,490708,95431
1106,FIRST INTST BANCSYSTEM INC,29.0696601001,108326,28.1289667428,59085,28.100488803,43985,31.4988018861,51748,-49241,-15100
1107,FIRST LONG IS CORP,29.9996720244,396371,28.5002369634,417786,28.6688699649,436013,33.1502513927,434778,21415,18227
1108,FIRST MAJESTIC SILVER CORP,3.2718995415,277209,6.47963866699,110037,13.5794651478,571672,10.3002791206,1670246,-167172,461635
1109,FIRST MERCHANTS CORP,25.4200293817,1216403,23.5698564983,1410785,24.9304077549,1571655,26.7497825318,1673808,194382,160870
1110,FIRST MIDWEST BANCORP DEL,18.4304109981,2012272,18.0202384835,2373498,17.5598738552,2304971,19.3602916388,2304769,361226,-68527
1111,FIRST NBC BK HLDG CO,37.3867749914,122102,20.6048921557,16598,16.7894136301,67483,9.42531744993,15278,-105504,50885
1112,FIRST POTOMAC RLTY TR,11.4004694311,187887,9.06117751604,137289,9.19754198443,99918,9.15254793801,121824,-50598,-37371
1113,FIRST REP BK SAN FRANCISCO C,66.0599828317,4072632,66.6398566729,2819844,69.9898448276,2622309,77.1099736101,2355065,-1252788,-197535
1114,FIRST SOLAR INC,65.9904974955,1132754,68.4695045928,982525,48.4801552403,770934,39.4904209884,1024375,-150229,-211591
1115,FIRST SOUTH BANCORP INC VA,8.55583895651,30973,8.25483815722,29195,9.34127878885,24836,9.93863970271,23142,-1778,-4359
1116,FIRST TR EXCH TRD ALPHA FD I,21.8966793479,116182,21.7056184105,72654,23.0646214834,44397,26.0757447464,51964,-43528,-28257
1117,FIRST TR EXCHANG TRADED FD I,52.0,50000,52.9,50000,53.9511201629,49100,53.9473969514,46119,0,-900
1118,FIRST TR EXCHANGE TRADED FD,35.9124724356,5240909,32.8868527703,5804508,34.2452539309,5147049,36.9497335296,2653578,563599,-657459
1119,FIRST TR EXCNGE TRD ALPHADEX,27.0882113243,77303,27.8975193168,73770,28.5483218763,49460,30.1523158222,48255,-3533,-24310
1120,FIRST TR ISE CHINDIA INDEX F,28.3578891648,79343,27.2603957154,106895,27.1475446616,106971,30.3732900533,8626,27552,76
1121,FIRST TR ISE WATER INDEX FD,30.0967776242,9403,33.1050228311,7884,35.1796407186,8016,37.760045597,7018,-1519,132
1122,FIRST TR LRG CP GRWTH ALPHAD,48.2102189781,171250,48.2699528877,372302,49.860519266,487881,50.5006339906,434549,201052,115579
1123,FIRST TR LRGE CP CORE ALPHA,43.3076587705,6881,44.5351642234,5389,45.058032084,27054,46.783625731,10773,-1492,21665
1124,FIRST TR MULTI CAP VALUE ALP,49.7243407958,56773,49.5129727159,56773,51.2039173551,56773,52.9124760009,56773,0,0
1125,FIRST TR MULTI CP VAL ALPHA,40.7369066789,104328,43.037343762,104328,42.4791679338,82205,45.5446748981,82205,0,-22123
1126,FIRST TR NAS100 EQ WEIGHTED,43.4796482316,156694,42.2277246678,156698,41.8703493344,156698,45.7646417192,104513,4,0
1127,FIRST TR NASDAQ100 TECH INDE,42.648269374,51022,42.9284853256,203245,43.3319392851,203245,50.9071377417,50268,152223,0
1128,FIRST TR SML CP CORE ALPHA F,44.1818081405,90535,45.1058247537,85377,46.0337369735,85307,49.8137693551,85378,-5158,-70
1129,FIRST TR US IPO INDEX FD,51.1323173337,7021,50.0076934913,6499,50.5212090796,95643,54.3035961415,48413,-522,89144
1130,FIRSTENERGY CORP,31.7299727461,16267395,35.969976959,13989389,34.9099517431,9044928,33.080021268,9635151,-2278006,-4944461
1131,FIRSTSERVICE CORP NEW,40.4374141107,34201,40.9523809524,27300,45.827801544,40674,46.6866251315,37077,-6901,13374
1132,FISERV INC,91.4600333231,1568882,102.579841107,1177902,108.730557266,1109219,99.4704089835,1160707,-390980,-68683
1133,FITBIT INC,29.5905069445,537909,15.1521164546,125989,12.2201846465,189768,14.8398438664,839025,-411920,63779
1134,FIVE BELOW INC,32.0999110906,3728515,41.3398827706,2228792,46.4102827148,1871568,40.289700407,2181426,-1499723,-357224
1135,FIVE PRIME THERAPEUTICS INC,41.5040202849,179838,40.6349931476,87560,41.3494435542,180341,52.4900970731,654352,-92278,92781
1136,FIVE STAR QUALITY CARE INC,3.18645302258,76888,2.28641395337,80038,2.33764917893,138173,1.90587890339,40926,3150,58135
1137,FLAGSTAR BANCORP INC,23.1161314577,114379,21.4714875811,74564,24.4051250763,121286,27.7550302185,147757,-39815,46722
1138,FLEETCOR TECHNOLOGIES INC,142.929643932,2202923,148.749655113,1765073,143.130125741,1538558,173.730156568,1615396,-437850,-226515
1139,FLEETMATICS GROUP PLC,50.7954362848,62230,40.7070294676,166556,43.3405093627,24619,59.9789869179,763334,104326,-141937
1140,FLEXION THERAPEUTICS INC,19.2541772712,27111,9.19058837216,34383,14.957572271,20859,19.5281702953,32978,7272,-13524
1141,FLEXSHARES TR,22.5016873608,564491,36.1083957311,99229,36.6357329671,99029,37.8552760536,48976,-465262,-200
1142,FLEXSTEEL INDS INC,44.1062276751,6439,43.758043758,5439,39.627596085,8378,51.7427722237,7402,-1000,2939
1143,FLIR SYS INC,28.0701257505,353080,32.950018292,694294,30.9506114177,246231,31.4208585876,350436,341214,-448063
1144,FLOTEK INDS INC DEL,11.450929715,27858,7.32537596415,46414,13.2141469102,51460,14.5470120723,63037,18556,5046
1145,FLOWERS FOODS INC,21.4899283129,2530162,18.4605326405,1242001,18.7500275849,906292,15.120391208,886485,-1288161,-335709
1146,FLOWSERVE CORP,42.0785789295,326627,44.4097217789,626552,45.170257123,638916,48.2401626508,625143,299925,12364
1147,FLUIDIGM CORP DEL,10.8103014875,626162,8.08349534432,19546,9.02676342615,129393,8.0104135376,139818,-606616,109847
1148,FLUOR CORP NEW,47.2195091054,1389341,53.7000151687,1509683,49.2804523906,1241405,51.3202888197,1441730,120342,-268278
1149,FLUSHING FINL CORP,21.6399917712,1215250,21.6197935803,1197560,19.8804609858,1225374,23.7205003047,1225733,-17690,27814
1150,FMC TECHNOLOGIES INC,29.0098270615,1147749,27.3600089967,3788047,26.6700954728,5751273,29.6700711319,5372552,2640298,1963226
1151,FNB CORP PA,13.3408298556,425086,13.0100962524,1800371,12.5399543882,1817072,12.300036167,1841458,1375285,16701
1152,FOMENTO ECONOMICO MEXICANO S,92.3501381786,217834,96.3153260287,220318,92.4889311944,229022,92.0408981171,1042982,2484,8704
1153,FOOT LOCKER INC,65.0903639413,1786332,64.5000382049,1858402,54.8603045611,1699626,67.7197742209,2221109,72070,-158776
1154,FORBES ENERGY SVCS LTD,0.280765409702,46302,0.460981231478,30370,0.186254423543,26845,0.149242593836,26802,-15932,-3525
1155,FORD MTR CO DEL,14.0899942855,41176170,13.4999849412,42035158,12.5700085791,25035146,12.0700290698,31806220,858988,-17000012
1156,FORMFACTOR INC,9.00926832076,34742,7.28343406168,25812,8.98876404494,53400,10.8503993689,550118,-8930,27588
1157,FORTINET INC,31.1719533386,481683,30.630994028,674317,31.5900582442,526748,36.9278391105,441943,192634,-147569
1158,FORTRESS BIOTECH INC,2.77143788719,12268,3.09307013276,57548,2.68930779716,272189,2.95652977318,21647,45280,214641
1159,FORTRESS INVESTMENT GROUP LL,5.09002919063,6600748,4.77981793205,795637,4.41964084792,777665,4.93982305788,794158,-5805111,-17972
1160,FORTRESS TRANS INFRST INVS L,11.2644972931,86999,9.94616707313,88979,9.19041280553,117949,12.5177697046,25324,1980,28970
1161,FORTUNA SILVER MINES INC,2.24406788305,78429,3.89821590855,167256,6.98276720789,200780,7.24036437636,343491,88827,33524
1162,FORTUNE BRANDS HOME & SEC IN,55.5000590084,7371830,56.0397885141,5599807,57.9698125726,4147952,58.0999651009,2968556,-1772023,-1451855
1163,FORUM ENERGY TECHNOLOGIES IN,12.4612183536,782909,13.1953398148,86091,17.305454833,88527,19.8614925554,395791,-696818,2436
1164,FORWARD AIR CORP,43.0097356462,1363854,45.3199584665,1090204,44.5304432931,1113710,43.2592769355,1022509,-273650,23506
1165,FOSSIL GROUP INC,36.5578546351,133870,44.4231158699,113567,28.5303689928,70977,27.7705848469,189229,-20303,-42590
1166,FOUNDATION MEDICINE INC,21.0707659687,15092,18.1527909177,16912,18.6579378069,21385,23.3533204094,22181,1820,4473
1167,FOUR CORNERS PPTY TR INC,24.1601266047,478971,17.9504610108,616363,20.5917452593,387971,21.3266797492,219631,137392,-228392
1168,FOX FACTORY HLDG CORP,16.5718768386,10198,15.8093053735,12208,17.3675264208,13531,22.9495571814,25970,2010,1323
1169,FQF TR,21.0385438972,56040,21.5950091534,56263,22.5760654734,35923,21.4354739524,11383,223,-20340
1170,FRANCESCAS HLDGS CORP,17.4036450553,40164,19.1608214756,134441,11.0495132499,524910,15.4321454616,330479,94277,390469
1171,FRANCO NEVADA CORP,45.7513685912,541798,61.380429771,583427,76.0593519982,325246,69.8690743619,277333,41629,-258181
1172,FRANKLIN COVEY CO,16.7406585276,32436,17.5764327268,32316,15.3237324447,33608,17.8125371714,33628,-120,1292
1173,FRANKLIN ELEC INC,27.0213537393,52403,32.1555025652,27678,33.0460949255,36555,40.7226368981,30278,-24725,8877
1174,FRANKLIN RES INC,36.8200170701,7236064,39.0499328986,7803112,33.3701278207,3006791,35.569967764,2872873,567048,-4796321
1175,FRANKLIN STREET PPTYS CORP,10.3470394638,166811,10.6122166105,115433,12.2697539275,132847,12.6035340235,214543,-51378,17414
1176,FRANKS INTL N V,16.6840779205,32546,16.474938373,24340,14.6055887501,82845,13.0052910053,94500,-8206,58505
1177,FREDS INC,16.3547462485,11862,14.8787251838,22717,16.0961128119,21558,9.06020786145,122293,10855,-1159
1178,FREEPORT-MCMORAN INC,6.77002893332,6130993,10.3399325429,5560868,11.1400857465,6432446,10.8600431974,16210709,-570125,871578
1179,FRESENIUS MED CARE AG&CO KGA,41.8354824067,118966,44.08010481,133575,43.5752467939,123281,43.7659316627,215373,14609,-10294
1180,FRESH DEL MONTE PRODUCE INC,38.8657715242,23311,42.0710526708,134154,54.4309865963,252393,59.900514446,282051,110843,118239
1181,FRONTIER COMMUNICATIONS CORP,4.67002387668,5535946,7.25274557793,4724142,4.93995528123,4078377,4.16009150707,9504839,-811804,-645765
1182,FRONTLINE LTD,2.98967540667,861632,8.37097247157,474019,7.87025995707,679266,7.16774334035,165324,-387613,205247
1183,FS INVT CORP,8.98326545977,58442,9.15891153257,33956,9.05306498854,153981,9.46848493634,282833,-24486,120025
1184,FTD COS INC,26.1789283001,17113,26.2528814138,46852,24.9579128451,108703,20.5714024345,174903,29739,61851
1185,FTI CONSULTING INC,34.6701608919,46553,35.5095021924,180853,40.6798490827,277238,44.5613550469,557501,134300,96385
1186,FUELCELL ENERGY INC,4.94654539652,18801,6.76437429538,15966,6.21905566961,16562,5.42389853138,11984,-2835,596
1187,FULING GLOBAL INC,2.55,20000,2.58814056479,17387,2.233002233,12987,2.3645320197,10150,-2613,-4400
1188,FULLER H B CO,36.4698985664,112586,42.4503861865,414955,43.9915147345,348840,46.4680055385,337996,302369,-66115
1189,FULTON FINL CORP PA,13.0099346447,932595,13.3797203933,1058916,13.500420193,1198259,14.5194633469,1359761,126321,139343
1190,FUTUREFUEL CORPORATION,13.5018397056,125020,11.7928338341,92853,10.8844572994,105104,11.2829185794,41390,-32167,12251
1191,G & K SVCS INC,62.9002632296,447518,73.2483914448,393210,76.568598751,409920,95.488070553,114297,-54308,16710
1192,G-III APPAREL GROUP LTD,44.2523768366,63635,48.8904388985,736913,45.7202413341,499888,29.151312618,611945,673278,-237025
1193,GAIN CAP HLDGS INC,8.09740354995,34085,6.5689211204,19029,6.31651812754,23114,6.17461820277,24293,-15056,4085
1194,GALAPAGOS NV,62.8796540644,369086,41.8197465141,349763,55.4715145376,300118,64.6613994705,289338,-19323,-49645
1195,GALECTIN THERAPEUTICS INC,1.62873251201,23945,1.41268963823,16281,1.44375902349,15238,1.12055896118,15171,-7664,-1043
1196,GALENA BIOPHARMA INC,1.46172586229,38995,1.36003956479,40440,0.467305746575,233252,0.350418022895,1472527,1445,192812
1197,GALLAGHER ARTHUR J & CO,40.9399924245,3820201,44.4801875758,4097757,47.5999880126,3470316,50.8696909888,2889992,277556,-627441
1198,GAMCO INVESTORS INC,31.0659429495,25977,37.0609247867,20156,32.7911857293,26684,28.4769895754,23598,-5821,6528
1199,GAMESTOP CORP NEW,28.0404269001,841321,31.7299041214,1100350,26.5793948616,1146151,27.5897953732,1295334,259029,45801
1200,GAMING & LEISURE PPTYS INC,27.802306845,219694,30.9205709599,908295,34.4799565472,2805804,33.4501005845,4371945,688601,1897509
1201,GANNETT CO INC,16.2902120886,1443689,15.1401952708,1409427,13.8091360913,1450489,11.6400317488,835307,-34262,41062
1202,GAP INC DEL,24.6999899075,19737336,29.3999366029,9369510,21.2199670905,3369845,22.2399758061,4060526,-10367826,-5999665
1203,GARMIN LTD,37.1691231221,899806,39.9607247771,991974,42.4193596203,1146882,48.1104511051,1203356,92168,154908
1204,GARTNER INC,90.6998891698,602724,89.3499074914,426447,97.4105194426,640167,88.4492556958,392044,-176277,213720
1205,GASLOG LTD,8.30100750665,75533,9.73625170411,93157,12.9841900097,69007,14.5474485517,31002,17624,-24150
1206,GASTAR EXPL INC NEW,1.30928272029,106165,1.10779308352,41524,1.09981078524,169120,0.847860437034,155686,-64641,127596
1207,GATX CORP,42.5420791492,84246,47.4945455201,110918,43.9651901446,81701,44.5479702081,135876,26672,-29217
1208,GAZIT GLOBE LTD,8.97968892757,184973,9.10164116571,216005,8.9405439889,322911,10.3410983933,297744,31032,106906
1209,GENCO SHIPPING & TRADING LTD,1.48867313916,77250,0.638553613462,79868,0.57304400978,104704,4.61077384154,13013,2618,24836
1210,GENER8 MARITIME INC,9.45183434845,98182,7.05897827501,136847,6.40374119486,170213,5.1211040986,174767,38665,33366
1211,GENERAC HLDGS INC,29.7698584264,857646,37.2402794063,359906,34.9600516731,284868,36.3008107272,552467,-497740,-75038
1212,GENERAL CABLE CORP DEL NEW,13.4304605253,382042,12.2100492432,461587,12.7085017959,531770,14.9805285671,276559,79545,70183
1213,GENERAL COMMUNICATION INC,19.7764173543,112710,18.3252876369,126983,15.7987660675,153493,13.7502069223,283923,14273,26510
1214,GENERAL DYNAMICS CORP,137.359924473,1105832,131.36945967,1354432,139.239889127,1210034,155.160197787,1065589,248600,-144398
1215,GENERAL ELECTRIC CO,31.1500083197,48901881,31.7900213237,52823840,31.4800106648,42720030,29.6200253061,41400336,3921959,-10103810
1216,GENERAL FIN CORP DEL,4.00129771818,36988,4.53527129665,18301,4.26294328432,16186,4.48205247092,25881,-18687,-2115
1217,GENERAL GROWTH PPTYS INC NEW,27.2099448923,2939881,29.7301444963,3492684,29.8199449406,4572879,27.599871852,2871680,552803,1080195
1218,GENERAL MLS INC,57.6598926927,2527320,63.3503403618,1883731,71.3202075788,1607679,63.8802260147,2172425,-643589,-276052
1219,GENERAL MOLY INC,0.192381685264,31188,0.32814858568,30474,0.343047289069,116602,0.280062360552,107119,-714,86128
1220,GENERAL MTRS CO,34.0098686722,13176646,31.4299930173,15614321,28.2999720842,8425344,31.7700384842,25646900,2437675,-7188977
1221,GENESCO INC,56.8394481438,45954,72.2411650362,62762,64.3140410368,34798,54.455566905,122375,16808,-27964
1222,GENESEE & WYO INC,53.6899994931,236748,62.6995201957,627756,58.9500217636,461781,68.9493355619,603066,391008,-165975
1223,GENESIS ENERGY L P,36.7399424752,7111715,31.7898671633,6574013,38.3698694579,5692722,37.9701001385,3634465,-537702,-881291
1224,GENESIS HEALTHCARE INC,3.46916925359,334374,2.32148283197,246825,1.77099205829,198194,2.67474278598,70661,-87549,-48631
1225,GENOMIC HEALTH INC,35.195660084,30231,24.7721886986,81866,25.8975342906,112057,28.9221927601,171218,51635,30191
1226,GENPACT LIMITED,24.9802469364,1406111,27.1901161898,2012827,26.8397305524,1780383,23.9501200134,1578990,606716,-232444
1227,GENTEX CORP,16.0092888042,690724,15.6905197122,1308051,15.4500428809,1161356,17.5599455213,1345847,617327,-146695
1228,GENTHERM INC,47.4067553562,70433,41.5913408947,86845,34.2436510858,67925,31.4200867902,217536,16412,-18920
1229,GENUINE PARTS CO,85.8904145201,923188,99.3596391827,978667,101.249045065,1002686,100.450340374,1002575,55479,24019
1230,GENVEC INC,1.82536258339,30131,0.815775408591,35549,0.565003672524,35398,0.465766185375,34352,5418,-151
1231,GENWORTH FINL INC,3.73001488825,14648467,2.72993241766,5660946,2.57990714677,6659542,4.95998077774,8839752,-8987521,998596
1232,GEO GROUP INC NEW,28.9049666212,114444,34.6692147094,362108,34.1791291989,561483,23.7798536021,407656,247664,199375
1233,GERDAU S A,1.19981541301,1701095,1.78152863151,350261,1.8180254289,255772,2.71895695632,463413,-1350834,-94489
1234,GERON CORP,4.83720309581,59952,2.92012375533,207183,2.68009420937,123130,2.26125752737,164068,147231,-84053
1235,GETTY RLTY CORP NEW,17.1517933713,19823,19.8302699475,23449,21.4470054285,33711,23.9376541099,55561,3626,10262
1236,GIBRALTAR INDS INC,25.4373725448,27951,28.5906169049,10423,31.569720335,979958,37.1502381089,991353,-17528,969535
1237,GIGAMON INC,26.5740115175,93249,31.0204372032,112442,37.3942501712,108038,54.7994190524,363544,19193,-4404
1238,GILDAN ACTIVEWEAR INC,28.4196914085,803457,30.509488824,758682,29.3292531866,573182,27.9509551447,130085,-44775,-185500
1239,GILEAD SCIENCES INC,101.189961965,9283490,91.8600198509,6784562,83.4199969875,9022429,79.1201152376,5457942,-2498928,2237867
1240,GLACIER BANCORP INC NEW,26.5298571842,2208229,25.4203736952,2096468,26.5802085739,2122030,28.5202778484,2038234,-111761,25562
1241,GLADSTONE INVT CORP,7.64379896809,10466,7.03080370875,22757,7.18222816102,17961,8.88696065945,71453,12291,-4796
1242,GLATFELTER,18.4431496873,46684,20.7327129226,144313,19.5600286713,135327,21.6803543082,137959,97629,-8986
1243,GLAXOSMITHKLINE PLC,40.3498455258,2251508,40.5500236962,3230479,43.3398921419,3188079,43.1296215813,3244290,978971,-42400
1244,GLOBAL BRASS & COPPR HLDGS I,21.3006539943,130888,24.9496851263,154030,27.2905542576,202451,28.8943361027,138297,23142,48421
1245,GLOBAL NET LEASE INC,7.95144021861,89292,8.55958058587,375953,7.95004038367,189433,8.15320192546,76657,286661,-186520
1246,GLOBAL PARTNERS LP,17.5700574625,1838241,13.5000480121,635257,13.7101538316,634785,16.1401149895,740763,-1202984,-472
1247,GLOBAL PMTS INC,64.509927132,1628013,65.29999197,1643844,71.3799193074,1860145,76.7596920195,2195853,15831,216301
1248,GLOBAL X FDS,12.8271232911,647768,12.7913569683,485015,20.4102766873,212442,21.666950183,158721,-162753,-272573
1249,GLOBALSTAR INC,1.44109123194,690449,1.46973987031,981126,1.20963995831,1582289,1.21012772088,1049476,290677,601163
1250,GLOBUS MED INC,27.8243503131,162232,23.7511877724,234683,23.8329742485,194940,22.5745454545,206250,72451,-39743
1251,GLOWPOINT INC,0.492724107348,30443,0.392969419834,55984,0.291266848978,123598,0.278316606224,118570,25541,67614
1252,GLU MOBILE INC,2.43001349223,141563,2.83514467577,35977,2.20181767076,85384,2.24524835809,83287,-105586,49407
1253,GNC HLDGS INC,31.0195579841,739340,31.7514978068,299104,24.2913126091,480501,20.4184024383,506259,-440236,181397
1254,GODADDY INC,32.0593959148,505624,32.3295550991,524319,31.1894136302,1223460,34.5304745817,1430881,18695,699141
1255,GOGO INC,17.798760958,90231,10.9939759036,39840,8.39616690198,66578,11.0392221369,82071,-50391,26738
1256,GOL LINHAS AEREAS INTLG S A,0.573611726224,374818,7.52781107982,35867,10.5908924429,32764,18.9432781046,37058,-338951,-3103
1257,GOLAR LNG LTD BERMUDA,15.7899002496,2578737,17.9700953395,4102705,15.500043012,4010505,21.199748509,3344851,1523968,-92200
1258,GOLAR LNG PARTNERS LP,13.3792158095,140068,14.6852769994,37112,18.332664258,59784,19.6289614691,557085,-102956,22672
1259,GOLD FIELDS LTD NEW,2.76988351424,2442702,3.94004405263,3912139,4.89981904838,4106070,4.84994819202,4494481,1469437,193931
1260,GOLD RESOURCE CORP,1.64885689825,31537,2.32558139535,12470,3.57036596251,13444,7.41683638832,58920,-19067,974
1261,GOLDCORP INC NEW,11.5597768919,1904189,16.2302208385,2354435,19.1299276365,4231694,16.5198803689,3717763,450246,1877259
1262,GOLDEN MINERALS CO,0.200169841077,164860,0.45001800072,166660,0.639507342492,42220,0.7688505684,18209,1800,-124440
1263,GOLDEN OCEAN GROUP LTD,1.06923877995,179567,0.697002323341,176470,0.663462676106,667709,4.04869682571,106701,-3097,491239
1264,GOLDEN STAR RES LTD CDA,0.16566564456,331994,0.454836013178,162696,0.645220926391,1092649,0.839705188989,1181367,-169298,929953
1265,GOLDMAN SACHS BDC INC,19.000118162,6051015,19.5999076447,6483653,19.9901197674,6483653,21.7699805958,6483653,432638,0
1266,GOLDMAN SACHS ETF TR,25.1646257092,15499098,26.4096377906,15525052,26.7093180311,16470282,28.7671264513,16454372,25954,945230
1267,GOLDMAN SACHS GROUP INC,19.8659316655,3454507,19.5969363387,3624291,22.5393120857,609291,21.4972087635,629291,169784,-3015000
1268,GOLDMAN SACHS MLP ENERGY REN,5.50068019164,16907,5.50068019164,16907,7.15679895901,16907,7.27509315668,16907,0,0
1269,GOLUB CAP BDC INC,16.629863264,695135,17.3111400226,671013,18.0713056991,661546,18.5703406564,657877,-24122,-9467
1270,GOODYEAR TIRE & RUBR CO,32.670000798,4398347,32.9800674033,4143715,25.6597772804,2868809,32.3001266195,1563740,-254632,-1274906
1271,GOPRO INC,18.0092264017,676320,11.9610188924,401220,10.8107202431,537152,16.6804060929,269298,-275100,135932
1272,GOVERNMENT PPTYS INCOME TR,15.8721800222,227883,17.8493415715,96138,23.0586214916,111802,22.6188173083,186084,-131745,15664
1273,GPO AEROPORTUARIO DEL PAC SA,88.28125,102400,88.7033461351,94258,102.62972679,62516,94.9569050595,60796,-8142,-31742
1274,GRACE W R & CO DEL NEW,99.589124754,722117,71.1805381456,1096915,73.2100490517,1099248,73.7999304867,932196,374798,2333
1275,GRACO INC,72.0700995065,2119159,83.9602765363,1869122,78.9902497893,1159257,74.0019904899,180860,-250037,-709865
1276,GRAHAM HLDGS CO,484.995864351,30225,479.997259899,29196,489.563745769,21272,481.388253242,26220,-1029,-7924
1277,GRAINGER W W INC,202.588778771,961998,233.429403519,662016,227.251072613,707385,224.839751211,378474,-299982,45369
1278,GRAMERCY PPTY TR,7.7198916677,7816690,8.44994449047,7938277,9.21993623629,8856135,9.64004678334,6570715,121587,917858
1279,GRAN TIERRA ENERGY INC,2.17607996743,71229,2.46626873692,104206,3.37337381382,68181,3.01279586483,205457,32977,-36025
1280,GRAND CANYON ED INC,40.1484306551,38806,42.7388888889,180000,39.9187964542,212306,40.3901070358,340727,141194,32306
1281,GRANITE CONSTR INC,42.9083375329,178590,47.7990790957,197849,45.5513556898,223023,49.7377972889,192027,19259,25174
1282,GRANITE REAL ESTATE INVT TR,27.5008075805,139305,28.7028082404,109606,30.1924413712,109332,30.6613745789,293268,-29699,-274
1283,GRAPHIC PACKAGING HLDG CO,12.8297769866,3178777,12.850015207,4297349,12.5398499415,4813056,13.9900709527,5078030,1118572,515707
1284,GRAY TELEVISION INC,16.3126779067,27402,11.7222916295,140075,10.8489401474,283530,10.3586537649,153881,112673,143455
1285,GREAT PLAINS ENERGY INC,27.3100333251,363090,32.2501416634,1140026,30.400353365,3282725,27.2901406292,5428957,776936,2142699
1286,GREAT SOUTHN BANCORP INC,45.2350698856,11805,37.1513552949,17819,36.992306316,22356,40.7122136641,19994,6014,4537
1287,GREAT WESTN BANCORP INC,29.0200564713,2085661,27.2699027158,2130664,31.5403630537,1967257,33.3198457578,2108113,45003,-163407
1288,GREEN DOT CORP,16.3551401869,5564,22.9705485356,414139,22.9926567955,58149,23.0618010011,60533,408575,-355990
1289,GREEN PLAINS INC,22.8984707793,326310,15.958719753,371897,19.722456203,117531,26.1972832789,216511,45587,-254366
1290,GREENBRIER COS INC,32.6264274062,72334,27.6415212995,103359,29.1288273089,55718,35.2963306327,74427,31025,-47641
1291,GREENHILL & CO INC,28.60926268,89866,22.2010783381,56754,16.0921642132,32811,23.5723820281,68173,-33112,-23943
1292,GREENLIGHT CAPITAL RE LTD,18.7120854372,220232,21.7891188355,268758,20.1591862577,287462,20.4412280939,259231,48526,18704
1293,GREIF INC,34.8837209302,80324,34.2372643002,341324,38.184296522,168001,49.5833490442,79563,261000,-173323
1294,GRIFFON CORP,17.7999718792,5817762,15.4500707898,5821462,16.8599391961,5832524,17.0099600105,5832524,3700,11062
1295,GRIFOLS S A,32.4002219787,1223541,15.4699442783,3024316,16.66998051,1730116,15.9706516231,1014298,1800775,-1294200
1296,GROUP 1 AUTOMOTIVE INC,75.7037788486,94632,58.6907140316,219234,49.3614846432,289578,63.8830553482,230468,124602,70344
1297,GROUPE CGI INC,40.0302882737,1494968,47.7796978361,1467548,42.7088655321,732026,47.6293007138,246151,-27420,-735522
1298,GROUPON INC,3.07007754109,3028588,3.98997386806,2343875,3.24992101693,3443776,5.15023006437,2441056,-684713,1099901
1299,GRUBHUB INC,24.1921903942,53447,25.1310089719,123274,31.0805926997,41505,42.9993777225,96420,69827,-81769
1300,GRUPO AEROPORTUARIO CTR NORT,38.4351092583,21829,45.599559956,18180,47.44283878,25673,47.0457174686,23339,-3649,7493
1301,GRUPO AEROPORTUARIO DEL SURE,140.668291871,102141,150.163340379,72854,159.558391403,23822,146.390752566,24742,-29287,-49032
1302,GRUPO AVAL ACCIONES Y VALORE,6.52138662305,141841,7.73218959289,200978,8.0503065025,284337,8.8295338118,393339,59137,83359
1303,GRUPO FINANCIERO GALICIA S A,27.0793615512,701826,28.2996531185,701104,30.5394274131,777454,31.1100201659,737383,-722,76350
1304,GRUPO FINANCIERO SANTANDER M,8.67882650884,35143,9.03426791277,12840,9.08694387903,13756,8.80062196198,285548,-22303,916
1305,GRUPO TELEVISA SA,27.2100571297,12475130,27.4600720857,12252080,26.0399454122,12227637,25.690060512,12772177,-223050,-24443
1306,GS FIN CORP,14.9518899488,240906,14.6187342435,244344,15.4392514494,252862,16.0004155952,307992,3438,8518
1307,GSV CAP CORP,9.36955258571,440576,5.59926045516,379693,5.01936879572,375346,4.72057408595,299328,-60883,-4347
1308,GTX INC DEL,0.692126048367,24562,0.517544767622,19322,0.547541726456,52964,0.789144873846,45619,-5240,33642
1309,GUESS INC,18.881472531,259037,18.7712018006,369662,15.0502845341,712744,14.6101590803,605606,110625,343082
1310,GUIDEWIRE SOFTWARE INC,60.1586026505,505414,54.4799024395,658463,61.7596181568,624340,59.9795465537,541718,153049,-34123
1311,GULF ISLAND FABRICATION INC,10.4506596729,49949,7.8431372549,68850,6.94556058136,87106,9.19458391132,81461,18901,18256
1312,GULFMARK OFFSHORE INC,4.6711409396,130375,6.17590686448,14087,3.13109926412,289994,1.68270997134,136090,-116288,275907
1313,GULFPORT ENERGY CORP,24.5699910548,5205008,28.3400719288,5820204,31.2599828464,4132088,28.251064091,700363,615196,-1688116
1314,GW PHARMACEUTICALS PLC,69.4435464056,77329,72.1117678667,9305,91.562548203,32415,132.724526229,87384,-68024,23110
1315,H & E EQUIPMENT SERVICES INC,17.4754112952,67409,17.5350353823,115312,19.0288898583,284252,16.7604211741,277320,47903,168940
1316,HAEMONETICS CORP,32.2433921261,19787,34.9806168011,231128,28.9913671107,232483,36.2102239576,222810,211341,1355
1317,HAIN CELESTIAL GROUP INC,40.3900181123,2484500,40.9102217318,2841857,49.7498155675,1895002,35.5802801394,1418651,357357,-946855
1318,HALCON RES CORP,1.25998416221,7671525,0.9630104243,260641,0.46597738757,399161,9.37965260546,20150,-7410884,138520
1319,HALLIBURTON CO,34.0401296146,4935557,35.7198016325,3781264,45.2899702142,3697397,44.8798771214,3576213,-1154293,-83867
1320,HALLMARK FINL SVCS INC    EC,11.6710395368,11053,11.4867732353,35345,11.5676106901,12535,10.3121672365,17843,24292,-22810
1321,HALOZYME THERAPEUTICS INC,17.3280956321,325079,9.46778307107,332496,8.63101689694,350596,12.0806499137,142542,7417,18100
1322,HALYARD HEALTH INC,33.4138953679,94751,28.7267943283,171025,32.5243808146,120279,34.6610913565,570611,76274,-50746
1323,HANCOCK HLDG CO,25.1699424294,297895,22.959701998,457715,26.1105728761,629630,32.42954302,473303,159820,171915
1324,HANESBRANDS INC,29.4296535444,1216664,28.3400468884,3207193,25.1300459858,3845755,25.2503146244,2563374,1990529,638562
1325,HANMI FINL CORP,23.7254153141,125688,22.0269184411,99560,23.4867481194,100099,26.3366984483,85584,-26128,539
1326,HANOVER INS GROUP INC,81.3445713548,170374,90.2179808801,235984,84.6210623123,253353,75.4200953052,334924,65610,17369
1327,HARDINGE INC,9.33782267116,22275,12.4730945416,36238,10.0559565323,36993,11.1315938741,28208,13963,755
1328,HARLEY DAVIDSON INC,45.389934742,749946,51.3300841661,2052013,45.3008894393,710560,52.5893003476,927432,1302067,-1341453
1329,HARMAN INTL INDS INC,94.2067005842,169627,89.0399838628,203257,71.8154821517,229658,84.4496076946,339149,33630,26401
1330,HARMONIC INC,4.06875958479,530137,3.27562285094,165770,2.85313465658,105498,5.92214083176,67712,-364367,-60272
1331,HARMONY GOLD MNG LTD,0.928708679748,1372874,3.63871245559,232225,3.61007329249,2474742,3.4904089391,1619581,-1140649,2242517
1332,HARRIS & HARRIS GROUP INC,2.1910449871,28297,1.62291843071,14172,1.63313785168,13471,1.3610888711,12490,-14125,-701
1333,HARRIS CORP DEL,86.9004494443,928925,77.8586783163,793155,83.4420455287,306620,91.608549857,486090,-135770,-486535
1334,HARSCO CORP,7.88382682767,220705,5.45096906117,179968,6.64082617299,184465,9.93033112287,89423,-40737,4497
1335,HARTE-HANKS INC,3.24113784327,142234,2.53206789517,167847,1.59108989658,243858,1.62168477626,213975,25613,76011
1336,HARTFORD FINL SVCS GROUP INC,43.4598247702,2591796,46.0801214812,3529765,44.380211911,2247736,42.8198015012,6614650,937969,-1282029
1337,HARVARD BIOSCIENCE INC,3.48159108713,11489,3.0153556551,57373,2.87102473498,31696,2.71580989331,15465,45884,-25677
1338,HARVEST NATURAL RESOURCES IN,0.427938254623,98145,0.614358434264,34182,0.839160839161,28600,0.817728350642,24458,-63963,-5582
1339,HASBRO INC,67.3603894717,421494,80.100473743,775526,83.9900945964,791891,79.3290750616,728308,354032,16365
1340,HAWAIIAN ELEC INDUSTRIES,28.9463527596,186552,32.401289096,172524,32.7896803932,170084,29.8506609863,875056,-14028,-2440
1341,HAWAIIAN HOLDINGS INC,35.3401891178,62818,47.1901592384,356070,37.9614658224,375407,48.5999670051,400062,293252,19337
1342,HCA HOLDINGS INC,67.6309213507,668703,78.0498084594,1010752,77.0095298248,968958,75.6297452286,911837,342049,-41794
1343,HCP INC,38.2397450115,4926968,32.5801683989,4879011,35.3797705255,5428752,37.9499416436,6313791,-47957,549741
1344,HD SUPPLY HLDGS INC,30.0304165331,761428,33.0701622921,1874953,34.8201268474,1756599,31.9799981939,952314,1113525,-118354
1345,HDFC BANK LTD,61.6012197769,723411,61.6315157904,390839,66.3492361797,649171,71.8893504662,785471,-332572,258332
1346,HEADWATERS INC,16.8710135827,181554,19.8399126194,362552,17.9392212964,398791,16.9215933139,373310,180998,36239
1347,HEALTHCARE RLTY TR,28.3203697756,1432220,30.8906194423,1245459,34.9901948381,1517568,34.0597014127,1869805,-186761,272109
1348,HEALTHCARE SVCS GRP INC,34.8704866411,1302993,36.8101764759,1395375,41.3797946331,1253172,39.5804975922,1486237,92382,-142203
1349,HEALTHCARE TR AMER INC,26.968903428,363159,29.419963331,695956,32.3420434926,257745,32.6206422521,301159,332797,-438211
1350,HEALTHEQUITY INC,25.0616029616,85629,24.66575824,50637,30.3916536354,83773,37.8472627918,333789,-34992,33136
1351,HEALTHSOUTH CORP,34.8101216969,1295514,37.6298616287,1195407,38.8201839089,1128820,40.5694902381,1158580,-100107,-66587
1352,HEARTLAND EXPRESS INC,17.0113590573,91821,18.5452099548,104070,17.3842620841,90139,18.8749778655,152477,12249,-13931
1353,HECLA MNG CO,1.89028836262,400468,2.78315626996,292833,5.09983285464,5370176,5.69997493333,7894947,-107635,5077343
1354,HEICO CORP NEW,53.8129945265,70522,53.270336894,121700,58.8247486786,192980,66.2955243045,227406,51178,71280
1355,HEIDRICK & STRUGGLES INTL IN,27.2190433356,120063,23.6931360668,122947,16.8806886333,113384,18.5533485674,113780,2884,-9563
1356,HELEN OF TROY CORP LTD,94.2581743595,74593,103.698877306,19952,102.836956997,91436,86.1689703857,286855,-54641,71484
1357,HELIX ENERGY SOLUTIONS GRP I,5.25767053917,134280,5.59750238027,225815,6.76094276094,259875,8.12876110421,314070,91535,34060
1358,HELMERICH & PAYNE INC,53.5499754064,1589842,58.7202310845,1456091,67.1302304613,1390819,67.3003288436,1465134,-133751,-65272
1359,HENRY JACK & ASSOC INC,78.0613125506,602552,84.5697350118,715315,87.2701562627,627981,85.5506106156,776102,112763,-87334
1360,HERBALIFE LTD,53.6195321616,1497141,61.5596909897,1237758,58.5300834176,1480982,61.989538508,1336903,-259383,243224
1361,HERITAGE COMMERCE CORP,11.966888609,22228,10.0284832661,16852,10.5311355311,10920,10.9590399683,20166,-5376,-5932
1362,HERITAGE CRYSTAL CLEAN INC,10.6105125694,12252,9.93693865851,10466,12.1994976677,30657,13.2779648596,57313,-1786,20191
1363,HERITAGE FINL CORP WASH,18.8404051758,747330,17.5690896886,878930,17.580516754,1003611,17.9501237335,997709,131600,124681
1364,HERITAGE INS HLDGS INC,21.8208689226,46011,15.9651669086,49608,11.9613304932,61030,14.4243978386,43676,3597,11422
1365,HERON THERAPEUTICS INC,26.7067374299,46917,18.9886921272,154671,18.0672768335,8413,17.2409233942,37817,107754,-146258
1366,HERSHA HOSPITALITY TR,21.758567882,210262,21.3413669361,316006,17.1482721508,318691,18.0214885485,332270,105744,2685
1367,HERSHEY CO,89.2712920185,323161,92.0909419877,710211,113.491192909,901603,95.6014673883,605702,387050,191392
1368,HESS CORP,48.4797897906,396557,52.6487679508,961447,60.0998137441,1564514,53.6195170633,1515064,564890,603067
1369,HEWLETT PACKARD ENTERPRISE C,15.1999513208,9926216,17.7299296264,9609288,18.2700037243,9234043,22.7499956533,8224573,-316928,-375245
1370,HEXCEL CORP NEW,46.4501414422,1492482,43.7094991911,2207209,41.6397309639,1163264,44.2993557034,883444,714727,-1043945
1371,HFF INC,31.1032118827,7877,27.5304330881,636314,28.8796966039,1447349,27.6902512484,1509701,628437,811035
1372,HHGREGG INC,3.63793850152,11545,2.11703398111,18422,1.78041543027,15165,1.83913683178,16312,6877,-3257
1373,HI-CRUSH PARTNERS LP,5.92011324723,733263,4.95834196231,251092,13.0699942279,1316680,15.3397530782,1443048,-482171,1065588
1374,HIBBETT SPORTS INC,30.2378268839,87837,35.9015633765,41001,34.8100145189,28239,39.8847297587,32619,-46836,-12762
1375,HIGHWOODS PPTYS INC,43.5998008264,4121028,47.8100285385,4852392,52.8001741049,3777033,52.1197776033,3997542,731364,-1075359
1376,HILL INTERNATIONAL INC,3.90516039052,10755,3.34323922734,16152,4.02491614758,10435,4.61947844598,46975,5397,-5717
1377,HILL ROM HLDGS INC,48.0579772733,222294,50.3016618069,337464,50.4488576047,270353,61.9825953572,297277,115170,-67111
1378,HILLENBRAND INC,29.6266670769,130018,29.9589695298,74335,30.0377578999,88988,31.6409462949,173857,-55683,14653
1379,HILLTOP HOLDINGS INC,19.2126899475,58503,18.8842474726,40457,20.9931719429,80550,22.459708696,116030,-18046,40093
1380,HILTON WORLDWIDE HLDGS INC,21.400076397,5269841,22.5199278588,2729094,22.5299908432,35527844,22.9299950085,33701054,-2540747,32798750
1381,HIMAX TECHNOLOGIES INC,8.19827712075,136980,11.2391744383,324579,8.25888007821,294592,8.59015539543,230380,187599,-29987
1382,HMS HLDGS CORP,12.3399423406,3380891,14.3501699583,1968130,17.6098407247,1370143,22.1700014639,1441317,-1412761,-597987
1383,HNI CORP,36.0546760285,74914,39.1677282378,58875,46.4835539397,70412,39.8028486048,128835,-16039,11537
1384,HOEGH LNG PARTNERS LP,18.6201105735,2435485,17.4300063523,2432185,17.8498299927,2395485,18.8199884366,2395485,-3300,-36700
1385,HOLLY ENERGY PARTNERS L P,31.1397959785,2884990,33.8300254085,3261511,34.6498736921,3272162,33.9299869556,3110906,376521,10651
1386,HOLLYFRONTIER CORP,39.889722863,3843045,35.3199229822,3645393,23.7697701675,2194468,24.5001955567,1321867,-197652,-1450925
1387,HOLOGIC INC,38.6898123519,3003814,34.5004030759,3314512,34.6001344596,2240078,38.8297557792,2722577,310698,-1074434
1388,HOME BANCSHARES INC,40.5208910094,995141,40.9501073391,1122610,19.7902666096,2366719,20.8098895192,2068776,127469,1244109
1389,HOME DEPOT INC,132.250059482,4644255,133.430165662,4293332,127.689959088,5014435,128.679884744,4191028,-350923,721103
1390,HOMETRUST BANCSHARES INC,20.272943038,10112,18.3338447376,13036,18.4858378188,22666,18.5052872249,27992,2924,9630
1391,HONDA MOTOR LTD,31.9288714059,496228,27.3415941074,429419,25.3297489045,413269,28.9221237571,530701,-66809,-16150
1392,HONEYWELL INTL INC,103.570115617,4890822,112.049960143,5416798,116.319899484,5364310,116.589798354,5429849,525976,-52488
1393,HOOKER FURNITURE CORP,25.2309389218,14506,32.8829449883,14506,21.4764173745,14481,24.4877561219,26013,0,-25
1394,HORACE MANN EDUCATORS CORP N,33.202181266,14487,31.6855962829,15496,33.7647338564,29439,36.6718560803,23124,1009,13943
1395,HORIZON PHARMA PLC,21.6697337847,2019268,16.5693163204,927920,16.4706691424,232656,18.1301071644,2106110,-1091348,-695264
1396,HORMEL FOODS CORP,79.0799834231,1327150,43.2402803878,2457454,36.6003172996,1542391,37.9301550327,1438987,1130304,-915063
1397,HORNBECK OFFSHORE SVCS INC N,9.93175989916,46014,9.92638328188,63165,8.3570465778,33385,5.49952129673,134739,17151,-29780
1398,HOSPITALITY PPTYS TR,26.1499177218,3288844,26.5599741728,3432044,28.8000221407,3685518,29.720153218,3482620,143200,253474
1399,HOST HOTELS & RESORTS INC,15.3399883828,3963106,16.6996709509,2750653,16.2100093101,3824859,15.5697363807,3359466,-1212453,1074206
1400,HOUGHTON MIFFLIN HARCOURT CO,21.7823902064,158798,19.9389953891,351121,15.6307432184,870592,13.4104876714,1158198,192323,519471
1401,HOUSTON WIRE & CABLE CO,5.28214779616,96173,6.99407957299,97797,5.24856810909,98122,6.18204184606,95923,1624,325
1402,HOVNANIAN ENTERPRISES INC,1.81086325821,416376,1.56265892426,216298,1.67656503083,70382,1.68809890274,100705,-200078,-145916
1403,HOWARD BANCORP INC,13.2230632651,21402,12.0095298293,20567,12.9807692308,16640,13.2075471698,13780,-835,-3927
1404,HOWARD HUGHES CORP,113.161488831,127402,105.888096427,178207,114.315487683,189047,114.498210138,151129,50805,10840
1405,HP INC,11.8400360809,10066270,12.3199752768,6963488,12.5499528106,6807675,15.5300225176,14351428,-3102782,-155813
1406,HRG GROUP INC,13.5599244089,292627,13.9280910796,422312,13.7286003391,475358,15.699513089,1017229,129685,53046
1407,HSBC HLDGS PLC,39.469464663,1153778,31.1200055288,1360154,31.116567198,1323700,37.1018360603,1360903,206376,-36454
1408,HSN INC,50.6703734092,769049,52.3114052203,361317,48.9276075034,208226,39.8013717896,184868,-407732,-153091
1409,HUB GROUP INC,32.9432899592,41192,40.7935984161,121220,38.3791470901,55551,40.7578595744,172433,80028,-65669
1410,HUBBELL INC,101.04055738,1843339,105.929915637,1616937,105.469994689,1393420,107.739975708,1349397,-226402,-223517
1411,HUBSPOT INC,56.3259776835,28051,43.6347821885,41389,43.4243384115,59667,57.6226888234,113254,13338,18278
1412,HUDBAY MINERALS INC,3.80411487355,74656,3.69091558519,33596,4.77887383773,84748,3.96551724138,29000,-41060,51152
1413,HUDSON GLOBAL INC,2.91155553434,20951,2.38652092979,20951,1.95694716243,20951,1.52737339506,20951,0,0
1414,HUDSON PAC PPTYS INC,28.1399472699,2437318,28.9202065936,2687014,29.1797529834,2362837,32.8700567943,2396193,249696,-324177
1415,HUGOTON RTY TR TEX,1.60413510382,11221,1.33677925319,11221,2.31708403886,11221,2.40620265573,11221,0,0
1416,HUMANA INC,178.509987339,1012582,182.950110617,804580,179.880211761,1207965,176.889703407,1336850,-208002,403385
1417,HUNT J B TRANS SVCS INC,73.3599777475,273228,84.2407865553,359339,80.9283330742,392273,81.1404435058,426150,86111,32934
1418,HUNTINGTON BANCSHARES INC,11.0600147497,28723289,9.54003502883,28473690,8.9399902186,26658754,9.85999886429,24759942,-249599,-1814936
1419,HUNTINGTON INGALLS INDS INC,126.850200504,462585,136.940666148,473979,168.030610416,596921,153.419666246,786027,11394,122942
1420,HUNTSMAN CORP,11.370398158,1623426,13.2995516277,1002515,13.4497055161,1472746,16.2699953681,5129688,-620911,470231
1421,HURON CONSULTING GROUP INC,59.4050666431,11329,58.2018927445,12680,60.4253879657,70947,59.7603583082,259888,1351,58267
1422,HUTCHINSON TECHNOLOGY INC,3.5895365011,200583,3.66124719342,177262,3.37517139542,18962,3.9754476354,62886,-23321,-158300
1423,HYATT HOTELS CORP,47.0200499249,337707,49.4895484784,327847,49.1434504239,300508,49.2204091206,311253,-9860,-27339
1424,HYSTER YALE MATLS HANDLING I,52.4628177026,55201,66.6121325922,53789,59.5076836844,42818,60.1352501509,64621,-1412,-10971
1425,IAC INTERACTIVECORP,60.0498735111,1938905,47.0797513466,2476861,56.2996415824,2143868,62.4698307226,1820975,537956,-332993
1426,IAMGOLD CORP,1.41997601979,552122,2.20983600691,447092,4.14014368089,2462958,4.05008925948,3771028,-105030,2015866
1427,IBERIABANK CORP,55.0723966355,259059,51.26998621,214648,59.730461501,164355,67.1211850794,140075,-44411,-50293
1428,ICAHN ENTERPRISES LP,61.2641815235,12340,63.0351732315,15182,54.1016607952,3974,50.796812749,2008,2842,-11208
1429,ICICI BK LTD,7.83006870514,3254633,7.16017329802,2575217,7.17989905214,1444310,7.46947117724,1746710,-679416,-1130907
1430,ICON PLC,77.7481554963,16129,75.0906847164,26741,70.0148108254,59416,77.3766421848,29001,10612,32675
1431,ICONIX BRAND GROUP INC,6.83056451031,485465,8.04938740889,568242,6.7640259116,87374,8.12061313777,95313,82777,-480868
1432,ICU MED INC,112.777487284,42074,104.104678258,55790,112.747669586,49562,126.381819117,97245,13716,-6228
1433,IDACORP INC,67.999845497,1242694,74.5903037137,1301818,81.3495727022,1316061,78.2802886781,1343365,59124,14243
1434,IDERA PHARMACEUTICALS INC,3.09017048019,28801,1.97294981958,38521,1.52806347341,34030,2.56389049706,60455,9720,-4491
1435,IDEX CORP,76.6102351403,371778,82.879188017,589569,82.1013884295,589515,93.5686367405,565681,217791,-54
1436,IDEXX LABS INC,72.9203591567,273641,78.3217104524,391756,92.859636916,784722,112.72960573,484744,118115,392966
1437,II VI INC,18.5577942736,49036,21.7099942883,176831,18.7608852856,196366,24.3319793476,326936,127795,19535
1438,IKANG HEALTHCARE GROUP INC,20.4400567132,7802767,21.8599711843,4387197,18.3401006317,4386290,18.0850689711,4379082,-3415570,-907
1439,ILLINOIS TOOL WKS INC,92.6798352652,877289,102.440470006,1761423,104.16107944,812866,119.839979367,1031367,884134,-948557
1440,ILLUMINA INC,191.94569129,1267421,162.109138159,1014329,140.379486029,784324,181.659852043,987582,-253092,-230005
1441,IMATION CORP,1.36672576832,54144,1.53968821314,36371,1.24913007013,56039,0.639352123182,56307,-17773,19668
1442,IMAX CORP,35.5366427595,70969,31.0830596336,50542,29.4817749028,110068,28.9736982517,241771,-20427,59526
1443,IMMUNOCELLULAR THERAPEUTICS,0.368188512518,19012,0.277652448548,28813,0.232675379067,77361,0.115901715345,51768,9801,48548
1444,IMMUNOGEN INC,13.5726490977,71983,8.52628373578,88667,3.07919226324,526112,2.68066136433,644244,16684,437445
1445,IMMUNOMEDICS INC,3.06980513324,501009,2.50050010002,69986,2.3167621413,149778,3.25447605701,108466,-431023,79792
1446,IMPAX LABORATORIES INC,42.7532701518,108787,32.0182043934,211817,28.8195847136,371310,23.7021724911,200277,103030,159493
1447,IMPERIAL OIL LTD,32.5190733745,922228,33.4003245781,1178761,31.5587828269,742836,31.3228410164,207644,256533,-435925
1448,IMPERVA INC,63.3099770571,112889,50.4980511044,34635,43.007744446,157274,53.7064499958,191504,-78254,122639
1449,IMS HEALTH HLDGS INC,25.4679683202,156314,26.5498359945,912774,25.3606399351,591310,31.339667587,295536,756460,-321464
1450,INC RESH HLDGS INC,48.5136399626,13893,41.2067696836,70668,38.1286128076,238561,44.5777918143,341964,56775,167893
1451,INCONTACT INC,9.54318995158,28502,8.89129376809,312328,13.8496067436,613086,13.9800223633,508869,283826,300758
1452,INCYTE CORP,108.449426139,782420,72.4705155077,1035290,79.9800385793,833608,94.2887320481,935414,252870,-201682
1453,INDEPENDENT BANK CORP MASS,46.5194080745,807061,45.9599443348,911881,45.7001816919,898224,54.0909434752,912149,104820,-13657
1454,INDEPENDENT BANK CORP MICH,15.246015246,15873,14.5406193703,23314,14.4938591807,26218,16.8369658227,39734,7441,2904
1455,INDEPENDENT BK GROUP INC,31.9987298655,346420,27.3993939982,340263,42.9083605676,340563,44.168413823,442624,-6157,300
1456,INFINERA CORPORATION,18.1210539311,113404,16.0608622147,300482,11.2797556691,496376,9.03043024684,950896,187078,195894
1457,INFINITY PHARMACEUTICALS INC,7.84980740593,2923766,5.26987684028,1633245,1.33232052859,165876,1.5611482892,201134,-1290521,-1467369
1458,INFINITY PPTY & CAS CORP,82.2989287536,5881,80.502650697,15279,80.6333917104,13704,82.6218197499,34785,9398,-1575
1459,INFOBLOX INC,18.3900184755,210549,17.1002140297,315844,18.7620534051,212077,26.3702565495,603938,105295,-103767
1460,INFORMATION SERVICES GROUP I,3.64055579152,16481,3.93367735386,47284,3.75894629218,33254,3.99033452304,90218,30803,-14030
1461,INFOSONICS CORP,1.57130472475,18456,0.924428010169,17308,0.83932853717,16680,0.500102293651,43991,-1148,-628
1462,INFOSYS LTD,16.7499351866,3328789,19.0201326007,3059863,17.8500201136,4119099,15.7800472927,3692321,-268926,1059236
1463,INFRAREIT INC,18.5017771596,258840,17.0544412607,43625,17.5374419005,139416,18.1358649865,110389,-215215,95791
1464,ING GROEP N V,13.4599156118,1090200,11.9306825469,1119718,10.3300024408,1093901,12.3396816536,1117776,29518,-25817
1465,INGERSOLL-RAND PLC,55.2901114612,4213484,62.0100839141,3824507,63.6801348898,3067393,67.9398941046,2158923,-388977,-757114
1466,INGLES MKTS INC,44.0958151105,24923,37.4936037587,42994,37.2685551511,12638,39.5226200389,18015,18071,-30356
1467,INGRAM MICRO INC,30.3801172061,2604302,35.9103749978,1636463,34.7802780317,1425233,35.6593414695,1017265,-967839,-211230
1468,INGREDION INC,95.8390987742,429282,106.78954531,692933,129.409878268,1141273,133.060879733,1084466,263651,448340
1469,INNERWORKINGS INC,7.49258754708,24958,7.94426484224,79806,8.26553201276,69566,9.41918790712,132177,54848,-10240
1470,INNODATA INC,2.85155274332,96088,2.25737300247,61576,2.45634999668,45189,2.48133037482,41913,-34512,-16387
1471,INNOPHOS HOLDINGS INC,28.9822600627,151748,30.9119370588,171843,42.208553017,136560,39.0300342284,103715,20095,-35283
1472,INNOSPEC INC,54.3085683898,45131,43.3566845235,33974,45.9922496431,39224,60.8049175562,96308,-11157,5250
1473,INOGEN INC,40.087189141,50465,44.9817589071,77298,50.1301599107,13445,59.9034580992,176918,26833,-63853
1474,INOVALON HLDGS INC,16.998695001,207663,18.5212635356,263103,18.0082354995,234837,14.7112793465,190738,55440,-28266
1475,INOVIO PHARMACEUTICALS INC,6.65758813739,6609,8.71572087972,36830,9.23044794821,47885,9.31617364579,83296,30221,11055
1476,INPHI CORP,27.0192926812,83866,33.3417817767,78910,32.032602875,143791,43.5103300915,263018,-4956,64881
1477,INSIGHT ENTERPRISES INC,25.1178468912,189865,28.6419563885,182704,25.9975854023,159861,32.5500601598,250998,-7161,-22843
1478,INSMED INC,18.1166257784,10598,12.6705653021,69768,9.86063163278,195525,14.5208525408,516292,59170,125757
1479,INSPERITY INC,48.1508380415,212042,51.7290654473,132962,77.2309968237,160881,72.6437002003,187752,-79080,27919
1480,INSTALLED BLDG PRODS INC,24.8854772812,8077,26.5486725664,7571,36.2894202107,111713,35.8747456539,146454,-506,104142
1481,INSULET CORP,37.8001221632,42566,33.1485429993,70350,30.2390755285,144515,40.9401250388,441303,27784,74165
1482,INSYS THERAPEUTICS INC NEW,28.6302097887,365034,15.9898342775,245531,12.9391855223,654137,11.7910925985,187260,-119503,408606
1483,INTEGRA LIFESCIENCES HLDGS C,67.7802586811,639552,67.360778842,698062,79.7795612305,664130,82.5503066979,557878,58510,-33932
1484,INTEGRATED DEVICE TECHNOLOGY,26.3498895829,712299,20.4400778822,1620395,20.1300889415,1293884,23.1002373501,1195702,908096,-326511
1485,INTEL CORP,34.4499510196,19902873,32.3499804219,22793275,32.7999517922,18270911,37.7500915563,18212830,2890402,-4522364
1486,INTELIQUENT INC,17.7694156998,47835,16.0444605533,41385,19.8881960869,37208,16.1433737082,50609,-6450,-4177
1487,INTELLICHECK MOBILISA INC,1.10867979577,34275,1.60593642707,18058,1.39355165643,15787,1.70357751278,12914,-16217,-2271
1488,INTELLIGENT SYS CORP NEW,3.24242533415,27757,3.43837510191,28211,3.70655803883,27249,3.66110720757,27041,454,-962
1489,INTELSAT S A,4.16034838057,77157,2.52017076978,53171,2.58124375506,84068,2.72134675021,63204,-23986,30897
1490,INTER PARFUMS INC,23.8076087831,12433,30.888030888,23569,28.5640093482,19255,32.265824688,33255,11136,-4314
1491,INTERACTIVE BROKERS GROUP IN,43.600558894,380752,39.3186052433,396657,35.4008860656,503123,35.2694343889,459945,15905,106466
1492,INTERACTIVE INTELLIGENCE GRO,31.3894026765,18382,36.3811272902,22869,41.0229088972,9385,60.1396234398,472700,4487,-13484
1493,INTERCEPT PHARMACEUTICALS IN,149.339368171,43746,128.479106999,27234,142.690584453,60039,164.575541883,49734,-16512,32805
1494,INTERCONTINENTAL EXCHANGE IN,256.259906009,2601956,235.140206228,2593929,255.96038893,2255935,269.360328832,2151371,-8027,-337994
1495,INTERCONTINENTAL HOTELS GROU,38.7443251024,90310,41.2662350718,99476,37.5146702539,145703,41.6336516674,71937,9166,46227
1496,INTERDIGITAL INC,49.0390271425,249903,55.6489100063,621288,55.6783584268,335678,79.2000040231,596553,371385,-285610
1497,INTERFACE INC,19.1553575461,48707,18.5426391709,123607,15.2501782873,321111,16.6893714774,374370,74900,197504
1498,INTERMOLECULAR INC,2.30591852421,33826,2.50974176078,15141,1.4653548252,33439,0.979260658203,28593,-18685,18298
1499,INTERNAP CORP,6.39825839937,150666,2.73193633577,98831,2.05788509827,52967,1.65194569895,75063,-51835,-45864
1500,INTERNATIONAL BANCSHARES COR,25.6972111554,60240,24.656799477,59659,26.0815257413,107279,29.7776055405,159986,-581,47620
1501,INTERNATIONAL BUSINESS MACHS,137.620078734,2682719,151.450302288,2834547,151.779654423,2685999,158.849786313,3148528,151828,-148548
1502,INTERNATIONAL FLAVORS&FRAGRA,119.638975135,560737,113.769258386,320315,126.070087221,322170,142.968853688,278781,-240422,1855
1503,INTERNATIONAL GAME TECHNOLOG,16.1791281077,942387,18.2496496259,960402,18.7391193788,920214,24.3803881665,2860783,18015,-40188
1504,INTERNATIONAL SPEEDWAY CORP,33.7149903118,56770,36.9091841457,79953,33.4505132044,92166,33.4168755221,260946,23183,12213
1505,INTERNATIONAL TOWER HILL MIN,0.194961634336,287236,0.314762354422,152496,0.882506317943,99716,0.881646550938,32893,-134740,-52780
1506,INTEROIL CORP,31.4447751137,17809,31.8290464129,140155,45.0003192935,548085,50.9197879662,1275457,122346,407930
1507,INTERPUBLIC GROUP COS INC,23.2800071551,4763014,22.9499817053,4577825,23.0999997459,5509394,22.3501846496,5321701,-185189,931569
1508,INTERSIL CORP,12.7599942901,7348671,13.3699459887,8229577,13.5399616882,8177645,21.9299710491,3383315,880906,-51932
1509,INTERVAL LEISURE GROUP INC,15.6108649765,43111,14.4382002615,56586,15.8997929474,1061083,17.1691436905,577373,13475,1004497
1510,INTERXION HOLDING N.V,30.1498439719,1474734,34.5800978017,1413472,36.8806189195,1370259,36.2206318729,1432250,-61262,-43213
1511,INTEVAC INC,4.69664800875,31086,4.48546091978,19396,5.65006829753,16106,5.93599449415,11624,-11690,-3290
1512,INTL PAPER CO,37.7000885338,2013921,41.0395720383,1304229,42.3792911168,1398820,47.9800211425,2093413,-709692,94591
1513,INTRA CELLULAR THERAPIES INC,53.7915302255,27179,27.8179771667,24876,38.8267847261,90350,15.2405810259,264360,-2303,65474
1514,INTRALINKS HLDGS INC,9.07445396404,82870,7.8823338209,61530,6.50172612198,86900,10.0630238205,105833,-21340,25370
1515,INTREPID POTASH INC,2.94885265905,147515,1.11644694583,65386,1.43933806898,364751,1.12916018333,330334,-82129,299365
1516,INTREXON CORP,30.1527287591,254438,33.8886978823,215234,24.6091738584,485510,28.0187531738,423395,-39204,270276
1517,INTUIT,96.5002816436,4551852,104.010026101,3621747,111.609709336,3588505,110.009748744,3693809,-930105,-33242
1518,INTUITIVE SURGICAL INC,546.152000274,145855,601.046619374,131662,661.406025825,142188,724.830784863,244068,-14193,10526
1519,INVACARE CORP,17.3796791444,85272,13.1652561035,84009,12.1213172178,57667,11.1750828329,153019,-1263,-26342
1520,INVENSENSE INC,10.2304615201,669960,8.39970823049,749907,6.12847090868,264340,7.42006821206,1407669,79947,-485567
1521,INVESCO LTD,33.4799043084,2219630,30.7700367665,3951149,25.5400546785,4011816,31.2698241549,2624639,1731519,60667
1522,INVESCO MORTGAGE CAPITAL INC,12.3901049819,750034,12.1801317381,929875,13.6903955197,1372422,15.2300207937,1232106,179841,442547
1523,INVESTMENT TECHNOLOGY GRP NE,17.0203320607,225260,22.0989550479,145844,16.7231652631,159001,17.1372832613,59461,-79416,13157
1524,INVESTORS BANCORP INC NEW,12.440513945,1379525,11.6399967181,2973884,11.0799855015,2794769,12.0099055469,1666541,1594359,-179115
1525,INVESTORS REAL ESTATE TR,6.94961528915,100725,7.26780198543,60541,6.46988158572,58270,5.94900314001,105732,-40184,-2271
1526,INVIVO THERAPEUTICS HLDGS CO,7.19598539762,95053,6.97951378153,349308,5.77942847208,333597,6.80003794441,200293,254255,-15711
1527,IONIS PHARMACEUTICALS INC,61.9303021975,1397232,40.5006178736,677323,23.2898314409,1007006,36.6395695655,1060138,-719909,329683
1528,IPG PHOTONICS CORP,89.1957991656,20853,96.0848637214,65234,79.9996633365,118813,82.3506147983,111256,44381,53579
1529,IRIDIUM COMMUNICATIONS INC,8.43261263911,20397,7.8677796188,95961,8.88148532588,119462,8.11721611722,68250,75564,23501
1530,IROBOT CORP,35.3995980832,12938,35.3389258509,20742,35.0625816511,23729,43.9816908169,287506,7804,2987
1531,IRON MTN INC NEW,27.0101264775,700441,33.9097392406,871608,39.8299021576,2929608,37.5299391213,3418604,171167,2058000
1532,IRONWOOD PHARMACEUTICALS INC,11.5939967281,112472,10.9421150551,190274,13.075035558,368412,15.8796640752,1356137,77802,178138
1533,IRSA INVERSIONES Y REP S A,12.3003935183,127313,14.9631223834,127313,16.8083067595,127318,18.9918157684,127318,0,5
1534,ISHARES,34.2754340782,1173406,34.2026513152,1402172,33.3892286996,898703,34.3290841882,1001221,228766,-503469
1535,ISHARES INC,21.9486544801,35208992,21.0247148302,36778525,22.9216146573,37729541,26.6907215716,44625133,1569533,951016
1536,ISHARES SILVER TRUST,13.1888333676,384037,14.6801627384,753602,17.8652610185,673094,18.2001774945,572412,369565,-80508
1537,ISHARES TR,67.1763463379,230475872,66.8256808663,226351274,70.1121434117,227454735,73.6288053688,188896342,-4124598,1103461
1538,ISLE OF CAPRI CASINOS INC,13.9340417617,123654,13.9962232413,126034,18.3162375943,114161,22.2815117771,187779,2380,-11873
1539,ISRAEL CHEMICALS LTD,4.0499756134,7331896,4.29006296675,6996867,3.90005107677,6883756,3.89997025483,6979284,-335029,-113111
1540,ISTAR INC,11.7302352717,2248804,9.65998157102,5447940,9.58992553883,5278456,10.7300509202,5001747,3199136,-169484
1541,ITAU UNIBANCO HLDG SA,6.50999325575,20776212,8.58989615588,3002481,9.44023699449,2139459,10.9397019589,3308134,-17773731,-863022
1542,ITC HLDGS CORP,39.2495391137,1196065,43.5704773194,956634,46.8197929692,531805,46.4794136937,1102359,-239431,-424829
1543,ITRON INC,36.1784491126,179278,41.7204885898,220635,43.0967501321,193054,55.7607187811,264559,41357,-27581
1544,IXIA,12.4253474216,139312,12.4623432357,164977,9.81983722829,2592711,12.4999901189,2530082,25665,2427734
1545,IXYS CORP,12.6614547927,11768,11.225650244,54518,10.2529049897,32186,12.0481927711,11786,42750,-22332
1546,J & J SNACK FOODS CORP,116.669600986,312395,108.280521511,143276,119.25522848,15253,119.14238028,15578,-169119,-128023
1547,J ALEXANDERS HLDGS INC,10.9253277598,42104,10.5346326047,18985,9.906515976,14334,10.16002032,15748,-23119,-4651
1548,J2 GLOBAL INC,82.3080833757,39340,61.5801520597,548732,63.1693003251,545439,66.6110861286,502574,509392,-3293
1549,JA SOLAR HOLDINGS CO LTD,9.69114855927,34774,8.61680558684,71024,6.84948025951,124389,6.0165673594,103215,36250,53365
1550,JABIL CIRCUIT INC,23.2899501412,2028128,19.2701035905,2452348,18.4701472147,2378974,21.8200941374,3177484,424220,-73374
1551,JACK IN THE BOX INC,76.7103280136,1589812,63.8695458708,1813603,85.9204075982,1473608,95.9395298048,1365433,223791,-339995
1552,JACOBS ENGR GROUP INC DEL,41.9498372922,722768,43.5493536744,737554,49.8101849588,1206701,51.719958271,1468524,14786,469147
1553,JAMBA INC,13.4870894961,159560,12.3603094683,162860,10.2881957769,205867,10.9199609566,163920,3300,43007
1554,JAMES HARDIE INDS PLC,12.6753246753,28875,13.6388067724,29768,15.3297682709,30855,15.7382418049,32977,893,1087
1555,JANUS CAP GROUP INC,14.0893789324,442319,14.6311070969,239148,13.9184323692,217194,14.0096844513,491303,-203171,-21954
1556,JASON INDS INC,3.78552259761,56267,3.49072543959,53857,3.60904159895,47381,2.21075902727,37996,-2410,-6476
1557,JAZZ PHARMACEUTICALS PLC,140.563014292,173175,130.546391246,223997,141.310150105,595718,121.480393605,704056,50822,371721
1558,JD COM INC,32.2649052265,6639567,26.4998211352,4634786,21.2300353111,3829386,26.0899334622,3861566,-2004781,-805400
1559,JETBLUE AIRWAYS CORP,22.6501330718,1629571,21.1200866938,3816651,16.5598858661,4701844,17.2401156423,10232936,2187080,885193
1560,JETPAY CORP,2.74097761535,17512,2.33085935104,16303,2.25928633132,15049,2.66265339199,17276,-1209,-1254
1561,JINKOSOLAR HLDG CO LTD,27.6619665527,42694,20.9002498216,44832,20.3830296107,56027,15.8415841584,7575,2138,11195
1562,JIVE SOFTWARE INC,4.05970149254,16750,3.79175187457,23472,3.76899696049,32900,4.26596057664,33990,6722,9428
1563,JMP GROUP LLC,5.45338297792,26589,5.22915101427,33275,5.43427630966,32203,5.52743533211,32203,6686,-1072
1564,JOHN BEAN TECHNOLOGIES CORP,49.8276522405,104440,56.412431557,25934,61.2036505201,31338,70.5503238119,383556,-78506,5404
1565,JOHNSON & JOHNSON,102.719938114,13899103,108.199919448,10740886,121.299966438,11119764,118.129940949,9868929,-3158217,378878
1566,JONES ENERGY INC,3.86156861598,34183,3.323409264,28886,4.11698450305,25747,3.56023491465,164315,-5297,-3139
1567,JONES LANG LASALLE INC,159.860290167,349868,117.319565999,400368,97.4524675869,419661,113.790498066,330880,50500,19293
1568,JOY GLOBAL INC,12.6100298131,1879377,16.0707291406,423814,21.1399457001,567220,27.7395445412,552893,-1455563,143406
1569,JP ENERGY PARTNERS LP,4.92000770054,1511583,5.36937471727,559283,8.43988593506,347872,7.39927329592,347872,-952300,-211411
1570,JPMORGAN CHASE & CO,63.0163359931,22708445,57.9222247757,19667960,60.6806990702,17584158,63.0148948674,16948120,-3040485,-2083802
1571,JUMEI INTL HLDG LTD,9.05286278235,67382,6.51149278477,199647,4.13114048811,409088,5.84868694083,103613,132265,209441
1572,JUNIPER NETWORKS INC,27.5999006101,4527625,25.5100835771,3556476,22.4903130466,2617438,24.0601611472,3350601,-971149,-939038
1573,JUNO THERAPEUTICS INC,43.9710668645,334288,38.0910104082,105878,38.4416339056,330423,30.0097082743,314165,-228410,224545
1574,JUST ENERGY GROUP INC,7.11909750583,422385,5.94149701224,440798,6.07954505132,422729,5.07063029471,97621,18413,-18069
1575,K12 INC,8.79672553764,265326,9.88935740801,277470,12.4877201437,377651,14.3515108345,370623,12144,100181
1576,KADANT INC,40.6287069988,23604,45.1680081049,35534,51.5147205234,35155,52.1069922128,98624,11930,-379
1577,KAISER ALUMINUM CORP,83.660987007,674747,84.5394851856,715015,90.4106046894,657445,86.4898559292,527796,40268,-57570
1578,KAMAN CORP,40.8103281306,1384723,42.6902529083,1136934,42.5198443238,1136975,43.9194540131,1130137,-247789,41
1579,KANDI TECHNOLOGIES GROUP INC,10.9483423285,6485,7.20678832965,8603,7.16680912618,15209,5.49592990097,19287,2118,6606
1580,KANSAS CITY SOUTHERN,74.6699331737,4317762,85.4500592329,3924339,90.0900664074,2282427,93.3199680502,2018164,-393423,-1641912
1581,KAPSTONE PAPER & PACKAGING C,22.5896851428,879605,13.8493337744,402041,13.0106933225,412968,18.9183493191,223011,-477564,10927
1582,KAR AUCTION SVCS INC,37.029975987,1153957,38.1407304977,974103,41.7409267259,1008842,43.1608377133,753623,-179854,34739
1583,KATE SPADE & CO,17.7699972282,16321612,25.5200441201,14007225,20.6099058043,8325220,17.1300673184,7912987,-2314387,-5682005
1584,KB FINANCIAL GROUP INC,27.8754420076,99263,27.5847441768,80153,28.4588992257,238414,34.2085479605,179575,-19110,158261
1585,KB HOME,12.3292624797,608390,14.2801311179,726674,15.2103072752,1023122,16.1204303971,1901314,118284,296448
1586,KBR INC,16.9200242076,948462,15.4800122809,1341924,13.2396400384,704853,15.1313286559,659757,393462,-637071
1587,KCAP FINL INC,4.04518394138,13102,3.5959569781,30868,3.90193624383,27166,4.63629096723,25020,17766,-3702
1588,KCG HLDGS INC,12.3084449608,359753,11.949200473,388980,13.2997119822,432265,15.5292572276,411095,29227,43285
1589,KEARNY FINL CORP MD,12.670760747,79790,12.354088615,64594,12.5780476447,221179,13.6127724779,101155,-15196,156585
1590,KELLOGG CO,72.2695902841,1149626,76.5502008342,1556508,81.6507247349,1595687,77.4691052892,1112650,406882,39179
1591,KEMET CORP,2.3664785063,46060,1.94165989343,22146,2.92721869872,67641,3.57170808757,140549,-23914,45495
1592,KEMPER CORP DEL,37.2502408253,128724,29.5695821003,164561,30.9768875193,162250,39.3217893218,182952,35837,-2311
1593,KEMPHARM INC,19.8531411477,62509,14.4951197043,85753,4.00686891815,15723,4.49713818479,19568,23244,-70030
1594,KENNAMETAL INC,19.1984795547,139959,22.4882567345,516892,22.1109173352,358375,29.0188548064,483272,376933,-158517
1595,KENNEDY-WILSON HLDGS INC,24.0800870747,2735123,21.8999480777,3035304,18.9598004539,3489119,22.5499580779,3501736,300181,453815
1596,KERYX BIOPHARMACEUTICALS INC,5.05483594349,66471,4.66828003952,69833,6.61938753295,431762,5.3094483606,618520,3362,361929
1597,KEY TRONICS CORP,7.58240057771,19387,7.1475843812,15110,7.50597065848,20517,7.45509996611,20657,-4277,5407
1598,KEYCORP NEW,13.2220067263,10732864,11.0399695215,9197308,11.0499879998,9262363,12.1700341729,7559798,-1535556,65055
1599,KEYSIGHT TECHNOLOGIES INC,28.3301729307,863814,27.7402413931,390732,29.0882910977,502814,31.691174175,320310,-473082,112082
1600,KEYW HLDG CORP,6.03162031255,32827,6.63524937044,95701,9.92850466109,39583,11.0295668312,47418,62874,-56118
1601,KILROY RLTY CORP,63.2805940813,460947,61.8706742276,371032,66.2906583538,560094,69.3498198347,561429,-89915,189062
1602,KIMBALL ELECTRONICS INC,10.989010989,108654,11.1673927878,152408,12.4456358215,182795,13.8632779795,194687,43754,30387
1603,KIMBALL INTL INC,9.7694161814,187524,11.3521758337,239954,11.3798348752,209054,12.9401261638,203862,52430,-30900
1604,KIMBERLY CLARK CORP,127.299889272,2547677,134.509945778,2112052,137.479715913,2236359,126.139830638,3271100,-435625,124307
1605,KIMCO RLTY CORP,26.4599230038,5303379,28.7799816517,6156432,31.3801533517,6934128,28.9498765023,7172604,853053,777696
1606,KINDER MORGAN INC DEL,16.328517587,6610398,18.4613872099,14931814,18.5620738792,12653543,22.9767962585,17008507,8321416,-2278271
1607,KINDRED BIOSCIENCES INC,3.39551791635,25033,3.46654978683,25097,3.52460172001,28372,4.98879634719,23653,64,3275
1608,KINDRED HEALTHCARE INC,11.9041738701,40490,12.3501048833,750358,11.2902775061,751443,10.2206841435,663165,709868,1085
1609,KINROSS GOLD CORP,1.82037661867,3517404,3.4000026395,3637056,4.89009335936,6890257,4.20986473507,4012718,119652,3253201
1610,KIRBY CORP,52.6203471165,1213656,60.2932528516,205761,62.3885833039,209798,62.1586188653,344007,-1007895,4037
1611,KITE PHARMA INC,61.6111537835,42963,45.8979403712,72683,49.9976225572,42062,55.8648157637,85868,29720,-30621
1612,KITE RLTY GROUP TR,25.931328945,421575,27.7094591957,358614,28.0300357529,359971,27.7201054935,338599,-62961,1357
1613,KKR & CO L P DEL,15.5900259776,1736110,14.6901331443,2438031,12.3401789511,2269335,14.2599192642,2622876,701921,-168696
1614,KLA-TENCOR CORP,69.3489334277,724611,72.8099319565,1862191,73.249629299,2674662,69.7099450288,2389616,1137580,812471
1615,KLONDEX MNS LTD,2.07448384866,30369,2.67873637539,21652,3.64172994073,42013,5.74989548201,1066802,-8717,20361
1616,KLX INC,30.7807135393,33495,32.1573820108,31719,31.0003687799,656218,35.1985865629,589768,-1776,624499
1617,KNIGHT TRANSN INC,24.2453216774,14642,26.1504351506,217396,26.5795659684,384995,28.6882195184,470193,202754,167599
1618,KNOLL INC,18.7974695017,55167,21.6541373112,152442,24.2800873753,230271,22.8516465659,227686,97275,77829
1619,KNOT OFFSHORE PARTNERS LP,13.4899366092,1766502,16.4000884499,1736576,18.5598105765,1680890,20.889765145,1655021,-29926,-55686
1620,KNOWLES CORP,13.3322563228,235219,13.1764251953,155505,13.6783207411,119386,14.0518007148,142971,-79714,-36119
1621,KOHLS CORP,47.6300423165,1269010,46.610515644,954806,37.9194223362,1465766,43.7505476455,1620574,-314204,510960
1622,KONINKLIJKE PHILIPS N V,25.4503567459,322078,28.5518188058,313255,24.9387501371,273470,29.5877546292,293466,-8823,-39785
1623,KOPPERS HOLDINGS INC,18.2514646237,71008,22.464316609,36992,30.7265003812,91810,32.1693659901,62917,-34016,54818
1624,KOREA ELECTRIC PWR,21.1614413184,20509,25.7534933266,47877,25.9289375348,109453,24.3753480268,167013,27368,61576
1625,KORN FERRY INTL,33.1817335248,332894,28.2905544724,267227,20.6987970596,141071,21.0002716284,58904,-65667,-126156
1626,KORNIT DIGITAL LTD,10.8001814085,1411180,9.94977046498,1383449,9.75978738339,1413248,9.38019160237,1405515,-27731,29799
1627,KOSMOS ENERGY LTD,5.20020860044,878234,5.82009175427,1053248,5.45040557848,421620,6.40978163573,1417677,175014,-631628
1628,KRAFT HEINZ CO,72.760123351,5579526,78.5601602048,3734221,88.4803467065,3257164,89.5100369405,3492100,-1845305,-477057
1629,KROGER CO,41.829797147,3060689,38.2501763634,3481448,36.7901197232,3108253,29.6801328519,2651976,420759,-373195
1630,KRONOS WORLDWIDE INC,5.63830850745,50015,5.72353910154,107451,5.23947989247,36454,8.28062978368,52653,57436,-70997
1631,KT CORP,11.9059899594,116328,13.4185564127,171628,14.2583584853,188521,16.049234575,433354,55300,16893
1632,KULICKE & SOFFA INDS INC,11.6689186312,258293,11.3203078745,253350,12.1698593953,331639,12.931748944,349914,-4943,78289
1633,KYOCERA CORP,46.1079199796,70682,44.1561662095,64521,47.6611315255,64497,48.1220657277,62196,-6161,-24
1634,L BRANDS INC,95.8202301932,2495903,87.8100647367,3126202,67.1297705201,1002223,70.7695675173,1096460,630299,-2123979
1635,L-3 COMMUNICATIONS HLDGS INC,119.510614525,447500,118.49953579,1235431,146.689449608,1174563,150.730299528,1657676,787931,-60868
1636,LA QUINTA HLDGS INC,13.6090948897,625758,12.500147648,931269,11.3994337822,639330,11.1800599164,598834,305511,-291939
1637,LA Z BOY INC,24.416466702,64178,26.7421197012,57961,27.8192965866,65566,24.5603022117,178418,-6217,7605
1638,LABORATORY CORP AMER HLDGS,123.640372375,2850137,117.129797785,2648566,130.270235661,2436466,137.480173744,1856755,-201571,-212100
1639,LADENBURG THALMAN FIN SVCS I,2.7566309114,70013,2.5016277715,87543,2.36518448439,73990,2.31367874921,71315,17530,-13553
1640,LAKELAND FINL CORP,46.6189907735,448165,45.779326917,471086,47.010629159,467958,35.4194738519,699841,22921,-3128
1641,LAM RESEARCH CORP,79.4198556806,1674342,82.6001705623,2586738,84.0596808568,2268198,94.7100260919,3891626,912396,-318540
1642,LAMAR ADVERTISING CO NEW,59.9800310196,4473939,61.5001240629,3933488,66.2999460866,3772718,65.3098692459,3305136,-540451,-160770
1643,LANCASTER COLONY CORP,115.455420027,84197,110.571740585,141935,127.607660382,127461,132.09140324,151592,57738,-14474
1644,LANDEC CORP,11.8308766486,20624,10.4815276048,19272,10.7729051273,19679,13.402539172,41037,-1352,407
1645,LANDS END INC NEW,23.440160752,117448,25.5044308545,78653,16.433755173,33346,14.4875045273,33132,-38795,-45307
1646,LANDSTAR SYS INC,58.6470777837,192354,64.6070696453,248301,68.6596035619,179902,68.0803092777,163219,55947,-68399
1647,LANTRONIX INC,1.14361604014,27107,0.959020323854,27111,0.977517106549,23529,1.40717203813,22030,4,-3582
1648,LAREDO PETROLEUM INC,7.98868347522,429107,7.92998120301,1021440,10.4797247982,745344,12.900032579,957672,592333,-276096
1649,LAS VEGAS SANDS CORP,43.8395531005,1091252,51.6802789786,1354656,43.489689774,1316266,57.539975741,1657943,263404,-38390
1650,LASALLE HOTEL PPTYS,25.1602016834,2688174,25.3098480776,3727956,23.57997391,4556536,23.8700944157,4585361,1039782,828580
1651,LATAM AIRLS GROUP S A,5.38876435291,408628,7.00081642174,342960,6.60008480992,384389,8.12073524547,420159,-65668,41429
1652,LATTICE SEMICONDUCTOR CORP,6.46859188502,112853,5.6794733222,101770,5.34701883548,111651,6.48813679596,698968,-11083,9881
1653,LAUDER ESTEE COS INC,88.0598169785,2649415,94.3099071724,2320753,91.0200303595,2049439,88.5598797778,1951719,-328662,-271314
1654,LAZARD LTD,45.0111195583,562972,38.7992412235,1192446,29.7793237322,547091,36.3603905915,857059,629474,-645355
1655,LEAR CORP,122.829479319,983347,111.169511961,1430725,101.759634359,1551686,121.220317705,2236729,447378,120961
1656,LEE ENTERPRISES INC,1.68019595538,148197,1.79789717946,208577,1.91205237125,294971,3.74837203765,277187,60380,86394
1657,LEGACY RESVS LP,1.73482032218,24210,0.961823024563,27032,1.5908597874,13829,1.35593220339,13275,2822,-13203
1658,LEGACY TEX FINL GROUP INC,25.0200540449,2326214,19.6500560342,2270935,26.9100337856,2212186,31.6300040371,2209516,-55279,-58749
1659,LEGG MASON INC,39.2299220869,1020624,34.6795795061,1217806,29.4895483182,1347630,33.4796854234,1595923,197182,129824
1660,LEGGETT & PLATT INC,42.0196920037,1494109,48.4009189272,635959,51.1080379128,444705,45.5797168958,729908,-858150,-191254
1661,LEIDOS HLDGS INC,56.2613495778,276442,50.3196192098,312403,47.8696753168,221539,43.2800511056,3387496,35961,-90864
1662,LENDINGCLUB CORP,11.0491247883,221375,8.2992808672,434134,4.30005906675,465575,6.17974384134,1340185,212759,31441
1663,LENDINGTREE INC NEW,89.3280632411,5060,97.7864266602,8222,88.286905023,9118,96.8660968661,4914,3162,896
1664,LENNAR CORP,48.8590682743,1398287,48.3089660657,1408310,45.9779913879,1149550,42.2518803506,1004334,10023,-258760
1665,LENNOX INTL INC,124.900079936,265212,135.19119535,346635,142.5985821,399464,157.028090954,411022,81423,52829
1666,LEUCADIA NATL CORP,17.3894379923,1383771,16.1697146584,1031991,17.3291503541,995144,19.0399199395,1486876,-351780,-36847
1667,LEVEL 3 COMMUNICATIONS INC,54.3598190184,3841937,52.8500437469,3511104,51.4899350707,4570971,46.3799946834,8524214,-330833,1059867
1668,LEXICON PHARMACEUTICALS INC,13.309506028,112476,11.9519155008,187836,14.3476689555,83010,18.0739010922,123327,75360,-104826
1669,LEXINGTON REALTY TRUST,7.99888607368,402181,8.60049846357,399628,10.1104494905,526485,10.2998997764,648550,-2553,126857
1670,LG DISPLAY CO LTD,10.4836316883,10111,11.4458845312,11882,11.5895858508,36412,12.7176744824,58344,1771,24530
1671,LGI HOMES INC,24.3755279353,8287,24.2080431364,17804,31.9595578785,11671,36.8569234707,7814,9517,-6133
1672,LHC GROUP INC,45.3201535678,22661,35.5918174293,16914,43.2660791026,13729,36.8816989548,90126,-5747,-3185
1673,LIBBEY INC,21.309255079,11075,18.6182388977,45869,15.8806544755,56106,17.8580526825,39254,34794,10237
1674,LIBERTY ALL STAR EQUITY FD,5.36211699164,14360,4.95359265825,19178,5.02037061375,38045,5.17504862462,28792,4818,18867
1675,LIBERTY BROADBAND CORP,51.8373030511,601806,57.9588627217,709624,59.971433565,829645,71.3120166669,996466,107818,120021
1676,LIBERTY GLOBAL PLC,41.1070254651,12801729,37.6943790594,13106543,29.2605791869,15114465,31.6984169585,18756678,304814,2007922
1677,LIBERTY INTERACTIVE CORP,32.0239626299,2041846,31.5165685964,2657618,27.6991376054,5244351,26.7487635303,3388680,615772,2586733
1678,LIBERTY MEDIA CORP DELAWARE,38.1696843991,3078857,38.1789252595,3660344,28.5324440665,3763400,31.9918311857,2724508,581487,103056
1679,LIBERTY PPTY TR,31.0497668685,4821099,33.4602069832,5058576,39.7199638663,5756400,40.3500228958,6199823,237477,697824
1680,LIBERTY TRIPADVISOR HLDGS IN,30.3398650014,574228,22.1610439211,628400,21.8789060547,800040,21.8501502883,1349739,54172,171640
1681,LIFELOCK INC,14.3547273982,65205,12.0760078139,90096,15.8138574803,87202,16.920649148,685021,24891,-2894
1682,LIFEPOINT HEALTH INC,73.3947744624,131508,69.2487387858,241434,65.3695684515,248709,59.2268333556,156939,109926,7275
1683,LIGAND PHARMACEUTICALS INC,108.471189075,9007,107.090842891,21972,119.2681274,30989,102.062585676,220306,12965,9017
1684,LILLY ELI & CO,84.2600322981,3663991,72.0101097155,2961112,78.7501033486,6930429,80.260052187,6072012,-702879,3969317
1685,LIMELIGHT NETWORKS INC,1.45999575911,30804884,1.81000519268,30804884,1.49001571839,30944640,1.87001690761,30944640,0,139756
1686,LINCOLN EDL SVCS CORP,1.99760287655,35042,2.46937031057,10529,1.50096123202,97271,2.20054280056,54532,-24513,86742
1687,LINCOLN ELEC HLDGS INC,51.8893416256,233150,58.5697654491,169217,59.0817144384,157206,62.6190556975,206311,-63933,-12011
1688,LINCOLN NATL CORP IND,50.2601046698,9428512,39.1999578285,7170722,38.7702023037,4302789,46.980059835,6017553,-2257790,-2867933
1689,LINEAR TECHNOLOGY CORP,42.4700675272,1552411,44.5594671922,1261393,46.5297227151,1091152,59.2901284321,4894491,-291018,-170241
1690,LINKEDIN CORP,225.080403095,2051227,114.350110917,1097218,189.24961982,1262560,191.120223566,986196,-954009,165342
1691,LION BIOTECHNOLOGIES INC,7.71982677462,21244,5.07206642645,51064,8.10091963157,279351,8.22757111597,68550,29820,228287
1692,LIONBRIDGE TECHNOLOGIES INC,4.92574072692,26798,5.06231157399,62027,3.95594874367,87716,4.99634313701,121689,35229,25689
1693,LIONS GATE ENTMNT CORP,32.3899438087,563076,21.8511937226,284195,20.2308482968,940791,19.9906293925,192090,-278881,656596
1694,LIQTECH INTL INC,1.01233204491,21732,0.705794947994,26920,0.6075768406,27980,0.817196660153,28145,5188,1060
1695,LIQUIDITY SERVICES INC,6.50635072042,99595,5.17511850766,117292,7.84241946384,213072,11.2419670985,183153,17697,95780
1696,LITHIA MTRS INC,106.670470349,701075,87.3299349377,717005,71.0691218086,768238,95.5211932903,579641,15930,51233
1697,LITTELFUSE INC,107.009284687,305880,123.109503069,233272,118.18948343,241942,128.807953718,197744,-72608,8670
1698,LIVANOVA PLC,59.3704277946,549516,53.9794617465,571032,50.2304917392,424961,60.1089957816,371941,21516,-146071
1699,LIVE NATION ENTERTAINMENT IN,24.5700157551,3902236,22.3100752737,4135441,23.4999797917,4131961,27.4800939894,4240051,233205,-3480
1700,LIVEPERSON INC,6.75460902734,75504,5.84627180372,20868,6.35131292066,31647,8.41017743605,267533,-54636,10779
1701,LKQ CORP,29.6300352514,6610792,31.9300933744,4484954,31.6998337566,2676197,35.4598124396,2349110,-2125838,-1808757
1702,LLOYDS BANKING GROUP PLC,4.35979593396,3218958,3.94994083554,3661827,2.96995046547,3959662,2.87021878453,4145677,442869,297835
1703,LOCKHEED MARTIN CORP,217.151171138,835768,221.499660413,1139618,248.170581994,912312,239.720348338,815300,303850,-227306
1704,LOEWS CORP,38.3992283254,1235754,38.2600126902,1516126,41.0903123111,1296656,41.1502459914,1364682,280372,-219470
1705,LOGITECH INTL S A,15.0688556789,627254,15.9098139486,1018428,16.2799016875,1772308,22.4595604848,1064491,391174,753880
1706,LOGMEIN INC,67.0978870203,46380,50.4641129559,107086,63.4312473393,75168,90.3999738508,91781,60706,-31918
1707,LOMBARD MED INC,1.36649357748,18295,1.04370927952,31618,1.08854772719,26641,0.932005930947,23605,13323,-4977
1708,LORAL SPACE & COMMUNICATNS I,40.7115976736,111074,35.1289675679,14461,35.2594940291,17669,39.1070133637,19306,-96613,3208
1709,LOUISIANA PAC CORP,18.0109953878,632447,17.1201524235,1345724,17.3502764389,1501417,18.8302942693,1741874,713277,155693
1710,LOWES COS INC,76.0400737282,4299575,75.750025959,4786401,79.170038503,4175519,72.2101579652,3673846,486826,-610882
1711,LPL FINL HLDGS INC,42.6591306688,81741,24.8038004141,124618,22.5277571651,142846,29.9087716198,181084,42877,18228
1712,LSI INDS INC,12.1896929913,123547,11.7484968064,133549,11.0679053441,132184,11.2323986528,123215,10002,-1365
1713,LTC PPTYS INC,43.1380514368,103389,45.238242383,275077,51.7299005892,104717,51.9904473933,103846,171688,-170360
1714,LULULEMON ATHLETICA INC,52.4705081613,402569,67.7096849936,242757,73.8614669598,227859,60.9809353549,879324,-159812,-14898
1715,LUMBER LIQUIDATORS HLDGS INC,17.3451556534,30902,13.1437190261,18564,15.4286805423,26185,19.6721311475,14030,-12338,7621
1716,LUMENTUM HLDGS INC,22.0205251233,750300,26.9685380489,248141,24.2005671131,35619,41.7659365527,117105,-502159,-212522
1717,LUMINEX CORP DEL,21.3859875042,104835,19.4051242411,62097,20.2284193496,104457,22.7198452227,229491,-42738,42360
1718,LUXOFT HLDG INC,77.0098730606,3545,54.9715286903,4566,52.037149391,21427,52.8569455316,21719,1021,16861
1719,LUXOTTICA GROUP S P A,64.8767844017,25849,55.0186585016,20902,48.8408037094,19410,47.8314558605,39681,-4947,-1492
1720,LYDALL INC DEL,35.4965744187,18537,32.5494053474,11183,38.5899576217,15574,51.1213818031,67506,-7354,4391
1721,LYON WILLIAM HOMES,16.5002602304,1087498,14.4893553449,1010742,16.1194941791,916530,18.5498001052,921735,-76756,-94212
1722,LYONDELLBASELL INDUSTRIES N,86.9004815775,2812424,85.579854375,2540224,74.4198299284,2239645,80.6594746318,2468935,-272200,-300579
1723,M & T BK CORP,121.180362382,2165945,110.999981855,3637406,118.230221076,2253434,116.099584877,898048,1471461,-1383972
1724,M D C HLDGS INC,25.525069038,78942,25.0712758375,56120,24.3329917017,30247,25.79763443,201220,-22822,-25873
1725,M/I HOMES INC,21.919448441,1139171,18.6500854231,1048896,18.8299156017,1479295,23.569593068,1288864,-90275,430399
1726,MA COM TECHNOLOGY SOLUTIONS,40.8924431303,29761,43.7944537681,12513,32.9713815373,63176,42.336728729,241209,-17248,50663
1727,MACATAWA BK CORP,6.03430741067,14749,6.2497003021,62563,7.42630202447,61942,8.00656949292,19484,47814,-621
1728,MACERICH CO,80.6897003692,1342786,79.2402335517,2405634,85.3898644098,734935,80.8706239114,709652,1062848,-1670699
1729,MACK CALI RLTY CORP,23.3494824739,698902,23.4995565906,1311429,26.9992638694,1195440,27.2192731495,1056641,612527,-115989
1730,MACQUARIE INFRASTRUCTURE COR,72.6001169431,1520397,67.4405352525,1505682,74.0499370924,1259785,83.2394308105,1212250,-14715,-245897
1731,MACROCURE LTD,1.2745347948,11769,0.88621056363,16926,1.45572179539,12365,1.4523156366,12394,5157,-4561
1732,MACROGENICS INC,31.003217315,6838,18.756698821,16794,27.0050310743,13516,29.913772738,33864,9956,-3278
1733,MACYS INC,34.9798259026,2282630,44.0897379303,1900601,33.6100896113,4449884,37.0501191271,2845281,-382029,2549283
1734,MADDEN STEVEN LTD,30.21883508,572623,37.0391705746,850613,34.1800382677,732211,34.5601070441,588916,277990,-118402
1735,MADISON SQUARE GARDEN CO NEW,161.838893409,12290,166.376754784,40817,172.513674058,68012,169.410493057,48108,28527,27195
1736,MAGELLAN HEALTH INC,61.6400162766,66353,67.9304764859,119269,65.770503787,196988,53.7324063838,134779,52916,77719
1737,MAGELLAN MIDSTREAM PRTNRS LP,67.9199861206,11608586,68.7999940622,11047937,76.0000169829,11305458,70.7399415336,10532197,-560649,257521
1738,MAGICJACK VOCALTEC LTD,9.43894621914,28393,6.56197845547,52728,6.28774459534,96537,6.09030130964,87352,24335,43809
1739,MAGNA INTL INC,40.5602102129,1566412,42.9597384227,2361979,35.0700433493,1643625,42.9507193298,794003,795567,-718354
1740,MAGNEGAS CORP,1.60565189467,28026,1.04912367317,16204,0.593052809941,35410,0.645483442741,82109,-11822,19206
1741,MAIDEN HOLDINGS LTD,14.9100222204,3981483,12.9401313285,4042231,12.2398890581,3853548,12.6900807063,3280909,60748,-188683
1742,MAIN STREET CAPITAL CORP,29.0700772715,37530,31.3236239023,18676,32.8640386163,24860,34.344953112,25273,-18854,6184
1743,MAKEMYTRIP LIMITED MAURITIUS,17.1595330739,154200,18.090694737,493237,14.8868380576,18204,23.586332023,16535,339037,-475033
1744,MALLINCKRODT PUB LTD CO,74.6298935512,2548456,61.2797227794,2526219,60.779827668,1850614,69.7806074139,695967,-22237,-675605
1745,MANCHESTER UTD PLC NEW,17.8114334471,65632,14.4376610837,131531,15.9305137443,101315,16.8795965312,92597,65899,-30216
1746,MANHATTAN ASSOCS INC,66.1695096382,688716,56.8704545577,1113478,64.1296657171,920089,57.6198399164,819197,424762,-193389
1747,MANITOWOC INC,15.3500424211,3352108,4.32987056876,2473746,5.45069193997,792193,4.79026687758,983035,-878362,-1681553
1748,MANNKIND CORP,1.45000048129,9765514,1.61004667494,9806548,1.16001888707,8568826,0.619948402629,6974774,41034,-1237722
1749,MANPOWERGROUP INC,84.2900949176,971158,81.4198239571,1149720,64.3400450233,1594730,72.2598172797,1448772,178562,445010
1750,MANTECH INTL CORP,30.2444427172,102928,31.9908874977,113251,37.8153301641,144095,37.6849319098,135996,10323,30844
1751,MANULIFE FINL CORP,14.9799070099,1458220,14.1297909376,3302172,13.6699295005,4244572,14.1098217415,4227906,1843952,942400
1752,MARATHON OIL CORP,12.5899716401,2352269,11.1400808689,3372866,15.0101943547,2417024,15.8097265603,4346881,1020597,-955842
1753,MARATHON PETE CORP,51.8401531814,4412024,37.1800773843,3649320,37.9601611455,2842401,40.5899401614,4468521,-762704,-806919
1754,MARCHEX INC,3.88575521533,111690,4.4514288879,144448,3.17990453888,156294,2.76476620749,144316,32758,11846
1755,MARCUS & MILLICHAP INC,29.1239821382,30456,25.3856781027,17372,25.4148602183,26756,26.1484694092,23749,-13084,9384
1756,MARCUS CORP,18.9988435487,12106,18.9592363124,37607,21.0973178105,31094,25.0336816808,54926,25501,-6513
1757,MARINEMAX INC,18.4208061444,32029,19.4572452637,42966,16.9925826028,29660,20.9521918105,110776,10937,-13306
1758,MARKEL CORP,883.348846166,62314,891.568497275,64769,952.761929744,45747,928.764954793,32849,2455,-19022
1759,MARKETAXESS HLDGS INC,111.590032666,508782,124.829922431,570328,145.400216577,763699,165.59076513,577810,61546,193371
1760,MARLIN BUSINESS SVCS CORP,16.0598069339,206665,14.3081799047,206665,16.3017443689,206665,19.3791885418,206665,0,0
1761,MARRIOTT INTL INC NEW,67.0398136271,797541,71.1805063634,1305821,66.4599741742,5417065,67.3299440892,1798041,508280,4111244
1762,MARRIOTT VACATIONS WRLDWDE C,56.9495519574,904713,67.4999242886,693423,68.4912294481,713011,73.3204021575,630002,-211290,19588
1763,MARSH & MCLENNAN COS INC,55.4500382487,1562145,60.7901823036,2165070,68.4595039265,1494577,67.2497628888,2727623,602925,-670493
1764,MARTIN MARIETTA MATLS INC,136.580194591,1288547,159.509814279,1183225,192.000911453,921605,179.109546969,830274,-105322,-261620
1765,MARVELL TECHNOLOGY GROUP LTD,8.81997519196,8070771,10.3100232782,9313849,9.53006221111,8215896,13.2700017581,8673925,1243078,-1097953
1766,MASCO CORP,28.3000465837,2681197,31.4499924725,2490875,30.9398852703,2428839,34.3101050506,2441205,-190322,-62036
1767,MASIMO CORP,41.5131958655,95295,41.8432977635,82092,52.5157362077,145842,59.4884507912,466309,-13203,63750
1768,MASONITE INTL CORP NEW,61.2061206121,17776,65.4996363532,277742,66.1394851926,962224,62.1704678239,1017541,259966,684482
1769,MASTEC INC,17.3810437991,106783,20.2430239391,222941,22.3211808446,288336,29.7391206413,657047,116158,65395
1770,MATADOR RES CO,19.77215351,235685,18.9603914689,270775,19.7990464133,334107,24.3405381755,1369033,35090,63332
1771,MATCH GROUP INC,13.5500480555,3470984,11.0599518921,6296682,15.0751259296,4885863,17.7907852982,1621626,2825698,-1410819
1772,MATERION CORP,28.0006765264,106426,26.482511985,129746,24.7605205787,75685,30.715123095,59710,23320,-54061
1773,MATRIX SVC CO,20.5381658429,45525,17.6977263217,57352,16.4861521371,39609,18.7673772011,38844,11827,-17743
1774,MATSON INC,42.6327486028,198439,40.1614731113,120887,32.2910170111,92998,39.877120551,51107,-77552,-27889
1775,MATTEL INC,27.1700044801,2035664,33.620165652,2574675,31.2901514599,6132249,30.2801214496,4970951,539011,3557574
1776,MATTHEWS INTL CORP,53.4472331418,13228,51.4947295663,11574,55.6348507395,32929,60.7526361614,41348,-1654,21355
1777,MAXIM INTEGRATED PRODS INC,38.0000290944,7286626,36.779907125,8587243,35.6900567917,6316241,39.9297488388,5791221,1300617,-2271002
1778,MAXIMUS INC,56.2501123288,723323,52.6396169563,1211350,55.3693613786,1262720,56.5603412614,1348878,488027,51370
1779,MAXLINEAR INC,14.7444847808,17905,18.5185185185,17820,17.9758071324,165834,20.2705135044,611134,-85,148014
1780,MB FINANCIAL INC NEW,32.3701939338,2241074,32.4498507379,2150580,36.2799550327,2156232,38.0401529897,2199886,-90494,5652
1781,MBIA INC,6.48002886838,781478,8.85002209224,914348,6.83101552479,375786,7.79056109665,760279,132870,-538562
1782,MBT FINL CORP,6.82808499169,22261,8.04251333632,49114,8.00856214939,27096,9.01557235224,10981,26853,-22018
1783,MCBC HLDGS INC,13.6980214418,247554,14.081724003,247981,11.0519634741,244210,11.3998948107,228160,427,-3771
1784,MCCLATCHY CO,1.19869753462,55894,1.0479390532,60118,14.6338867603,18792,16.111272095,17255,4224,-41326
1785,MCCORMICK & CO INC,85.5601253473,4330370,99.4799966155,3675553,106.67018187,3610981,99.919852202,2944560,-654817,-64572
1786,MCDERMOTT INTL INC,3.3534226016,213215,4.08983676137,1747258,4.94018582751,595929,5.01001398128,1488419,1534043,-1151329
1787,MCDONALDS CORP,118.140229468,4435644,125.679930064,7229420,120.339936143,5445258,115.359911271,4809227,2793776,-1784162
1788,MCEWEN MNG INC,1.05260455444,77902,1.87231986471,33114,3.83192977766,22443,3.67249945993,46290,-44788,-10671
1789,MCGRATH RENTCORP,25.1830869145,28948,25.0443262411,13536,30.5730382104,42423,31.708749266,175409,-15412,28887
1790,MCKESSON CORP,197.229804929,1806010,157.24984351,1690202,186.649201783,1484121,166.750606909,1634099,-115808,-206081
1791,MDC PARTNERS INC,21.7198462407,111603,23.5779546124,10179,18.282203317,93096,10.7223610615,84030,-101424,82917
1792,MDU RES GROUP INC,18.3193886603,1326791,19.4600936535,1737042,23.999897256,1635132,25.4400155479,1986123,410251,-101910
1793,MEAD JOHNSON NUTRITION CO,78.949937627,6719258,84.9697829121,1616304,90.7496993185,2431975,79.0100023248,1410872,-5102954,815671
1794,MEDGENICS INC,6.04594921403,13232,4.39472632841,15018,5.57153127247,16692,5.5715081644,23333,1786,1674
1795,MEDIA GEN INC NEW,16.150130269,1299618,16.3089980081,288675,17.1901610992,1099757,18.4306958809,829323,-1010943,811082
1796,MEDICAL PPTYS TRUST INC,11.5104337699,1114554,12.9809426027,870738,15.2093567821,1068487,14.7700412816,2147929,-243816,197749
1797,MEDICAL TRANSCRIPTION BLG CO,1.18791976973,21887,1.0238749011,21487,0.866250866251,17316,0.920863309353,17375,-400,-4171
1798,MEDICINES CO,37.3349696546,104299,31.7723928517,284209,33.6302279454,292921,37.7391873463,638673,179910,8712
1799,MEDIDATA SOLUTIONS INC,49.2982729995,70469,38.7060658163,75027,46.8752127906,73429,55.7583880211,432760,4558,-1598
1800,MEDIFAST INC,30.3845695916,83990,30.1872789977,91628,33.2686098756,88582,37.7855226538,39883,7638,-3046
1801,MEDLEY CAP CORP,7.48867990247,11484,6.60287616809,17871,6.71721893286,28881,7.62766827398,70926,6387,11010
1802,MEDNAX INC,71.6595391575,1050858,64.6202715237,1116956,72.4293664887,722497,66.2493539864,1035195,66098,-394459
1803,MEDTRONIC PLC,76.9200457414,6420446,74.9999667219,5258709,86.7698820419,5164799,86.4000004445,3599456,-1161737,-93910
1804,MEETME INC,3.55778099881,15178,2.84291428123,153012,5.32832917842,292024,6.19950958163,476328,137834,139012
1805,MEI PHARMA INC,1.59523556312,28209,1.2520121624,22364,1.34204943937,23099,1.7694296992,51429,-5845,735
1806,MELCO CROWN ENTMT LTD,16.8003046741,485765,16.5099646457,973291,12.5795946506,803603,16.1101727946,692730,487526,-169688
1807,MELLANOX TECHNOLOGIES LTD,42.1391208291,61558,54.3256269913,36723,47.9581395349,215000,43.2510469736,335252,-24835,178277
1808,MEMORIAL PRODTN PARTNERS LP,2.63575413276,78156,2.12631910537,38094,1.89723320158,18975,1.78314639057,17385,-40062,-19119
1809,MENTOR GRAPHICS CORP,18.4208308304,747469,20.3294769174,1698814,21.2598873196,1511532,26.4399733502,4631926,951345,-187282
1810,MERCADOLIBRE INC,114.384582112,20807,117.867399176,24027,140.663672197,87272,184.971478358,182493,3220,63245
1811,MERCER INTL INC,9.04939442068,656066,9.44942110202,651151,7.97908016482,633657,8.47013458623,641076,-4915,-17494
1812,MERCK & CO INC NEW,52.8200753365,11262536,52.9099503091,9282375,57.6100090425,11286754,62.4099793098,11834085,-1980161,2004379
1813,MERCURY GENL CORP NEW,46.568334578,535600,55.5002337066,492070,53.1603111742,481788,54.8505390333,525756,-43530,-10282
1814,MERCURY SYS INC,18.3429629214,35654,20.3106533851,59230,24.8478195789,50105,24.5697605702,167523,23576,-9125
1815,MEREDITH CORP,43.2518921115,157496,47.5039550009,45512,51.9002860646,75857,51.9910391807,218730,-111984,30345
1816,MERIDIAN BANCORP INC MD,14.1103701556,20694,13.9111212745,26238,14.7706871226,36762,15.5608052588,38944,5544,10524
1817,MERIDIAN BIOSCIENCE INC,20.51906172,129002,20.6038889182,37954,19.5133114654,65545,19.2895339954,136136,-91048,27591
1818,MERIT MED SYS INC,18.5943817834,112776,18.4930722547,87330,19.8307504078,39232,24.3063789424,8434,-25446,-48098
1819,MERITAGE HOMES CORP,33.9901320619,783345,36.4596807955,637773,37.539181819,650174,34.7006356941,857016,-145572,12401
1820,MERITOR INC,8.34151128557,93748,8.05813723552,80912,7.20360557431,53029,11.1291858801,542807,-12836,-27883
1821,MERRIMACK PHARMACEUTICALS IN,7.91921706954,28917,8.35999932986,59689,5.38963921121,110397,6.34994708377,120001,30772,50708
1822,METHANEX CORP,33.008554996,346698,32.1211973598,205285,29.0987449213,182379,35.6799354659,161155,-141413,-22906
1823,METHODE ELECTRS INC,31.8289173918,287066,29.2407147063,332892,34.2321228508,252599,34.9704943629,130653,45826,-80293
1824,METLIFE INC,48.2099490076,13281968,43.9399950122,10982887,39.8299730522,4385893,44.429956974,7690937,-2299081,-6596994
1825,METTLER TOLEDO INTERNATIONAL,339.128508182,510022,344.75945389,600758,364.918993076,707779,419.830052352,754703,90736,107021
1826,MFA FINL INC,6.59996943277,7602914,6.84999812587,13206135,7.2700087772,18304242,7.48002389488,17515051,5603221,5098107
1827,MGE ENERGY INC,46.4030994101,22714,52.2620169651,21220,56.5030283711,25096,56.499928336,34885,-1494,3876
1828,MGIC INVT CORP WIS,8.83014836938,2499505,7.67033227761,1449872,5.94998436266,2180678,7.99992662721,2616774,-1049633,730806
1829,MGM RESORTS INTERNATIONAL,22.719971228,9509255,21.439977262,6403365,22.629935425,2842739,26.0298932833,2349491,-3105890,-3560626
1830,MICHAEL KORS HLDGS LTD,40.059328558,1434048,56.9596478454,907783,49.4805600891,1340001,46.790156889,3301314,-526265,432218
1831,MICHAELS COS INC,22.1093252142,169476,27.9717968212,393289,28.4408311854,294471,24.1710180822,369037,223813,-98818
1832,MICROCHIP TECHNOLOGY INC,46.5400898012,1169250,48.2002097769,1258480,50.7601362295,1003307,62.1395318655,1787606,89230,-255173
1833,MICRON TECHNOLOGY INC,14.1600028933,12608472,10.4700675607,19387745,13.7600927741,12479349,17.7799586985,11589397,6779273,-6908396
1834,MICROSEMI CORP,32.5931421909,169821,38.3100509078,1366195,32.6804771339,1345115,41.9797981726,1676878,1196374,-21080
1835,MICROSOFT CORP,55.4800022717,24299260,55.2299665702,28844649,51.1699815099,26354690,57.6000240124,32116688,4545389,-2489959
1836,MICROSTRATEGY INC,179.277307192,31521,179.718327433,64117,175.02313815,81035,167.43858236,218504,32596,16918
1837,MID-AMER APT CMNTYS INC,90.8098101907,2924673,102.210240723,3238697,106.399815423,3055635,93.9900070007,2916842,314024,-183062
1838,MIDDLEBY CORP,107.870101835,2403298,106.770247706,2552462,115.249792864,2416282,123.619761378,2132240,149164,-136180
1839,MIDDLESEX WATER CO,26.5070542967,9356,30.8289941317,12099,43.3759741215,13602,35.2062868369,12725,2743,1503
1840,MILACRON HLDGS CORP,12.5133954332,60655,16.4730888939,13173,14.504834945,11996,15.970405125,11083,-47482,-1177
1841,MILLER HERMAN INC,28.7013148142,314341,30.8905231334,666159,29.8903008252,660716,28.599868936,1246719,351818,-5443
1842,MILLER INDS INC TENN,21.7832131285,47835,20.2790499521,46945,20.5971194677,45686,22.8001557084,53947,-890,-1259
1843,MIMECAST LTD,9.59644284347,71068,9.7249951697,62108,10.0307475175,19839,19.1392026888,10711,-8960,-42269
1844,MIMEDX GROUP INC,9.37158996084,31158,8.7341859798,101097,7.98021547727,174682,8.576358442,176765,69939,73585
1845,MINDBODY INC,15.1314728182,30995,13.3349338164,91639,16.1392015747,130056,19.659569708,107276,60644,38417
1846,MINERALS TECHNOLOGIES INC,45.8595085223,346384,56.8509064003,675750,56.8004040309,851420,70.6897525535,1345584,329366,175670
1847,MITEL NETWORKS CORP,7.68052423301,47002,8.20788774607,29362,6.28458228021,29278,7.34174461605,18388,-17640,-84
1848,MITSUBISHI UFJ FINL GROUP IN,6.21999853724,4279583,4.58971298868,3792394,4.42987442052,3640961,5.04997481348,3867148,-487189,-151433
1849,MIZUHO FINL GROUP INC,4.03995069417,3146078,2.94004408731,2620709,2.84995047198,2333023,3.36015493024,2280252,-525369,-287686
1850,MKS INSTRUMENT INC,35.9997697458,1285536,37.6499777123,1292192,43.0602333453,1420127,49.7304150211,973348,6656,127935
1851,MOBILE MINI INC,31.1298935473,1353747,33.0201853614,1092029,34.6393368366,1079553,30.2003701692,1073563,-261718,-12476
1852,MOBILE TELESYSTEMS PJSC,6.18023603331,1438780,8.09003459624,1516928,8.27989721568,2267661,7.62992774564,4961777,78148,750733
1853,MOBILEIRON INC,3.60964051683,54022,4.52634982218,27837,3.06656079731,36523,2.75620745854,41724,-26185,8686
1854,MOBILEYE N V AMSTELVEEN,42.2804782896,1349559,37.2897291803,1389042,46.1401465586,2042733,42.570412902,2291803,39483,653691
1855,MODEL N INC,11.16220107,93082,10.7793392101,42767,13.3622428399,19832,11.0885894837,16774,-50315,-22935
1856,MODINE MFG CO,9.05178624003,159637,11.0073052184,171795,8.80235198845,170409,11.8618438182,199716,12158,-1386
1857,MODUSLINK GLOBAL SOLUTIONS I,2.4942592446,25258,1.46993973247,34015,1.24245038827,28975,1.60758781448,12441,8757,-5040
1858,MOHAWK INDS INC,189.390565618,1059868,190.900198952,781094,189.760993815,298486,200.339771102,223680,-278774,-482608
1859,MOLINA HEALTHCARE INC,60.1282085307,414481,64.4894329453,551005,49.900150512,406612,58.320051634,379595,136524,-144393
1860,MOLSON COORS BREWING CO,93.9206608821,613241,96.1802635527,2436477,101.130084891,1985957,109.800070082,3473067,1823236,-450520
1861,MOMENTA PHARMACEUTICALS INC,14.838836478,111936,9.23764722781,111392,10.8059181119,89488,11.6905242133,306402,-544,-21904
1862,MOMO INC,16.0317460317,12600,11.1925515055,10096,10.1044504995,35232,22.5003370933,971541,-2504,25136
1863,MONDELEZ INTL INC,44.8400563753,6668881,40.1200355421,6001889,45.5099544502,5242831,43.9001203071,4718757,-666992,-759058
1864,MONEYGRAM INTL INC,6.26794132364,37971,6.10992599615,37971,6.84733085776,37971,7.1106897369,37971,0,0
1865,MONMOUTH REAL ESTATE INVT CO,10.4511620842,32915,11.8666132586,19972,13.242641305,16613,14.2762284197,90360,-12943,-3359
1866,MONOGRAM RESIDENTIAL TR INC,9.75907806414,589195,9.86005579273,519064,10.2106119428,518774,10.6413169183,609605,-70131,-290
1867,MONOLITHIC PWR SYS INC,63.7154373807,28282,63.6964255463,11806,68.3127693926,67513,80.5035765379,174750,-16476,55707
1868,MONOTYPE IMAGING HOLDINGS IN,23.6396106007,861224,23.919637973,542943,24.6304405545,534826,22.1033392986,52526,-318281,-8117
1869,MONRO MUFFLER BRAKE INC,66.2179404785,318977,71.4684649277,435087,63.5594755336,469277,61.1694024705,374174,116110,34190
1870,MONSANTO CO NEW,98.5196457205,1638932,87.740225006,1287699,103.409840319,1742281,102.199974178,2106752,-351233,454582
1871,MONSTER BEVERAGE CORP NEW,148.960251473,622891,133.381238067,677734,160.709947083,728505,146.808953473,792765,54843,50771
1872,MONSTER WORLDWIDE INC,5.73028879814,332793,3.25864532934,272199,2.39021844479,670650,3.61010830325,205257,-60594,398451
1873,MOODYS CORP,100.341504136,592965,96.5585908793,632735,93.7102125405,645618,108.27951917,614770,39770,12883
1874,MOOG INC,60.6002529802,860937,45.6795361335,862662,53.9194335676,932150,59.5404647804,991393,1725,69488
1875,MORGAN STANLEY,31.8098557951,3536011,25.0099622207,9658991,25.9799359302,9431586,32.0599335997,9669234,6122980,-227405
1876,MORGAN STANLEY ASIA PAC FD I,13.8291339278,555277,13.6902688931,545570,13.7792310377,544370,15.0863390496,538169,-9707,-1200
1877,MORGAN STANLEY EM MKTS DM DE,6.81134167591,18939,7.6064200977,14330,7.65696784074,14366,8.03197848177,26768,-4609,36
1878,MORGANS HOTEL GROUP CO,3.38322739389,29262,1.37738447895,52999,2.1432532486,66721,2.03498610731,25553,23737,13722
1879,MORNINGSTAR INC,80.3925455987,30264,88.2682686033,59761,81.7913531061,67770,79.2722547109,72333,29497,8009
1880,MOSAIC CO NEW,27.589934421,1124903,27.000003607,1386185,26.1795798253,1170989,24.4602494366,2116209,261282,-215196
1881,MOSYS INC,1.09899771408,45496,0.659055224951,51589,0.401254833297,54828,0.756475429678,66096,6093,3239
1882,MOTOROLA SOLUTIONS INC,68.4498879809,748533,75.7012295653,567111,65.9700268181,792375,76.281906804,492489,-181422,225264
1883,MOVADO GROUP INC,25.7174124514,49344,27.5563067201,27217,21.6593573794,11173,21.4694028081,37961,-22127,-16044
1884,MPLX LP,39.3300051274,10676022,29.6900083058,19503329,33.6300612083,16875170,33.860031162,14527305,8827307,-2628159
1885,MRC GLOBAL INC,12.8979304684,68228,13.1404712576,631332,14.2095205285,801153,16.4295442033,552176,563104,169821
1886,MSA SAFETY INC,43.4694458792,414314,48.3504272162,509344,52.5295230536,509009,58.0406925371,518326,95030,-335
1887,MSC INDL DIRECT INC,56.2702304479,299981,76.3123999079,204187,70.56006998,434410,73.4102701774,460031,-95794,230223
1888,MSCI INC,72.1298912435,1375366,74.079681462,1235143,77.1199392212,1021409,83.9403460441,906763,-140223,-213734
1889,MSG NETWORK INC,20.798955004,633878,17.2899356182,1001681,15.3403277078,1099455,18.6088788585,546782,367803,97774
1890,MTS SYS CORP,63.4026927785,16340,60.8428871306,30965,43.8351826364,82103,46.0280832679,40736,14625,51138
1891,MUELLER INDS INC,27.0957998666,193351,29.4182432267,204295,31.8812363105,180796,32.421028294,173005,10944,-23499
1892,MUELLER WTR PRODS INC,8.6008302637,342060,9.87968881367,1089508,11.4201064294,1028099,12.5497497774,983924,747448,-61409
1893,MURPHY OIL CORP,22.4498198662,1845850,25.1901347312,1518134,31.7499413019,1737704,30.4000527598,2517068,-327716,219570
1894,MURPHY USA INC,60.7424554184,279936,61.450660899,440158,74.160393409,901047,71.3600534166,1299971,160222,460889
1895,MYERS INDS INC,13.3356667833,28570,12.8363284766,29993,14.3947277142,46128,13.0141567272,35884,1423,16135
1896,MYLAN N V,54.0699593339,20205767,46.3499990834,15383366,43.2397884666,7993633,38.1201087495,7268080,-4822401,-7389733
1897,MYRIAD GENETICS INC,43.1577606808,133487,37.4317625943,215058,30.5992984551,991526,20.5803479146,1441618,81571,776468
1898,NABORS INDUSTRIES LTD,8.50983564997,3297596,9.19993718557,2776432,10.049934524,2268771,12.1602554344,1563454,-521164,-507661
1899,NANOVIRICIDES INC,1.16595413914,25730,2.1868621652,96028,1.6255356879,13534,1.68604135238,22538,70298,-82494
1900,NANTKWEST INC,17.3319626414,228595,8.22359463669,91809,6.22337593184,30048,7.78474061632,30958,-136786,-61761
1901,NASDAQ INC,58.1695704081,1878783,66.3798459346,2142337,64.6702234571,2016987,67.5395700724,2016107,263554,-125350
1902,NATERA INC,10.8003199934,921269,9.49438625575,13271,12.0776117835,38087,11.1159865438,13674,-907998,24816
1903,NATIONAL BEVERAGE CORP,45.4602379461,15970,42.3559896352,10034,62.7844141069,14064,44.0524292894,71029,-5936,4030
1904,NATIONAL BK HLDGS CORP,21.3705316837,100793,20.3866894647,45618,20.3634409047,48371,23.3759378652,53046,-55175,2753
1905,NATIONAL CINEMEDIA INC,15.7063281892,54755,15.2165014505,56189,15.4750734972,79935,14.72231761,160165,1434,23746
1906,NATIONAL FUEL GAS CO N J,42.7458649607,150845,50.0521714334,154299,56.8776140702,131739,54.06713678,243771,3454,-22560
1907,NATIONAL GEN HLDGS CORP,21.8602278242,2169831,21.5898990213,2184818,21.4200745361,2150366,22.2399979577,2115243,14987,-34452
1908,NATIONAL GRID PLC,69.5376833794,194542,71.4200456979,234584,74.3285368191,238993,71.1139294018,236550,40042,4409
1909,NATIONAL HEALTH INVS INC,60.8698863343,1353970,66.5190438808,923525,75.0895637392,1007104,78.4796646579,927769,-430445,83579
1910,NATIONAL HEALTHCARE CORP,61.6990982439,4214,62.2641509434,5830,64.6963233801,9846,66.0046728972,15408,1616,4016
1911,NATIONAL INSTRS CORP,28.6884499863,164805,30.1090720968,347935,27.401179064,356554,28.3997829187,792330,183130,8619
1912,NATIONAL OILWELL VARCO INC,33.490049904,2263747,31.1001333565,2155875,33.649625455,3222443,36.7398622066,3971599,-107872,1066568
1913,NATIONAL PRESTO INDS INC,82.8712571832,29757,83.7308200678,17401,94.3094629156,3128,87.7842411423,3782,-12356,-14273
1914,NATIONAL RETAIL PROPERTIES I,40.0501988454,3471793,46.2001059094,3814580,51.7199669102,5084342,50.8500477088,4907901,342787,1269762
1915,NATIONAL STORAGE AFFILIATES,17.1411892695,37687,21.2085463363,38145,20.8170522038,102368,20.933644686,96782,458,64223
1916,NATIONSTAR MTG HLDGS INC,13.3729865671,100202,9.90236775585,43121,11.2641966114,21484,14.8082168903,143704,-57081,-21637
1917,NATURAL GAS SERVICES GROUP,22.3365816271,9133,21.6010165184,14953,22.9080280063,29422,24.5688050627,16118,5820,14469
1918,NATURAL HEALTH TRENDS CORP,33.5974643423,6310,33.1354455701,30994,28.1705948373,17820,28.2384282384,15015,24684,-13174
1919,NATUS MEDICAL INC DEL,48.0507396106,146158,38.4327298086,116151,37.8026242839,108220,39.2862266462,90617,-30007,-7931
1920,NAUTILUS INC,16.7206262038,24401,19.3499622071,13230,17.8455386153,20005,22.7232301672,202392,-11171,6775
1921,NAVIDEA BIOPHARMACEUTICALS I,1.32993358798,3897939,0.944338594556,3609934,0.530586081698,4283942,0.915390889513,1022514,-288005,674008
1922,NAVIENT CORP,11.4499378436,5443523,11.9703010987,2924822,11.950250301,4386519,14.4699717973,3445411,-2518701,1461697
1923,NAVIGANT CONSULTING INC,16.0576887336,107612,15.809751561,158067,16.1486097999,140879,20.2234797922,159567,50455,-17188
1924,NAVIGATORS GROUP INC,85.7580398162,5224,83.8566195709,7644,91.943847224,15814,96.9148222669,11928,2420,8170
1925,NAVIOS MARITIME ACQUIS CORP,3.01020732362,1731110,1.58982341028,930292,1.56836192542,144737,1.35366986196,127062,-800818,-785555
1926,NAVIOS MARITIME HOLDINGS INC,1.75326601991,111221,1.1325268049,94479,0.810222179275,672655,1.21016538927,567691,-16742,578176
1927,NAVISTAR INTL CORP NEW,8.8367376503,48321,12.5,19440,11.6896918172,26348,22.8914774403,108512,-28881,6908
1928,NCR CORP NEW,24.459377442,779333,29.9298687106,797932,27.7699646989,632842,32.1905766847,547769,18599,-165090
1929,NEENAH PAPER INC,62.4409035195,28555,63.6678200692,30345,72.3727451983,41079,79.0092904377,49298,1790,10734
1930,NEKTAR THERAPEUTICS,16.8510516761,462167,13.7489541801,366937,14.2312682452,394624,17.1801349706,840331,-95230,27687
1931,NELNET INC,33.5692526863,65983,39.3851581202,39685,34.7503175999,51165,40.36895527,77733,-26298,11480
1932,NEOGEN CORP,56.554889333,13509,50.3303536728,5146,56.3077939234,12112,55.9453643933,74823,-8363,6966
1933,NEOPHOTONICS CORP,10.8797745773,12776,14.043109079,18372,9.51005176357,16614,16.3394464666,641515,5596,-1758
1934,NET 1 UEPS TECHNOLOGIES INC,13.5055255718,77820,9.15815427968,11356,9.98946092041,176486,8.56230031949,125200,-66464,165130
1935,NETAPP INC,26.5301629238,1889472,27.2905951327,1845874,24.5900167603,1615127,35.8189176068,1067006,-43598,-230747
1936,NETEASE INC,181.240829158,660381,143.580101987,750487,193.219633047,696275,240.781263939,571689,90106,-54212
1937,NETFLIX INC,114.379885032,5444821,102.229854267,3374660,91.4801212235,3756368,98.550069157,3993087,-2070161,381708
1938,NETGEAR INC,41.9105583762,193221,40.3693849634,225889,47.53673293,236028,60.4892608297,295507,32668,10139
1939,NETLIST INC,0.895583146754,24565,1.36320824865,40346,1.17123448114,46959,1.23895712131,37128,15781,6613
1940,NETQIN MOBILE INC,3.6437157013,45009,4.58027844139,364170,3.70778901484,75247,3.82239882521,92612,319161,-288923
1941,NETSCOUT SYS INC,30.7002122568,850385,22.9699094187,1602096,22.2499274003,1714882,29.2498474862,2042438,751711,112786
1942,NETSUITE INC,84.6214082953,224754,68.4817911685,72355,72.7978299524,77049,110.686353791,176833,-152399,4694
1943,NETWORK 1 TECHNOLOGIES INC,2.09261770975,51610,1.92225004426,39537,2.64135053401,26123,2.7330264672,20856,-12073,-13414
1944,NEURALSTEM INC,1.03097968216,159072,0.726163677293,13771,0.266258403781,15023,0.318725099602,12550,-145301,1252
1945,NEUROCRINE BIOSCIENCES INC,56.5705733562,209137,39.549869197,783239,45.4499335819,640639,50.6402584306,721896,574102,-142600
1946,NEUSTAR INC,23.9694720903,213313,24.5988955495,398026,23.5092282462,489042,26.5889097559,445148,184713,91016
1947,NEVRO CORP,67.6949443016,1167,56.2574274235,141368,73.7582738908,175099,104.390110134,722032,140201,33731
1948,NEVSUN RES LTD,2.70798428686,351553,3.2390578361,169185,2.94054710743,144871,3.03241895262,200500,-182368,-24314
1949,NEW GOLD INC CDA,2.32172867235,502212,3.72999021605,876946,4.37986816428,2661039,4.35076366751,1576275,374734,1784093
1950,NEW JERSEY RES,32.9603296247,2337689,36.4299422203,2325038,38.5501091758,1961058,32.8597103017,1715992,-12651,-363980
1951,NEW MTN FIN CORP,13.0202327498,997294,12.640369527,861209,12.9005930934,862596,13.7587558278,710384,-136085,1387
1952,NEW ORIENTAL ED & TECH GRP I,31.3696074472,519930,34.5906478075,632194,41.8801231381,1367570,46.3600829052,1514018,112264,735376
1953,NEW RELIC INC,36.4150054936,6371,26.0773975531,49123,29.3843745666,100938,38.3477029983,15542,42752,51815
1954,NEW RESIDENTIAL INVT CORP,12.1593199335,1047427,11.6299865611,2152711,13.839888936,2157315,13.8101445488,1917069,1105284,4604
1955,NEW SR INVT GROUP INC,9.87195777539,40924,10.2905800145,52378,10.6810178543,145679,11.5412797751,416245,11454,93301
1956,NEW YORK & CO INC,2.26574694124,19861,3.95819258435,125815,1.49480116946,90982,2.26764511354,31751,105954,-34833
1957,NEW YORK CMNTY BANCORP INC,16.3199962795,7568813,15.8999067255,8601497,14.9900096437,7485719,14.2299609077,7393274,1032684,-1115778
1958,NEW YORK MTG TR INC,5.32857502008,163083,4.74165169028,223129,6.0983289253,150861,6.0225846926,119550,60046,-72268
1959,NEW YORK REIT INC,11.5015560929,339954,10.0991217088,529551,9.25005013855,244323,9.15037029291,210374,189597,-285228
1960,NEW YORK TIMES CO,13.4173922214,256011,12.4591947769,238940,12.1012580948,412767,11.9506001763,831339,-17071,173827
1961,NEWCASTLE INVT CORP NEW,4.07470288625,70680,4.32812261317,19639,4.60064861603,13259,4.548480142,18028,-51041,-6380
1962,NEWELL RUBBERMAID INC,44.0801632065,833300,44.2902715614,2862299,48.5699819721,6432821,52.6598258837,8589660,2028999,3570522
1963,NEWFIELD EXPL CO,32.5600052805,3923863,33.2499303913,6274359,44.1799775579,6285517,43.4598361531,4540215,2350496,11158
1964,NEWLINK GENETICS CORP,36.3926636413,79549,18.1999385263,107363,11.2179487179,10608,15.0358367093,12836,27814,-96755
1965,NEWMARKET CORP,380.756820182,23863,396.277951781,27458,414.419264843,20431,429.309773606,45275,3595,-7027
1966,NEWMONT MINING CORP,17.9898146534,2094185,26.5800578494,1976858,39.1199578754,5289065,39.2899182012,2541848,-117327,3312207
1967,NEWPARK RES INC,5.27351989875,99554,4.31980442815,143988,5.78909834221,262217,7.35790975298,173147,44434,118229
1968,NEWS CORP NEW,13.5246347712,3077865,12.8214323854,1254774,11.3846612659,1019354,14.0065948431,2920767,-1823091,-235420
1969,NEXPOINT RESIDENTIAL TR INC,13.0865287588,31712,13.0802212142,32186,18.2137033505,32503,19.6656394682,67173,474,317
1970,NEXSTAR BROADCASTING GROUP I,58.6998523051,1155761,44.2696345423,736419,47.5793931614,911445,57.7106829612,1016207,-419342,175026
1971,NEXTERA ENERGY INC,102.739491415,2569090,118.33988046,2186710,130.400155658,2261370,122.320092647,2359923,-382380,74660
1972,NEXTERA ENERGY PARTNERS LP,29.8517254953,15242,27.1828126023,15267,30.3834507162,29391,27.9736098021,79575,25,14124
1973,NGL ENERGY PARTNERS LP,11.0404353779,461576,7.51990607643,1328740,19.3218236328,96730,18.8388951969,446523,867164,-1232010
1974,NIC INC,19.6751132955,62668,18.0321688867,127328,21.9433266736,177685,23.4982393002,464588,64660,50357
1975,NICE SYS LTD,57.3160056562,74255,64.7914892075,55177,63.8507805636,73985,66.9256938893,53791,-19078,18808
1976,NIELSEN HLDGS PLC,46.6001576149,1407227,52.6598384396,3614994,51.9695807486,1885122,53.5700482081,1099607,2207767,-1729872
1977,NII HLDGS INC,5.05037258137,762518,5.52941954318,983105,3.18002030703,1649675,3.33178464704,553157,220587,666570
1978,NIKE INC,62.500072191,10389108,61.4700399672,10428560,55.2000791147,10172576,52.6500932886,12402903,39452,-255984
1979,NIMBLE STORAGE INC,9.19877999526,143606,7.83995239742,124363,7.96007247989,157285,8.82869494731,148040,-19243,32922
1980,NIPPON TELEG & TEL CORP,39.738695413,423567,43.2387868994,425752,47.0798935823,423238,45.8104232146,407571,2185,-2514
1981,NISOURCE INC,19.5101336563,4226214,23.5600308005,4938873,26.5199649967,5398348,24.1099528215,8135271,712659,459475
1982,NIVALIS THERAPEUTICS INC,7.74080863467,369858,4.16122320608,20667,4.61133069829,27324,8.12744245225,77023,-349191,6657
1983,NMI HLDGS INC,6.77376137829,79867,5.05221778519,144491,5.48369688213,57443,7.6220761552,61007,64624,-87048
1984,NN INC,15.9241366971,11178,13.6870155039,57792,13.9906837356,61398,18.240297334,69955,46614,3606
1985,NOAH HLDGS LTD,27.989821883,7467,24.8803356753,975228,24.1102908791,1310063,26.1097434075,630416,967761,334835
1986,NOBILIS HEALTH CORP,2.78687074228,22606,3.12862516258,56894,2.23190722505,66311,3.34858569052,48080,34288,9417
1987,NOBLE CORP PLC,10.5495884275,1119001,10.3499033567,2082918,8.24021751174,1759905,6.3402138065,3436004,963917,-323013
1988,NOBLE ENERGY INC,32.9298155268,5169206,31.4098483148,2125257,35.8697956693,2325299,35.7398091719,2583058,-3043949,200042
1989,NOKIA CORP,7.02040287224,1079995,5.90995572934,1296118,5.69045807257,1558574,5.78946329524,1519830,216123,262456
1990,NOMURA HLDGS INC,5.54970939519,1086183,4.44032592365,911870,3.51034066233,1657389,4.45017107714,831204,-174313,745519
1991,NORDIC AMERICAN TANKERS LIMI,15.5324928606,57428,14.089011719,121939,13.8920548084,78966,10.1104471041,186243,64511,-42973
1992,NORDSON CORP,64.1589227088,35942,76.04220078,64359,83.609813534,181749,99.6301807841,271484,28417,117390
1993,NORDSTROM INC,49.8100438322,811503,57.2101293803,631549,38.0507484343,803611,51.8793340923,628015,-179954,172062
1994,NORFOLK SOUTHERN CORP,84.5901696295,805992,83.2497930105,962609,85.1298752334,1310527,97.0600752091,1607252,156617,347918
1995,NORTH ATLANTIC DRILLING LTD,2.45733788396,175800,2.73451702824,132016,6.74360154342,56498,3.03391067245,26039,-43784,-75518
1996,NORTHERN DYNASTY MINERALS LT,0.306689376888,394536,0.32365749013,373852,0.31141200431,321118,0.712856230099,189379,-20684,-52734
1997,NORTHERN OIL & GAS INC NEV,3.85996985943,1011925,3.98951009932,573504,4.62072976046,539958,2.68003762953,844018,-438421,-33546
1998,NORTHERN TR CORP,72.0900445238,2531903,65.1697453498,2489376,66.2599065743,2499098,67.9896239843,2612178,-42527,9722
1999,NORTHFIELD BANCORP INC DEL,15.9208938782,76252,16.4404645306,71470,14.8256915498,63336,16.1107329249,30849,-4782,-8134
2000,NORTHROP GRUMMAN CORP,188.810998725,1030083,197.898790778,954498,222.280040951,943562,213.949252323,1218775,-75585,-10936
2001,NORTHSTAR ASSET MGMT GROUP I,12.1399859405,7190865,11.3499871133,6991726,10.2099297404,3957324,12.9297305704,2932157,-199139,-3034402
2002,NORTHSTAR REALTY EUROPE CORP,11.810188152,951890,11.6011922534,395218,9.24938200222,546523,10.9506701672,57896,-556672,151305
2003,NORTHSTAR RLTY FIN CORP,17.0297166801,2051003,13.1201330341,2237020,11.4301768889,2651665,13.1699654022,1921797,186017,414645
2004,NORTHWEST BANCSHARES INC MD,13.3847129408,102505,13.5151250149,100628,14.8299019631,213083,15.7093142402,315227,-1877,112455
2005,NORTHWEST BIOTHERAPEUTICS IN,3.20079104806,622971,1.46013502728,638982,0.581167865695,958415,0.54287943251,994696,16011,319433
2006,NORTHWEST NAT GAS CO,50.6086984714,61689,53.8449166324,55957,64.8008849558,45200,60.1140261992,81911,-5732,-10757
2007,NORTHWESTERN CORP,54.2497765176,1328964,61.7499526512,1393912,63.0695587392,1167790,57.5294693528,1231873,64948,-226122
2008,NORWEGIAN CRUISE LINE HLDGS,58.6004347625,886461,55.2911651142,418783,39.8399610237,541868,37.7006264091,732269,-467678,123085
2009,NOVADAQ TECHNOLOGIES INC,12.7399378609,352435,11.0909339995,343073,9.8394556613,269832,11.5675996073,107974,-9362,-73241
2010,NOVAGOLD RES INC,4.20963753694,165810,5.03922336675,94459,6.11874128751,175036,5.59807704472,94854,-71351,80577
2011,NOVARTIS A G,86.039942576,967539,72.4390521559,913568,82.5099958938,871858,78.9605269237,973955,-53971,-41710
2012,NOVATEL WIRELESS INC,1.67857656707,20851,1.74411361654,16054,1.53155815891,37217,3.13146945913,248765,-4797,21163
2013,NOVAVAX INC,8.39006741088,268651,5.15994339338,471323,7.26967195149,355862,2.08038467096,574413,202672,-115461
2014,NOVO-NORDISK A S,58.07963114,720924,54.1906272929,797315,53.7798432947,759132,41.5894693669,777769,76391,-38183
2015,NOVOCURE LTD,22.4719101124,356,14.5172997822,4133,11.6806937006,19605,8.53595447491,15464,3777,15472
2016,NOW INC,15.8195107299,149815,17.7242189488,184719,18.1403028974,387590,21.4299635442,2437195,34904,202871
2017,NRG ENERGY INC,11.7700209767,7733801,13.0101228149,3857919,14.9902042412,3248855,11.209643529,2565202,-3875882,-609064
2018,NRG YIELD INC,14.6272340815,65631,13.9742505404,106410,15.482152435,165933,16.7691390265,97262,40779,59523
2019,NTN BUZZTIME INC,0.158179355617,101151,0.149245378057,160809,8.59637340497,22335,7.08198986642,17368,59658,-138474
2020,NTT DOCOMO INC,20.4996931341,381274,22.7698821331,466713,27.009669784,465574,25.409946997,450729,85439,-1139
2021,NU SKIN ENTERPRISES INC,37.8881814509,287108,38.250124564,501750,46.191242661,610094,64.7806679463,793956,214642,108344
2022,NUANCE COMMUNICATIONS INC,19.8891794469,652767,18.6902647583,3790476,15.6302001588,4125475,14.5001630862,4273814,3137709,334999
2023,NUCOR CORP,40.3002704716,2979980,47.3000819501,4835869,49.4100115797,5761808,49.4494533594,1433666,1855889,925939
2024,NUSTAR ENERGY LP,40.1001949617,2251211,40.4002289474,2984092,49.8001026227,4057582,49.5802581212,2872837,732881,1073490
2025,NUSTAR GP HOLDINGS LLC,21.1499220997,1185489,20.7298743462,1081145,25.6400615477,1037244,25.5802927697,1018753,-104344,-43901
2026,NUTRI SYS INC NEW,21.636282246,227858,20.8653367376,188782,25.367425005,29802,29.7014699197,19797,-39076,-158980
2027,NUVASIVE INC,54.1088099846,486187,48.6514209992,454293,59.7197942513,1628589,66.6602294748,1501690,-31894,1174296
2028,NVIDIA CORP,32.9599434826,10876657,35.629984272,18909607,47.0099063779,6064275,68.519917538,10895197,8032950,-12845332
2029,NVR INC,1642.99265858,48492,1732.39631519,50586,1780.32141006,48225,1639.87336047,55275,2094,-2361
2030,NXP SEMICONDUCTORS N V,84.2505907735,1692273,81.0700151693,1746293,78.3399354828,3230766,102.009724963,2119494,54020,1484473
2031,NXSTAGE MEDICAL INC,21.9032556474,33511,14.9844581125,105843,21.682395086,100773,24.9893651752,505415,72332,-5070
2032,O REILLY AUTOMOTIVE INC NEW,253.420230301,710113,273.662348952,487758,271.10186632,608631,280.111764917,530399,-222355,120873
2033,OAKTREE CAP GROUP LLC,47.7203321644,662443,49.3302754269,185748,44.7577409447,216834,42.3997564659,338351,-476695,31086
2034,OASIS PETE INC NEW,7.3700144794,759700,7.28007530939,3188978,9.33980910561,1556777,11.4699319241,3444833,2429278,-1632201
2035,OCCIDENTAL PETE CORP DEL,67.6097649733,1461919,68.4299465364,2774224,75.5600369632,2777897,72.9203378727,2834559,1312305,3673
2036,OCEAN RIG UDW INC,1.6293310181,261457,0.82057086266,282730,2.48014894051,152007,0.837437606753,120606,21273,-130723
2037,OCEANEERING INTL INC,37.5167418648,133647,33.2397155376,432254,29.8608909782,1334421,27.5101094226,2612167,298607,902167
2038,OCH ZIFF CAP MGMT GROUP,6.23032220037,615859,4.34986643564,498636,3.80068300453,518591,4.34047831634,960954,-117223,19955
2039,OCLARO INC,3.47998837064,2947711,5.39929801312,639898,4.87952441077,304128,8.54966716732,562595,-2307813,-335770
2040,OCWEN FINL CORP,6.97012792494,2908268,2.46916762721,543098,1.71065018177,668167,3.66970692198,822409,-2365170,125069
2041,OFFICE DEPOT INC,5.64000978819,21180637,7.099996646,18783530,3.31007564757,6448191,3.57007669322,6771003,-2397107,-12335339
2042,OFG BANCORP,7.32004719035,505188,6.99162168548,550230,8.30140904201,609776,10.1106583424,534980,45042,59546
2043,OGE ENERGY CORP,26.2902640266,889721,28.6303435348,1226950,32.7499887275,1308489,31.6202702549,1675381,337229,81539
2044,OIL STS INTL INC,27.2491275919,646773,31.5201379495,664591,32.8806215543,478671,31.5704090237,654632,17818,-185920
2045,OLD DOMINION FGHT LINES INC,59.0701924227,735464,69.6175126293,270205,60.3104655557,280482,68.6102419868,1327965,-465259,10277
2046,OLD NATL BANCORP IND,13.5594639866,238800,12.1897034676,310590,12.529759231,712384,14.0605830209,578710,71790,401794
2047,OLD REP INTL CORP,18.6299259964,1732213,18.2800351884,3646656,19.2900820386,4061258,17.6201102565,2885453,1914443,414602
2048,OLIN CORP,17.2602003983,1720374,17.3698544521,2707219,24.8399541675,3614902,20.519985099,3849418,986845,907683
2049,OM ASSET MGMT PLC,15.3299695971,2847429,13.3499161301,2266606,13.3499118441,2422413,13.9098727283,2279532,-580823,155807
2050,OMEGA HEALTHCARE INVS INC,34.9798876614,1983111,35.2998688683,2421992,33.9498884866,3006814,35.4500124498,4072354,438881,584822
2051,OMEGA PROTEIN CORP,22.2075013407,31701,16.9449668509,52641,19.9995359736,43101,23.3681131474,244778,20940,-9540
2052,OMEROS CORP,15.7247732834,173675,15.3404968386,57886,10.5263157895,37050,11.1636772064,29381,-115789,-20836
2053,OMNICELL INC,31.0768531627,57213,27.8671643712,93228,34.2691990091,9688,38.3030096093,164008,36015,-83540
2054,OMNICOM GROUP INC,75.6597031946,1125923,83.230633185,712430,81.4892499819,702743,85.0001156994,821093,-413493,-9687
2055,OMNOVA SOLUTIONS INC,6.1533843614,19989,5.55748249984,126856,7.25027703024,221095,8.43961197695,180814,106867,94239
2056,ON ASSIGNMENT INC,44.9495663505,813445,36.9204993564,929917,36.9501964255,918669,36.2902622501,1203050,116472,-11248
2057,ON DECK CAP INC,10.2995392715,456234,7.79104701236,387111,5.15100453662,385750,5.69928132897,395313,-69123,-1361
2058,ON SEMICONDUCTOR CORP,9.80034189723,1498111,9.58993312489,1918053,8.82010637991,1455538,12.3198161335,1735172,419942,-462515
2059,ONCOGENEX PHARMACEUTICALS IN,1.20576354977,33174,0.675310642896,29616,1.00768358735,23817,0.49907670809,20037,-3558,-5799
2060,ONCOMED PHARMACEUTICALS INC,22.5291204576,14337,10.1040433838,56611,12.3283626163,27092,11.4336530522,31486,42274,-29519
2061,ONE GAS INC,50.1644018972,137468,61.099697651,206384,66.5905156954,256508,61.8387489336,461814,68916,50124
2062,ONE HORIZON GROUP INC,1.15812917595,44900,0.821018062397,14616,0.779355732594,11548,0.519851842225,15389,-30284,-3068
2063,ONE LIBERTY PPTYS INC,21.4745884037,22352,22.3884318125,20055,23.847934348,28514,24.1584671155,38620,-2297,8459
2064,ONEBEACON INSURANCE GROUP LT,12.4059681642,48122,12.7341482719,56855,13.806592648,69532,14.2825352512,49431,8733,12677
2065,ONEMAIN HLDGS INC,41.5397793078,517191,27.4301776116,384941,22.81840559,302256,30.9503190464,407621,-132250,-82685
2066,ONEOK INC NEW,24.6601014024,2750232,29.8599003439,1679376,47.4498633087,2266055,51.3900209824,2927222,-1070856,586679
2067,ONEOK PARTNERS LP,30.1299168856,8388440,31.3999777261,6922903,40.0600373109,7062275,39.9499682151,8057278,-1465537,139372
2068,OOMA INC,6.36579572447,10525,5.88806604346,16474,8.16231343284,12864,9.0686364135,27347,5949,-3610
2069,OPEN TEXT CORP,47.9309594802,441364,51.8006309148,396250,59.1598540452,452469,64.8615189622,271409,-45114,56219
2070,OPHTHOTECH CORP,78.5288787986,384088,42.2718006955,283546,51.0279437882,277593,46.1306498839,742825,-100542,-5953
2071,OPKO HEALTH INC,10.0499514872,1139906,10.3901635804,2009593,9.34031262943,2001539,10.5894109472,1116776,869687,-8054
2072,ORACLE CORP,36.5299724532,17133766,40.9100142029,25255430,40.9299687567,22747904,39.2800241091,24458819,8121664,-2507526
2073,ORANGE,16.6302401096,719713,17.3793990221,768381,16.4196524668,704278,15.5800513004,615980,48668,-64103
2074,ORASURE TECHNOLOGIES INC,6.42592545926,39683,7.20357297219,13882,5.90867446523,150626,7.96528110298,131571,-25801,136744
2075,ORBCOMM INC,7.23687660601,38138,10.1345707657,53875,9.94665254928,98224,10.250527414,433246,15737,44349
2076,ORBITAL ATK INC,89.3376238234,340909,86.9376295207,329098,85.1373421675,398603,76.2304962771,882652,-11811,69505
2077,ORBOTECH LTD,22.1303689251,38951,23.7804273871,90831,25.5501322499,36673,29.6172816953,43792,51880,-54158
2078,OREXIGEN THERAPEUTICS INC,1.71998284945,608727,0.56255246201,563503,0.431115143275,422161,3.31796693778,34057,-45224,-141342
2079,ORGANOVO HLDGS INC,2.48999983935,435743,2.16806722689,59500,3.74919198449,15470,3.79825426391,27381,-376243,-44030
2080,ORION ENERGY SYSTEMS INC,2.18388294387,13737,1.40947164948,24832,1.15165157305,19103,1.3391183245,18669,11095,-5729
2081,ORION ENGINEERED CARBONS S A,12.5898176012,16283,14.1099544008,23246,15.8698931077,15249,18.7373194892,25137,6963,-7997
2082,ORITANI FINL CORP DEL,16.499949271,1113761,16.9703470266,1129971,15.9907431997,1159796,15.7201821375,1159783,16210,29825
2083,ORMAT TECHNOLOGIES INC,36.4561053282,42078,41.2466182005,66163,43.7676412169,57394,48.4062918659,147047,24085,-8769
2084,ORRSTOWN FINL SVCS INC,17.8579776542,21391,17.3168515816,36323,18.0516123565,23599,19.7405527355,12411,14932,-12724
2085,ORTHOFIX INTL N V,39.2085191413,41037,41.5102974828,65550,42.4056315303,76853,42.7686794707,159065,24513,11303
2086,OSHKOSH CORP,39.0292140505,95057,40.8740359897,202280,47.7104874446,196330,56.0004895189,849814,107223,-5950
2087,OSI SYSTEMS INC,88.6615515772,129030,65.5146013344,9143,58.1201755714,26428,65.3819015699,113380,-119887,17285
2088,OSIRIS THERAPEUTICS INC NEW,10.3893891976,46971,5.71077456898,55334,5.0970825648,50421,4.95180829428,33927,8363,-4913
2089,OTONOMY INC,27.7507032767,378585,14.9218081504,380986,15.8792270909,383331,18.1909571326,511298,2401,2345
2090,OUTFRONT MEDIA INC,21.8292028533,635479,21.1006345707,496241,24.1704793702,606525,23.6529335701,323258,-139238,110284
2091,OVASCIENCE INC,9.76891728535,356539,9.48203573502,31006,5.226196309,12246,7.17715190813,20203,-325533,-18760
2092,OVERSEAS SHIPHOLDING GROUP I,3.30882352941,21760,1.91208577269,431466,10.9982486865,14275,10.5708891624,130831,409706,-417191
2093,OWENS & MINOR INC NEW,35.9760063598,138370,40.4200036726,691613,37.3798376975,584834,34.7301310562,640107,553243,-106779
2094,OWENS CORNING NEW,47.0300535775,1574355,47.2797840157,2077188,51.5199018833,2315610,53.3901872463,3062117,502833,238422
2095,OWENS ILL INC,17.4180201954,244115,15.9600490812,1387903,18.010531715,892922,18.390057672,1538875,1143788,-494981
2096,OXFORD INDS INC,63.8184245661,14980,67.2414590172,43262,56.6123849861,54776,67.7042891745,86287,28282,11514
2097,P T TELEKOMUNIKASI INDONESIA,44.4003576618,35788,50.8675078864,25360,61.4685757001,34782,66.0854213021,82696,-10428,9422
2098,PACCAR INC,47.3999968925,1029768,54.6898262254,1282926,51.8697747985,1062160,58.7806332928,1875941,253158,-220766
2099,PACIFIC BIOSCIENCES CALIF IN,13.1289080754,179756,8.49356392871,68287,7.03679965817,74892,8.95951406025,184385,-111469,6605
2100,PACIFIC DRILLING SA LUXEMBOU,0.840005697722,4163067,0.489966810553,4177834,7.22117100467,408521,4.06008551497,426592,14767,-3769313
2101,PACIFIC ETHANOL INC,4.77109662381,27457,4.68687938567,37765,5.45398678752,13018,6.9096047395,77139,10308,-24747
2102,PACIFIC MERCANTILE BANCORP,7.12092506696,30614,7.0070223215,65363,7.09417942129,17902,7.40625243627,12827,34749,-47461
2103,PACIRA PHARMACEUTICALS INC,76.7912648442,602256,52.9810805453,726448,33.7305562313,559048,34.2201216279,611044,124192,-167400
2104,PACKAGING CORP AMER,63.0498914899,3192789,60.3996380028,1387856,66.9302352196,943714,81.259293442,877635,-1804933,-444142
2105,PACWEST BANCORP DEL,43.1001436486,4139963,37.1499941326,2496851,39.7799708369,2335145,42.9097648647,2584470,-1643112,-161706
2106,PALO ALTO NETWORKS INC,176.138044952,226419,163.14026869,413264,122.639350399,563669,159.329741959,606453,186845,150405
2107,PAMPA ENERGIA S A,20.5502094282,1321933,21.4399462302,1309285,27.3399171994,1347334,32.3996515943,1347854,-12648,38049
2108,PAN AMERICAN SILVER CORP,6.50104161286,290415,10.8725124174,335617,16.4505032531,1201483,17.6204677187,487558,45202,865866
2109,PANDORA MEDIA INC,13.4100528651,4118030,8.9500348496,4934059,12.450749122,943638,14.3301219734,3475267,816029,-3990421
2110,PANERA BREAD CO,194.779938148,1165695,204.830469498,1204562,211.940221375,1044922,194.720458249,1020581,38867,-159640
2111,PANHANDLE OIL AND GAS INC,16.1845730028,11616,17.3314076214,18002,16.6696222735,16917,17.5302141917,16714,6386,-1085
2112,PAPA JOHNS INTL INC,55.8720275551,241552,54.1884804192,416786,68.0017894193,259302,78.8482542108,204177,175234,-157484
2113,PAR PACIFIC HOLDINGS INC,23.5370568216,90793,18.7653681895,69543,15.3256704981,20880,13.0667638729,35663,-21250,-48663
2114,PARAMOUNT GROUP INC,18.100720917,173529,15.9494591305,189787,15.9408795128,345464,16.3907120273,342206,16258,155677
2115,PAREXEL INTL CORP,68.1196541185,149531,62.731195645,376575,62.878375257,350677,69.4482610306,334796,227044,-25898
2116,PARK NATL CORP,90.4774750472,55605,90.0042148948,30843,91.7611997693,20804,95.9781639929,17952,-24762,-10039
2117,PARKER DRILLING CO,1.82093118554,346526,2.11790210956,239860,2.29125704548,190725,2.16900135563,453665,-106666,-49135
2118,PARKER HANNIFIN CORP,96.9796775528,529513,111.081162461,411816,108.049818646,368617,125.529919262,484036,-117697,-43199
2119,PARKERVISION INC,0.231789291335,655768,3.12218011189,55410,3.14209503142,44238,4.22002328289,13744,-600358,-11172
2120,PARKWAY PPTYS INC,15.6300383656,3647016,15.6599039017,3789870,16.7308166141,836062,17.0097737349,846043,142854,-2953808
2121,PARNELL PHARMACEUT HLDGS LTD,3.8687575677,33861,2.14132762313,15878,1.65289256198,11495,1.37677833869,10895,-17983,-4383
2122,PARSLEY ENERGY INC,18.4497497728,3064215,22.5998709434,2873158,27.0601714147,2269350,33.5101482272,4459843,-191057,-603808
2123,PATRICK INDS INC,43.5154495884,18706,45.4205327746,13364,60.2963058808,15457,61.9214419806,139031,-5342,2093
2124,PATRIOT NATL INC,6.70413441259,84873,7.68251273345,23560,8.17730225449,13085,9.00010975744,18222,-61313,-10475
2125,PATTERN ENERGY GROUP INC,20.9085485383,293325,19.0722941914,179475,22.9710903896,295023,22.4902149472,632853,-113850,115548
2126,PATTERSON COMPANIES INC,45.2092720895,516863,46.5294228018,682192,47.8905298538,564099,45.9404679468,989215,165329,-118093
2127,PATTERSON UTI ENERGY INC,15.0798890257,980047,17.6190790548,863439,21.3205065126,971506,22.3699461175,1017213,-116608,108067
2128,PAYCHEX INC,52.8901221448,3241645,54.0098659589,3131576,59.5000546969,3153745,57.8700924798,3790127,-110069,22169
2129,PAYCOM SOFTWARE INC,37.6577445543,24882,35.5859624945,60951,43.207486829,118822,50.1302920177,427885,36069,57871
2130,PAYLOCITY HLDG CORP,40.5584779509,20341,32.7510917031,33892,43.1964203763,52296,44.4585582725,40937,13551,18404
2131,PAYPAL HLDGS INC,36.1999841622,6111964,38.5998166158,5451943,36.5099837529,4299235,40.9700503079,4884324,-660021,-1152708
2132,PBF ENERGY INC,36.8101726974,2803111,33.2000497913,2104786,23.7801892039,1476397,22.6402815191,1192388,-698325,-628389
2133,PBF LOGISTICS LP,21.3601201854,1080331,18.8403443235,1212929,23.0198279087,1336500,19.819977784,2144402,132598,123571
2134,PDC ENERGY INC,53.3792153252,905802,59.4497397708,1116708,57.6106651816,991188,67.0602661768,1900917,210906,-125520
2135,PDF SOLUTIONS INC,10.8153078203,12020,13.3816245247,88629,13.9820889565,80174,18.1587371675,54354,76609,-8455
2136,PDL BIOPHARMA INC,3.54012901757,2845659,3.33003915285,1245631,3.13969404367,1342806,3.3501957336,1854817,-1600028,97175
2137,PEAK RESORTS INC,6.00650428088,90402,3.38106603023,10056,4.53237410072,13900,5.16795865633,11223,-80346,3844
2138,PEARSON PLC,10.7806441491,44617,12.5393718391,201286,12.9906139814,241636,9.78911783007,252321,156669,40350
2139,PEBBLEBROOK HOTEL TR,28.0199818711,4995328,29.0698617951,5299234,26.2497998618,5040267,26.6000741734,5705548,303906,-258967
2140,PEDEVCO CORP,0.28938461732,79479,0.180857523027,77409,0.281135788586,64026,0.183896772612,65254,-2070,-13383
2141,PEGASYSTEMS INC,27.5010938666,77706,25.3786754978,124711,26.9501625135,110760,29.4846631041,69799,47005,-13951
2142,PEMBINA PIPELINE CORP,21.7596782835,2642824,26.980058771,2513486,30.3400040038,1843243,30.4598267891,1206737,-129338,-670243
2143,PENDRELL CORP,0.50134788612,486688,0.531719666099,212518,0.503372596396,248325,0.6872816718,193516,-274170,35807
2144,PENGROWTH ENERGY CORP,0.732967494966,723088,1.30902024408,666911,1.8407719907,405808,1.59380692168,197640,-56177,-261103
2145,PENN NATL GAMING INC,16.023986557,91051,16.6900717757,179448,13.9507388256,434744,13.5701124302,912299,88397,255296
2146,PENN WEST PETE LTD NEW,0.836799759779,452916,0.92906487727,343356,1.38990912394,1767022,1.81186415422,295276,-109560,1423666
2147,PENNEY J C INC,6.66045797372,1896266,11.059419509,894622,8.87961245104,1746360,9.22149795415,593396,-1001644,851738
2148,PENNSYLVANIA RL ESTATE INVT,21.8731017439,192611,21.8512430655,292020,21.4500560443,372027,23.0294258401,514038,99409,80007
2149,PENNTEX MIDSTREAM PARTNERS L,12.9351113006,75067,10.1466666667,75000,15.5929365408,219779,17.357202006,214954,-67,144779
2150,PENNYMAC FINL SVCS INC,15.3274148266,13179,11.7935654307,10599,12.4983018612,22083,16.9827342202,10599,-2580,11484
2151,PENNYMAC MTG INVT TR,15.2599665232,307078,13.6397659413,366062,16.2295447369,1076740,15.5797602703,1611899,58984,710678
2152,PENSKE AUTOMOTIVE GRP INC,42.3416203691,333171,37.8974350934,255136,31.4596244458,344664,48.1775354035,354273,-78035,89528
2153,PENTAIR PLC,49.5299928005,3332183,54.260317372,575098,58.2898194896,694032,64.2401966789,2775692,-2757085,118934
2154,PEOPLES UNITED FINANCIAL INC,16.149820856,5341793,15.9300719025,3346752,14.6600462419,3297875,15.8200605857,3375714,-1995041,-48877
2155,PEPSICO INC,99.9198424632,5327010,102.479917207,5670028,105.94000654,5345516,108.769979209,4874755,343018,-324512
2156,PEREGRINE PHARMACEUTICALS IN,1.17038419133,58955,0.419227513981,126423,0.363834136644,266605,0.430668716862,313466,67468,140182
2157,PERFICIENT INC,17.1128032028,12739,21.7264658511,29181,20.3196893534,37599,20.1441979458,133289,16442,8418
2158,PERFORMANCE FOOD GROUP CO,23.1151857993,10253,23.3560651567,56602,26.9082641964,58941,24.800132144,302700,46349,2339
2159,PERFORMANCE SPORTS GROUP LTD,9.67283072546,10545,3.18178012225,47772,3.00130982018,115283,4.04977739634,37286,37227,67511
2160,PERFORMANT FINL CORP,1.79543131785,36203,1.70593252743,33999,1.62319696019,54214,2.95687670086,38216,-2204,20215
2161,PERFUMANIA HLDGS INC,2.43558518139,15602,2.50750195256,24327,2.40084953137,21659,2.15132512473,21847,8725,-2668
2162,PERKINELMER INC,53.5693911148,1717828,49.4601930463,1624377,52.4196716895,1603482,56.1105068609,1517951,-93451,-20895
2163,PERNIX THERAPEUTICS HLDGS IN,2.94962286347,115608,1.05141824639,128398,0.446571510423,237364,0.623516077807,325573,12790,108966
2164,PERRIGO CO PLC,144.698598263,372609,127.929761217,1881126,90.6699527014,3072396,92.3297119367,2295155,1508517,1191270
2165,PETMED EXPRESS INC,17.13917116,220139,17.913735971,110753,18.7564282375,53475,20.2832180324,61578,-109386,-57278
2166,PETROBRAS ARGENTINA S A,5.53969282474,140441,6.55148151044,127910,6.27465170979,138175,6.57594572613,100822,-12531,10265
2167,PETROCHINA CO LTD,65.6044707351,33641,66.3028139786,48188,67.9169426337,86061,66.7910857394,91090,14547,37873
2168,PETROLEO BRASILEIRO SA PETRO,4.08559654217,14508530,4.82423238109,23727920,6.35465934698,10499540,8.61569168,22566035,9219390,-13228380
2169,PFIZER INC,32.2799925377,52000043,29.6400070014,105778585,35.210021682,38339113,33.8699891824,33154395,53778542,-67439472
2170,PG&E CORP,53.1899938578,6202990,59.7199872448,7037108,63.9199799236,4929163,61.1700473019,5304230,834118,-2107945
2171,PHARMERICA CORP,35.001102524,185937,22.1114088481,169053,24.659729886,152232,28.0830937088,37211,-16884,-16821
2172,PHH CORP,16.1997723588,1449650,12.540144394,1431084,13.3196783238,1489075,14.4491064945,410406,-18566,57991
2173,PHI INC,16.4157651865,13219,18.9175287192,17497,17.8868917142,22810,18.183786124,18478,4278,5313
2174,PHIBRO ANIMAL HEALTH CORP,30.1261880298,124576,27.0443994763,84010,18.6545098756,93007,27.2075594656,12276,-40566,8997
2175,PHILIP MORRIS INTL INC,87.9096952966,3109384,98.1099150477,4462974,101.719994842,3962977,97.2198798473,4043854,1353590,-499997
2176,PHILLIPS 66,81.8001498145,3974247,86.5898381021,2882001,79.3400423126,2370455,80.5501633295,2836903,-1092246,-511546
2177,PHILLIPS 66 PARTNERS LP,61.3999053711,3656390,62.5899229859,3120726,55.8701362803,3780517,48.6001104905,3057277,-535664,659791
2178,PHOTRONICS INC,12.4518454082,80470,10.4102705843,604211,8.90967447223,1002618,10.3104729283,1294509,523741,398407
2179,PHYSICIANS RLTY TR,16.8600391788,2511560,18.5797442977,2843150,21.0101349362,3108357,21.5401606861,2308850,331590,265207
2180,PICO HLDGS INC,10.328323117,23818,10.2362958002,20906,9.46585530764,22185,11.8029588685,30755,-2912,1279
2181,PIEDMONT NAT GAS INC,57.0207039461,167939,59.8288564695,840581,60.1202286548,1525094,60.0396603073,1356520,672642,684513
2182,PIEDMONT OFFICE REALTY TR IN,18.8798900798,3956326,20.3100466563,4018750,21.5399021196,4666920,21.7699589715,4224629,62424,648170
2183,PIER 1 IMPORTS INC,5.08775360367,271043,7.00585286732,204686,5.14152083633,368179,4.23948414201,1016869,-66357,163493
2184,PILGRIMS PRIDE CORP NEW,22.0899450428,2390771,25.4000125263,2714290,25.4799948046,2625393,21.1200562307,6020912,323519,-88897
2185,PIMCO ETF TR,96.9413926907,317759,100.644018586,178411,100.61273479,154553,101.413344127,118584,-139348,-23858
2186,PINGTAN MARINE ENTERPRISE LT,1.38606141985,23087,1.27498980008,19608,1.07126460236,19603,1.07213968448,19587,-3479,-5
2187,PINNACLE FINL PARTNERS INC,51.3600540259,1270501,49.059576334,1288515,48.8495093461,1278498,54.0800520181,1267251,18014,-10017
2188,PINNACLE FOODS INC DEL,42.459958498,936341,44.6797543867,2448402,46.289966221,2776282,50.1701660593,2298637,1512061,327880
2189,PINNACLE WEST CAP CORP,64.4804628312,1633425,75.0698277348,2917537,81.0601367353,3158951,75.9897874543,3215261,1284112,241414
2190,PIONEER ENERGY SVCS CORP,2.17166416604,399233,2.20033134401,424936,4.60081702302,370369,4.03867297145,317431,25703,-54567
2191,PIONEER NAT RES CO,125.380246782,2003633,140.739940929,2222745,151.210051161,1947397,185.650422538,1442593,219112,-275348
2192,PIPER JAFFRAY COS,40.4117687974,43131,49.5699233967,76498,37.7000638656,206684,48.298963216,272863,33367,130186
2193,PITNEY BOWES INC,20.6501951102,1006867,21.5397405514,555717,17.8002708063,419488,18.1600278302,497301,-451150,-136229
2194,PJT PARTNERS INC,28.2810322457,41618,24.0544894801,62691,22.9911906033,29968,27.2585089745,13427,21073,-32723
2195,PLAINS ALL AMERN PIPELINE L,23.0999568599,9837724,20.9700391186,15516900,27.4899679261,16974556,31.41006737,22112369,5679176,1457656
2196,PLAINS GP HLDGS L P,9.44984101735,594719,8.68998769185,3971352,10.4299354858,5340685,12.9400579425,7799115,3376633,1369333
2197,PLANET FITNESS INC,15.6424910151,33946,16.2294081757,8195,18.885580604,58775,20.0768156425,28640,-25751,50580
2198,PLANET PAYMENT INC,3.0649327904,22839,3.53237843412,97951,4.49738932035,91164,3.70876953022,38018,75112,-6787
2199,PLANTRONICS INC NEW,47.4217479489,218908,39.1896105043,362443,43.9977119751,277969,51.962042805,285901,143535,-84474
2200,PLATFORM SPECIALTY PRODS COR,12.8300241165,7989151,8.59947376355,1340082,8.88095492214,580906,8.10992096589,624667,-6649069,-759176
2201,PLEXUS CORP,34.9202431163,1118148,39.5197246397,1121440,43.2003063819,866892,46.7803011578,1011430,3292,-254548
2202,PLUG POWER INC,2.11336615544,84699,2.04216993647,57292,1.86099618904,134874,1.71094101756,188785,-27407,77582
2203,PLY GEM HLDGS INC,12.5304559694,17238,14.0651686146,29861,14.5689371504,121560,13.3576776533,157737,12623,91699
2204,PNC FINL SVCS GROUP INC,95.3098196937,2003036,84.5701089986,2315901,81.3901391166,2394897,89.3515273877,2536946,312865,78996
2205,PNM RES INC,30.5700775289,2371502,33.7197868582,2650254,35.4396555544,2663062,32.7198768874,2626538,278752,12808
2206,POLARIS INDS INC,85.9495192747,273649,98.4794047799,310339,81.7609922442,447793,77.441241231,390580,36690,137454
2207,POLYONE CORP,31.7595880383,1426152,30.2495875971,1193008,35.2399385971,1333487,33.8097638854,1190100,-233144,140479
2208,POOL CORPORATION,80.7828440558,91257,87.7404058812,339114,94.0287466793,370408,94.517577392,143878,247857,31294
2209,POPEYES LA KITCHEN INC,58.5106382979,39104,52.0604638252,39627,54.6366449685,56226,53.1352192272,157485,523,16599
2210,POPULAR INC,28.3385481405,279972,28.6110703633,327216,29.299887217,337817,38.2188935461,671605,47244,10601
2211,PORTLAND GEN ELEC CO,36.3701382123,2100102,39.4901484805,2557372,44.1200047936,2469968,42.5900778467,2382245,457270,-87404
2212,PORTOLA PHARMACEUTICALS INC,51.4517538015,67539,20.4011341973,124846,23.5966882943,127306,22.7096690129,828854,57307,2460
2213,POSCO,35.3628926508,118203,47.333617142,176175,44.4969621974,197182,51.0818285342,215145,57972,21007
2214,POST HLDGS INC,61.6997605415,784687,68.7703554398,539782,82.6909162706,800233,77.1702218103,1474999,-244905,260451
2215,POST PPTYS INC,59.1597593104,1380533,59.7402269199,2057642,61.0497188253,2240600,66.1297756735,2521058,677109,182958
2216,POTASH CORP SASK INC,17.1198695528,3019766,17.019513482,1880136,16.2400916624,1727207,16.3191881347,806045,-1139630,-152929
2217,POTBELLY CORP,11.6853505605,10526,13.5925399083,18981,12.5456656566,70622,12.4402737721,46462,8455,51641
2218,POTLATCH CORP NEW,30.2350531552,51265,31.5018582942,218749,34.0991290761,138244,38.8888378376,108823,167484,-80505
2219,POWELL INDS INC,26.048714479,11824,29.7740173503,9337,39.3474088292,15630,40.0796906129,25599,-2487,6293
2220,POWER INTEGRATIONS INC,48.6241648737,88310,49.6650947647,133172,50.0689148213,108830,63.0282039487,110871,44862,-24342
2221,POWERSHARES DB CMDTY IDX TRA,13.3599712159,316842,13.2704217045,13564,15.3491188166,61111,15.0118113236,78738,-303278,47547
2222,POWERSHARES DB G10 CURCY HAR,23.3434394771,57061,23.3630922792,50293,24.1915515278,40386,24.9178154093,36199,-6768,-9907
2223,POWERSHARES ETF TR II,37.2890944439,1894924,35.0873755773,2909337,36.0895353912,2845534,31.1440325317,1856407,1014413,-63803
2224,POWERSHARES ETF TRUST,29.8796157599,3201748,32.8576365239,3194752,35.6205301345,2081019,35.501352733,1426002,-6996,-1113733
2225,POWERSHARES ETF TRUST II,22.5889929855,8411309,23.4686992232,3940653,23.3477028594,11973255,23.3031686016,9388337,-4470656,8032602
2226,POWERSHARES GLOBAL ETF FD,20.5074185306,44618,20.2623717366,23097,20.7072744386,22311,21.0354519902,22058,-21521,-786
2227,POWERSHARES QQQ TRUST,111.860012204,9065876,109.200117615,9376391,107.540052856,6581678,118.720091738,10809931,310515,-2794713
2228,POWERSHS DB MULTI SECT COMM,32.404566098,8147,14.0855755614,39544,28.8394232115,21429,23.2005324712,42068,31397,-18115
2229,POWERSHS DB US DOLLAR INDEX,25.6522728011,123108,24.5406495484,762653,24.8398988094,696903,24.6800420953,382941,639545,-65750
2230,PPG INDS INC,98.8188836946,677664,111.490446261,889861,104.14987826,1157793,103.359514126,674413,212197,267932
2231,PPL CORP,34.1300766843,2916372,38.0698940554,5076426,37.7500651827,5741553,34.5700093568,2894156,2160054,665127
2232,PRA GROUP INC,34.6859997801,163726,29.393992554,51303,24.1322157503,105585,34.5403031331,218122,-112423,54282
2233,PRA HEALTH SCIENCES INC,45.2687557685,22753,42.7583123859,272906,41.7596196865,657142,56.5093441111,935509,250153,384236
2234,PRAXAIR INC,102.400366251,886823,114.450265676,1559044,112.390616572,839821,120.829829659,836027,672221,-719223
2235,PRECISION DRILLING CORP,3.94031052715,208613,4.20119074961,283015,5.30095895543,501796,4.18031263692,586559,74402,218781
2236,PREMIER INC,35.2708333333,144000,33.3585771811,299743,32.6985669686,286037,32.3396912176,654830,155743,-13706
2237,PRESS GANEY HLDGS INC,31.5499507216,1955217,30.0802988084,2015472,39.3492423479,526033,40.40067423,207051,60255,-1489439
2238,PRESTIGE BRANDS HLDGS INC,51.4798353797,875469,53.3894691323,832505,55.3998291061,959660,48.269464661,1181513,-42964,127155
2239,PRETIUM RES INC,5.03059951278,50491,5.34100246508,12170,11.2009956441,77136,10.2868298543,13318,-38321,64966
2240,PRGX GLOBAL INC,3.71811500216,34695,4.72093200335,39399,5.2212647875,54776,4.71161992933,48391,4704,15377
2241,PRICE T ROWE GROUP INC,71.489508785,1001028,73.4594814415,1234422,72.9690269062,903397,66.4999111658,1001866,233394,-331025
2242,PRICELINE GRP INC,1274.94601581,470045,1288.95689964,287863,1248.4091708,304401,1471.49174472,369279,-182182,16538
2243,PRICESMART INC,82.9839990011,56059,84.5799320392,51206,93.5543045101,47427,83.7693466648,73010,-4853,-3779
2244,PRIMERICA INC,47.2299510443,113572,44.532094917,94314,57.2393120988,66056,53.027689799,191334,-19258,-28258
2245,PRIMERO MNG CORP,2.28046631793,547695,1.81140717242,213094,2.08240120093,239147,1.66110522124,204683,-334601,26053
2246,PRIMORIS SVCS CORP,22.0215352553,14395,24.302430243,51106,18.916617203,38749,20.5951257037,28599,36711,-12357
2247,PRINCIPAL FINL GROUP INC,44.9798861293,3782713,39.4497796646,1908908,41.1103495256,1899546,51.5094769813,1070172,-1873805,-9362
2248,PRIVATEBANCORP INC,41.0202409785,2801495,38.6001462442,2982683,44.0300289439,3279103,45.9200602465,3800387,181188,296420
2249,PROASSURANCE CORP,48.5303588419,858679,50.5997352612,982100,53.5494158284,950748,52.4798599024,934206,123421,-31352
2250,PROFIRE ENERGY INC,1.00081017967,20983,0.976860614201,32758,1.10669202836,28915,1.22914837577,28475,11775,-3843
2251,PROGENICS PHARMACEUTICALS IN,6.12581643176,145450,4.37211561817,20585,4.2252967534,50884,6.32963891707,940338,-124865,30299
2252,PROGRESS SOFTWARE CORP,23.9965057873,228950,24.1258084427,37263,27.4644433546,79521,27.1999682539,403199,-191687,42258
2253,PROGRESSIVE CORP OHIO,31.7998354225,3425741,35.1399609352,3756834,33.4999466837,3751200,31.4998065701,4391773,331093,-5634
2254,PROLOGIS INC,42.9199623687,9688755,44.1801083594,5457026,49.0400669575,4650116,53.5400189043,4601063,-4231729,-806910
2255,PROOFPOINT INC,65.0216738913,26991,53.761682243,42800,63.0860033727,59300,74.8493192891,467379,15809,16500
2256,PROS HOLDINGS INC,23.0404635433,870512,11.7888420162,389945,17.4312929834,338357,22.6106241639,480659,-480567,-51588
2257,PROSHARES TR,43.9912166108,2261997,50.9405934491,1297904,57.3314813249,1844484,55.5723294185,2023651,-964093,546580
2258,PROSHARES TR II,36.3748541837,593212,32.9540884501,770830,31.9121968433,493103,20.275456515,323100,177618,-277727
2259,PROSPECT CAPITAL CORPORATION,6.98088485145,319014,7.26713346064,169668,7.81952304666,372657,8.09943331968,285699,-149346,202989
2260,PROSPERITY BANCSHARES INC,47.8604316603,1532038,46.3900515281,1893919,50.9902310011,1957826,54.8897082082,1754573,361881,63907
2261,PROTALIX BIOTHERAPEUTICS INC,1.02644058988,76965,0.838677849038,40540,0.641341884558,40540,0.567340897879,40540,-36425,0
2262,PROTHENA CORP PLC,68.1098568282,58112,41.148526838,75993,34.9626515948,70418,59.9636994094,73828,17881,-5575
2263,PROTO LABS INC,63.6765764839,9721,77.0798369696,16684,57.553488977,15377,59.9134290541,18944,6963,-1307
2264,PROVECTUS BIOPHARMACEUTICALS,0.391116002309,370734,0.38219132642,138674,0.371424412622,199233,0.0980264017775,153020,-232060,60559
2265,PROVIDENT FINL SVCS INC,20.1495010746,1755974,20.1897897898,1873125,19.6401567492,1870759,21.2298829639,2036893,117151,-2366
2266,PRUDENTIAL FINL INC,81.4101259547,6309252,72.2199707863,5014084,71.3398050659,2403581,81.6499161605,3067768,-1295168,-2610503
2267,PRUDENTIAL PLC,45.0796473444,386893,37.1987805741,381491,34.0093653609,375426,35.7097935539,421369,-5402,-6065
2268,PS BUSINESS PKS INC CALIF,87.4301249544,1264221,100.50964777,1238110,106.080803316,741925,113.56880013,545951,-26111,-496185
2269,PTC INC,34.6303889921,1925592,33.1602872881,2360836,37.580055699,2474371,44.309958001,2923880,435244,113535
2270,PTC THERAPEUTICS INC,32.4008950715,231043,6.42733970842,12758,7.02664329282,69023,14.0107888422,149599,-218285,56265
2271,PUBLIC STORAGE,247.699383397,1234343,275.828859326,1113096,255.588990567,1133210,223.139971341,1118679,-121247,20114
2272,PUBLIC SVC ENTERPRISE GROUP,38.6900048751,3864564,47.1400928495,4675956,46.6098633183,4304089,41.8700357511,4209096,811392,-371867
2273,PULTE GROUP INC,17.8199883543,2157016,18.709729114,3282303,19.4896401508,2624266,20.0399905686,3019712,1125287,-658037
2274,PUMA BIOTECHNOLOGY INC,78.3975909562,202570,29.3720422079,91073,29.7931529591,133722,67.049956269,155496,-111497,42649
2275,PURE STORAGE INC,15.570230822,1674927,13.6897444293,1456857,10.8998090238,1404887,13.5522448195,109207,-218070,-51970
2276,PURECYCLE CORP,4.76484602488,11333,4.52912697173,19209,4.70848997686,163322,5.73333333333,52500,7876,144113
2277,PVH CORP,73.6501029555,4246009,99.0601237263,4069791,94.2300594489,2354461,110.500383343,1865170,-176218,-1715330
2278,PZENA INVESTMENT MGMT INC,8.58732908267,27133,7.57726819541,10030,7.62119503946,22175,7.69498472604,25861,-17103,12145
2279,QAD INC,20.5272347856,23481,21.2605359165,23847,19.2813321648,20538,22.3886358373,12953,366,-3309
2280,QEP RES INC,13.4006506904,1209792,14.1103587849,2022911,17.6305056832,1542270,19.5302974585,2292387,813119,-480641
2281,QIAGEN NV,27.6503842554,899662,22.3393740613,1448832,21.8097455729,1169844,27.4399852078,1719826,549170,-278988
2282,QIWI PLC,17.9425204213,56681,14.4896154748,55419,13.097143157,152476,14.6413598102,61538,-1262,97057
2283,QLT INC,2.66071994276,561878,1.9894075944,525282,1.41987056717,498637,2.05914786967,498750,-36596,-26645
2284,QORVO INC,50.899960293,3891005,50.4099995533,2551954,55.2600196551,2192815,55.739733874,1759768,-1339051,-359139
2285,QTS RLTY TR INC,45.1144305879,72970,47.3778220257,102453,55.9878456895,48707,52.8498643695,184693,29483,-53746
2286,QUAD / GRAPHICS INC,9.30118923085,290608,12.9422919598,292143,23.2877782568,345589,26.7203124943,272901,1535,53446
2287,QUAKER CHEM CORP,77.2605269111,327114,84.85988928,274747,89.2027863777,279072,105.931067168,320718,-52367,4325
2288,QUALCOMM INC,49.9849475648,12243866,51.140055203,12480843,53.569818843,11170917,68.4999847111,9647535,236977,-1309926
2289,QUALITY SYS INC,16.1203343477,363454,15.2392652393,102564,11.9062000832,74499,11.3204327679,187537,-260890,-28065
2290,QUALYS INC,33.085054358,53166,25.3203883495,25750,29.8050853667,54588,38.1901594868,106153,-27416,28838
2291,QUANTA SVCS INC,20.2502428631,1730399,22.5599991072,1612899,23.1196262304,2103970,27.9899876241,1719472,-117500,491071
2292,QUANTUM CORP,0.932999008689,154341,0.610834039984,139154,0.422154677474,59220,0.736012229126,70651,-15187,-79934
2293,QUEST DIAGNOSTICS INC,71.1396554302,1665091,71.4496590926,1934103,81.4102423598,1779297,84.630386349,1937212,269012,-154806
2294,QUICKLOGIC CORP,1.12657388999,15090,1.04964188689,32392,0.985589994562,29424,0.766129032258,24800,17302,-2968
2295,QUINSTREET INC,4.28952118972,116330,3.41797856726,149211,3.5495619128,151568,3.01543599616,144921,32881,2357
2296,QUINTILES TRANSNATIO HLDGS I,68.6604749622,1325537,65.0995470552,1696233,65.3202224744,1414095,81.0599075807,2727785,370696,-282138
2297,QUNAR CAYMAN IS LTD,52.7402279495,320685,39.6984484657,217011,29.7894840237,478491,29.0014556225,315329,-103674,261480
2298,RACKSPACE HOSTING INC,25.3199551572,2821411,21.5901397268,2993913,20.8598602564,2448770,31.6899296494,1833958,172502,-545143
2299,RADIAN GROUP INC,13.3899884145,4248398,12.4001202857,4545843,10.4201265847,5015774,13.5500096134,5575568,297445,469931
2300,RADIANT LOGISTICS INC,3.46792172405,12111,3.56757653696,12053,2.99188340542,33758,2.83823699279,60601,-58,21705
2301,RADIO ONE INC,1.73215162101,34639,1.42252109534,30931,3.18938317672,175269,3.03318794695,45167,-3708,144338
2302,RADIUS HEALTH INC,61.5389587455,433189,31.4409808971,416272,36.7501293147,404053,54.0909048891,432716,-16917,-12219
2303,RADNET INC,6.1867629052,31034,4.82618967263,59260,5.34103605199,73394,7.39446428119,78978,28226,14134
2304,RADWARE LTD,15.3401686504,1705066,11.8301892923,1723472,11.2598661447,1653128,13.7398874176,869585,18406,-70344
2305,RAIT FINANCIAL TRUST,2.70941093996,52779,3.13551544815,65380,3.13375301589,108177,3.38497749415,82423,12601,42797
2306,RALPH LAUREN CORP,111.479869423,3381920,96.2569727875,315333,89.6187205372,365716,101.14022347,437195,-3066587,50383
2307,RAMBUS INC DEL,11.6002323795,53361,13.7540545807,174494,12.08092766,82444,12.5019819248,252280,121133,-92050
2308,RAMCO-GERSHENSON PPTYS TR,16.6102395371,188739,18.0310638795,171260,19.6074514309,100115,18.7426345539,141709,-17479,-71145
2309,RAND LOGISTICS INC,1.58784520066,32119,0.950415373142,576590,1.03961131267,47133,0.749146805028,36041,544471,-529457
2310,RANDGOLD RES LTD,61.9292373894,83660,90.8092786681,178517,112.037053343,283915,100.073851233,184154,94857,105398
2311,RANGE RES CORP,24.6094466463,376197,32.3800250417,815441,43.1397766872,671793,38.7503595127,2350404,439244,-143648
2312,RAPID7 INC,15.1252665245,30016,13.0310603356,11204,12.5846105967,51412,17.7321511899,4286,-18812,40208
2313,RAPTOR PHARMACEUTICAL CORP,5.19990686059,2654086,4.60003051118,2654765,5.36989481384,2753499,8.97106036112,395271,679,98734
2314,RAVEN INDS INC,15.625875105,17855,16.0238291951,45994,18.9452848862,63657,23.0303592551,86234,28139,17663
2315,RAYMOND JAMES FINANCIAL INC,57.9700019649,4580300,47.6099156844,3936995,49.3001875769,2416076,58.2100098672,2049218,-643305,-1520919
2316,RAYONIER ADVANCED MATLS INC,9.7910139324,120008,9.50057358905,742692,13.5879639609,231970,14.1687172377,240177,622684,-510722
2317,RAYONIER INC,22.1966316396,138940,24.6782597778,159290,26.2388505768,215482,26.5408742182,220151,20350,56192
2318,RAYTHEON CO,124.529832733,988478,122.629122709,1134812,135.949974618,1083450,136.130092002,1884205,146334,-51362
2319,RBC BEARINGS INC,64.5891566786,577775,73.2598070389,605407,72.4987111869,504340,76.4795862257,300067,27632,-101067
2320,RE MAX HLDGS INC,37.2959374833,93415,34.3025155178,202026,40.2588433895,156388,43.7876172258,85732,108611,-45638
2321,REALITY SHS ETF TR,23.3064296726,33081,23.0804111245,66160,23.5792019347,66160,24.2140266022,66160,33079,0
2322,REALOGY HLDGS CORP,36.6680567783,388458,36.1109946034,572208,29.0196525685,666376,25.8597520937,1015787,183750,94168
2323,REALPAGE INC,22.4499907103,64588,20.8398678942,216796,22.32585501,210787,25.7008030999,373179,152208,-6009
2324,REALTY INCOME CORP,51.6308525277,533402,62.5096480584,511761,69.3602812332,737324,66.9300696661,980247,-21641,225563
2325,RECON TECHNOLOGY LTD,1.4009526478,10707,1.30755580461,10707,1.12076211824,10707,1.12076211824,10707,0,0
2326,RED HAT INC,82.810736417,860287,74.5107179742,776546,72.6013094313,793016,80.8297593204,1699770,-83741,16470
2327,RED ROBIN GOURMET BURGERS IN,61.7398244214,31325,64.4885852957,22252,47.4357785403,21566,44.9453295006,74446,-9073,-686
2328,REDWOOD TR INC,13.1990097097,274263,13.0771173642,194003,13.8091783832,187484,14.1588529583,217673,-80260,-6519
2329,REGAL BELOIT CORP,58.5229193283,174547,63.0867063692,99070,55.0528718247,148094,59.4890320183,344366,-75477,49024
2330,REGAL ENTMT GROUP,18.8705282839,594207,21.1415685864,630606,22.0397405448,544834,21.7505882906,510377,36399,-85772
2331,REGENCY CTRS CORP,68.1197074869,979922,74.8499441366,851183,83.7298447011,898461,77.4896942459,898042,-128739,47278
2332,REGENERON PHARMACEUTICALS,542.871058924,835622,360.440205192,743108,349.230348748,914700,402.018769276,909465,-92514,171592
2333,REGIONAL MGMT CORP,15.4687248754,31095,17.1121436319,61769,14.6597690852,138406,21.6572328223,106708,30674,76637
2334,REGIONS FINL CORP NEW,9.59984688746,5047268,7.85003286196,7546720,8.50994448791,15259559,9.87001395111,16836653,2499452,7712839
2335,REGIS CORP MINN,14.1499649422,583323,15.1895208901,524243,12.4499666605,520403,12.549906,744149,-59080,-3840
2336,REGULUS THERAPEUTICS INC,8.71943738645,745805,6.9296058496,774070,2.89020317678,776762,3.30060485855,396291,28265,2692
2337,REINSURANCE GROUP AMER INC,85.5495976088,1196721,96.2497307372,1267349,96.9904177745,1215584,107.940450242,1381836,70628,-51765
2338,RELIANCE STEEL & ALUMINUM CO,57.9090750448,618884,69.1895180613,742916,76.9000252097,2038894,72.0299381384,2067196,124032,1295978
2339,RELX NV,16.8319035633,233604,17.5314494819,294043,17.4083555314,250397,17.8610796013,249481,60439,-43646
2340,RELX PLC,17.8296496679,253959,18.7904626559,373647,18.6981066553,348431,19.1600895276,339560,119688,-25216
2341,RENAISSANCERE HOLDINGS LTD,113.190506196,285660,119.830908775,552128,117.439102155,392050,120.162901879,197665,266468,-160078
2342,RENASANT CORP,34.4101602356,865413,32.9097776333,1199370,32.3303047476,1422226,33.6302006295,1505611,333957,222856
2343,RENESOLA LTD,1.67670147092,13121,1.4474527205,42143,1.24122907009,39477,1.01559961001,24616,29022,-2666
2344,RENEWABLE ENERGY GROUP INC,9.29932787036,21722,9.43998226446,667586,8.83246413458,113898,8.46807374953,179852,645864,-553688
2345,RENREN INC,3.68421052632,19000,3.27666151468,16175,1.78540821573,70012,2.05710061311,124447,-2825,53837
2346,RENT A CTR INC NEW,14.9693568859,293867,15.847322664,191515,12.2791743752,275670,12.6416727418,366249,-102352,84155
2347,RENTECH INC,3.52008768602,189768,2.20825547817,23548,2.39504085658,49686,2.91734595065,81581,-166220,26138
2348,REPLIGEN CORP,28.2899007057,144822,26.8177561577,318222,27.3597811218,353073,30.1893960283,163203,173400,34851
2349,REPROS THERAPEUTICS INC,1.20748289399,171431,0.964168010658,57044,1.60071712127,15618,2.09287115762,15290,-114387,-41426
2350,REPUBLIC SVCS INC,43.9901223224,2228864,47.6498671956,2974300,51.3100718984,2823013,50.4498135691,2908316,745436,-151287
2351,RESMED INC,53.6903204736,1188054,57.8208698997,1123072,63.2302097865,1206417,64.7902068004,1157783,-64982,83345
2352,RESOLUTE ENERGY CORP,0.875028863799,82283,0.507931068246,163408,2.97145726961,95576,26.0524682481,66059,81125,-67832
2353,RESOLUTE FST PRODS INC,7.57207179315,113047,5.50416281221,43240,5.28880291864,40841,4.7296362882,36155,-69807,-2399
2354,RESOURCE CAP CORP,12.7524523947,17330,11.2525318197,39991,12.8353376503,17296,12.8021552593,94281,22661,-22695
2355,RESOURCES CONNECTION INC,16.3394707962,41005,15.5479605558,35696,14.7911152802,59698,14.9426034926,61502,-5309,24002
2356,RESTAURANT BRANDS INTL INC,37.3605475033,463778,38.8285242867,496980,41.5996944008,340315,44.576406214,190796,33202,-156665
2357,RESTORATION HARDWARE HLDGS I,79.4501157079,2640701,41.899844288,2155903,28.6805191717,723383,34.5807845271,498109,-484798,-1432520
2358,RETAIL OPPORTUNITY INVTS COR,17.8997561305,229221,20.1203141708,259986,21.6686650042,219349,21.9606946376,376081,30765,-40637
2359,RETAIL PPTYS AMER INC,14.770077186,3837353,15.8500237233,4261634,16.9000492722,4895252,16.7999248915,4995439,424281,633618
2360,RETAILMENOT INC,9.93641512134,48911,8.01980365893,58979,7.71187996747,190615,9.89273249846,155872,10068,131636
2361,RETROPHIN INC,19.2894025553,520182,13.6595710014,822427,17.8101851852,864000,22.3790255406,540238,302245,41573
2362,REVANCE THERAPEUTICS INC,34.1580490523,315826,17.4600741195,300056,13.5989783127,425179,16.2114537445,425625,-15770,125123
2363,REX AMERICAN RESOURCES CORP,54.0690814901,73739,55.468946442,59655,59.8154514203,27635,84.7608701707,35901,-14084,-32020
2364,REX ENERGY CORPORATION,1.04997088113,827642,0.768181949165,1318698,0.660268858258,745151,0.582674183164,343245,491056,-573547
2365,REXAHN PHARMACEUTICALS INC,0.369959304477,40545,0.32852185697,48703,0.248257028777,48337,0.221975582686,40545,8158,-366
2366,REXFORD INDL RLTY INC,16.3612693885,305722,18.1634847478,224131,21.0863686871,155693,22.8927770054,145286,-81591,-68438
2367,REXNORD CORP NEW,18.1087597107,37330,20.248396021,16989,19.6303671203,1273588,21.4099727522,1339189,-20341,1256599
2368,REYNOLDS AMERICAN INC,46.14989233,4824930,50.3099220708,3527177,53.9297754933,6005254,47.1500947254,6415915,-1297753,2478077
2369,RICE ENERGY INC,10.9000635529,6745557,13.960036347,6104497,22.0400090094,5123546,26.1100066075,6828608,-641060,-980951
2370,RICE MIDSTREAM PARTNERS LP,13.4901385428,2639113,14.8899800852,3601348,20.4300676392,4070569,24.2600359422,5642943,962235,469221
2371,RICEBRAN TECHNOLOGIES,1.91759807144,18252,1.12504018001,18666,1.67889565974,16082,1.32584620184,12822,414,-2584
2372,RIGEL PHARMACEUTICALS INC,3.03249827316,59357,2.0757020757,81900,2.2314544366,110242,3.67005374149,1768094,22543,28342
2373,RIGNET INC,20.6748411349,11173,13.6771875802,38970,13.390418803,56757,15.115021628,40688,27797,17787
2374,RING ENERGY INC,7.0371379279,44052,5.03605697598,33558,8.82326990383,34001,10.9296253567,32938,-10494,443
2375,RINGCENTRAL INC,23.5754951097,123306,15.7517009973,289683,19.7216552236,269450,23.6594449058,317928,166377,-20233
2376,RIO TINTO PLC,29.1204506368,1723428,28.2700295408,2034133,31.2998944773,1414861,33.3995264961,1451308,310705,-619272
2377,RITCHIE BROS AUCTIONEERS,24.1117447772,400842,27.0808649802,288654,33.7782185196,244033,35.0755647214,62066,-112188,-44621
2378,RITE AID CORP,7.84004722196,12241763,8.14995277206,16480709,7.48997067513,17612352,7.68994645765,6401475,4238946,1131643
2379,RLI CORP,61.7501587161,677310,66.8607559722,819554,68.780358154,778827,68.3594471808,784705,142244,-40727
2380,RLJ LODGING TR,21.6300967339,11537119,22.8799937463,11078281,21.4500222259,12163717,21.0299518965,12589520,-458838,1085436
2381,RMG NETWORKS HLDG CORP,0.74956275506,24014,1.17695220551,19542,0.981123189828,25481,0.87597356845,52513,-4472,5939
2382,RMR GROUP INC,14.4449332747,13638,25.0104536902,76528,30.9685149988,96808,37.9371665679,60732,62890,20280
2383,ROBERT HALF INTL INC,47.1396668583,1022748,46.578997851,927886,38.1601171039,976910,37.8604726128,645264,-94862,49024
2384,ROCKET FUEL INC,3.49140612667,107693,3.14957695031,53658,2.22190287742,90463,2.63890994542,422144,-54035,36805
2385,ROCKWELL AUTOMATION INC,102.610256019,1258344,113.750238171,955198,114.818945308,659055,122.339852669,557112,-303146,-296143
2386,ROCKWELL COLLINS INC,92.3002133073,641797,92.2104807181,637151,85.1400392147,694127,84.3400435684,952525,-4646,56976
2387,ROFIN SINAR TECHNOLOGIES INC,26.7703227987,29585,32.2252639812,102280,31.9387023869,90705,32.1804061314,73523,72695,-11575
2388,ROGERS COMMUNICATIONS INC,34.4597084365,1196789,40.0201498084,1703242,40.3995675976,1729870,42.4210540062,536031,506453,26628
2389,ROGERS CORP,51.6017042765,12674,59.9242593005,4489,61.0926812083,34063,61.0799645913,125393,-8185,29574
2390,ROKA BIOSCIENCE INC,1.22199592668,24550,0.711035267349,21096,0.567268601683,10577,0.685602350637,10210,-3454,-10519
2391,ROLLINS INC,25.9003661287,486441,27.1206436889,1125637,29.2696805565,850573,29.280564743,846261,639196,-275064
2392,ROPER TECHNOLOGIES INC,189.789788197,377191,182.770351718,671958,170.559135872,1000222,182.469473435,1207391,294767,328264
2393,ROSS STORES INC,53.8104234246,1204748,57.8999230121,4918953,56.6900001642,5481390,64.2999792216,6266114,3714205,562437
2394,ROWAN COMPANIES PLC,16.9499931104,3548851,16.1000872778,1835518,17.6597191551,1854333,15.1601714012,2672793,-1713333,18815
2395,ROYAL BANCSHARES PA INC,2.08877740974,114421,2.13374494938,132162,2.26189020663,98148,2.35935053514,93246,17741,-34014
2396,ROYAL BK CDA MONTREAL QUE,53.5804243505,958783,57.5600993146,2342456,59.0897501826,2314090,61.9592696145,1015409,1383673,-28366
2397,ROYAL BK SCOTLAND GROUP PLC,10.7802122213,354724,15.4193435439,376994,16.4259858556,1147024,12.7903207473,1187695,22270,770030
2398,ROYAL CARIBBEAN CRUISES LTD,101.211582177,845506,82.149321149,766884,67.1506101553,507084,74.9504858094,578622,-78622,-259800
2399,ROYAL DUTCH SHELL PLC,45.8463077934,1554978,48.6258013495,1485775,55.4697965738,1578066,50.8402309682,1953689,-69203,92291
2400,ROYAL GOLD INC,36.4733745893,130890,51.2894969365,482126,72.0206638896,884635,77.429379606,788370,351236,402509
2401,RPC INC,11.9573749691,92997,14.1804033992,156272,15.5298787318,164264,16.8007979089,116304,63275,7992
2402,RPM INTL INC,44.0597160356,1724160,47.3299876889,3106128,49.9498927226,3596284,53.7199243206,3721487,1381968,490156
2403,RPX CORP,11.0062254978,123203,11.2578965885,196129,9.16912746472,180497,10.6886721473,289746,72926,-15632
2404,RSP PERMIAN INC,24.3898451558,2630193,29.0400196415,2647450,34.8903255478,2470083,38.7801547565,2987920,17257,-177367
2405,RTI SURGICAL INC,3.95842232664,35115,4.00811945228,58132,3.59889568133,40568,3.1236764083,37776,23017,-17564
2406,RUBICON PROJ INC,16.4215524632,15163,18.2894736842,30400,13.6550275329,62834,8.2780607884,233992,15237,32434
2407,RUBICON TECHNOLOGY INC,1.13378684807,52038,0.738825267824,51433,0.677680501117,54598,0.630430071514,50759,-605,3165
2408,RUBY TUESDAY INC,5.50811056648,39578,5.39732084796,15378,3.61528614101,84364,2.50257618136,190204,-24200,68986
2409,RUDOLPH TECHNOLOGIES INC,14.2160509133,24198,13.65089422,34723,15.5258942872,46825,17.7460197041,97543,10525,12102
2410,RUTHS HOSPITALITY GROUP INC,15.9351235367,31691,18.4248145039,44071,15.9532197037,84309,14.1167316617,107957,12380,40238
2411,RYANAIR HLDGS PLC,86.4696472173,59385,85.8216584074,102713,69.5427538104,77420,75.0345099586,101420,43328,-25293
2412,RYDER SYS INC,56.8306683181,357659,64.7805193822,383109,61.140981775,429630,65.9501670273,370598,25450,46521
2413,RYDEX ETF TRUST,61.6820314087,901089,75.5473254208,2070980,69.9954621667,2029603,78.608297846,1226728,1169891,-41377
2414,RYERSON HLDG CORP,4.66094270194,28535,5.5729492799,31940,17.4926487948,46591,11.2829736211,83400,3405,14651
2415,RYMAN HOSPITALITY PPTYS INC,51.633310329,86940,51.4768111036,94528,50.6533247854,151303,48.1565441894,127044,7588,56775
2416,S & T BANCORP INC,30.8187387833,48477,25.7585720996,53225,24.4420023495,52778,28.9940529339,59357,4748,-447
2417,SABRA HEALTH CARE REIT INC,20.2335252719,125040,20.0894565895,91441,20.6372902584,178851,25.1807590853,243003,-33599,87410
2418,SABRE CORP,27.9700395603,7870779,28.9200149258,6887410,26.7900989766,6899004,28.1796675235,2195945,-983369,11594
2419,SAFE BULKERS INC,0.812151163795,115742,0.799250595141,116359,1.05146494643,175945,1.41206675225,179170,617,59586
2420,SAFETY INS GROUP INC,56.3627841575,25602,57.0647740251,24516,61.5715052801,16761,67.2002416188,19866,-1086,-7755
2421,SAGE THERAPEUTICS INC,58.2871110275,31911,32.0583934244,79324,30.1275578544,145581,46.0479003467,311480,47413,66257
2422,SALEM MEDIA GROUP INC,4.99597099114,12410,5.73427375423,17439,7.21749911442,45168,5.86832935999,21812,5029,27729
2423,SALESFORCE COM INC,78.4000982425,2068352,73.830130084,2703869,79.4098484714,3335279,71.3297888687,2342808,635517,631410
2424,SALLY BEAUTY HLDGS INC,27.8900695823,3639575,32.3798713145,2762704,29.4098551746,2680054,25.6800263769,4085393,-876871,-82650
2425,SANCHEZ ENERGY CORP,4.31015881804,950081,5.49084073867,593716,7.06091337876,605729,8.84070902866,158019,-356365,12013
2426,SANDERSON FARMS INC,77.5151370027,87699,90.1815923456,154577,86.638177776,75117,96.3368819684,99287,66878,-79460
2427,SANDSTORM GOLD LTD,2.62928397569,153654,3.28678445701,59937,4.44669390116,27661,5.03119483731,559708,-93717,-32276
2428,SANDY SPRING BANCORP INC,26.9590340727,548944,27.8293866613,532854,29.0605364502,592040,30.5798455964,624856,-16090,59186
2429,SANFILIPPO JOHN B & SON INC,54.0709290709,8008,69.0861139778,17442,42.6305353602,42364,51.3267824931,84264,9434,24922
2430,SANGAMO BIOSCIENCES INC,9.13123322503,176975,6.04891733146,68442,5.79122017205,94626,4.63243019517,125636,-108533,26184
2431,SANMINA CORPORATION,20.5858558349,124843,23.378994009,128192,26.8097426381,205858,28.4722789255,122470,3349,77666
2432,SANOFI,32.4425245331,1374369,29.4151040084,1303548,30.4195171444,1348312,29.143617018,1640119,-70821,44764
2433,SANTANDER CONSUMER USA HDG I,15.8501626025,3035931,10.4894358709,1358891,10.330554179,1103813,12.1600784973,1255584,-1677040,-255078
2434,SAP SE,79.0997434833,2254824,80.4204626736,1870606,75.0196944869,1871082,91.4105729458,1523303,-384218,476
2435,SAREPTA THERAPEUTICS INC,38.629492778,14885,19.5167367111,114927,19.0684871971,441776,61.4100493669,282983,100042,326849
2436,SASOL LTD,26.8199233716,12528,29.5393458765,37577,27.1083352408,30581,27.2991824103,21649,25049,-6996
2437,SAUL CTRS INC,51.2838476898,28547,53.0410555643,19023,61.7185949593,15117,66.59822918,15586,-9524,-3906
2438,SBA COMMUNICATIONS CORP,105.070138009,2531509,100.170106775,2203322,107.939701823,2353703,112.159848863,2424290,-328187,150381
2439,SCANA CORP NEW,60.4899198686,3504369,70.1498772,3674675,75.6599994769,2714737,72.3699446107,3735197,170306,-959938
2440,SCANSOURCE INC,32.2321571987,18677,40.3971823814,23566,37.1240263631,41725,36.4958107442,81160,4889,18159
2441,SCHEIN HENRY INC,158.189747224,1615465,172.629760984,1525131,176.800040092,1476606,162.9805203,1180049,-90334,-48525
2442,SCHLUMBERGER LTD,69.7496746941,2496112,73.749810609,3953461,79.0801310277,4739762,78.6400921189,4695671,1457349,786301
2443,SCHNITZER STL INDS,14.3717068868,258494,18.4388574808,426111,17.6009902365,345776,20.8987968052,350068,167617,-80335
2444,SCHOLASTIC CORP,38.5627822077,52045,37.379252415,19048,39.5981947882,13738,39.3700787402,26543,-32997,-5310
2445,SCHULMAN A INC,30.6380586527,74711,27.2150353918,8194,24.4198953433,18919,29.1134700904,139420,-66517,10725
2446,SCHWAB CHARLES CORP NEW,32.9299241262,11165255,28.020020949,5844678,25.3099844436,5420272,31.569956296,4455882,-5320577,-424406
2447,SCHWAB STRATEGIC TR,39.809974972,596132,40.8538951513,633942,43.1564928014,569138,43.3693800849,247179,37810,-64804
2448,SCHWEITZER-MAUDUIT INTL INC,41.9909110582,115525,31.4761832157,222994,35.2789971377,161059,38.5618865625,169027,107469,-61935
2449,SCICLONE PHARMACEUTICALS INC,9.20055196143,279005,10.9996724353,399921,13.059783213,296789,10.2527715637,322742,120916,-103132
2450,SCIENCE APPLICATNS INTL CP N,45.7779409625,144349,53.3445066292,167065,58.3498670852,180943,69.3688913132,337327,22716,13878
2451,SCIENTIFIC GAMES CORP,8.97192832243,163510,9.43270891457,7527,9.18266438539,63707,11.2744611106,80536,-155983,56180
2452,SCORPIO BULKERS INC,9.89016498825,1336277,3.27964241318,189045,2.79651537236,59002,3.4554441724,108235,-1147232,-130043
2453,SCORPIO TANKERS INC,8.01961512121,191281,5.83000699312,832246,4.19996737889,613100,4.62990429316,421391,640965,-219146
2454,SCOTTS MIRACLE GRO CO,64.5135825859,101343,72.7677639363,215535,69.9119066687,138603,83.2723614414,153076,114192,-76932
2455,SCRIPPS E W CO OHIO,18.9989785495,29370,15.5919821288,132504,15.84219751,132368,15.8979595093,376086,103134,-136
2456,SCRIPPS NETWORKS INTERACT IN,55.2100111026,3069552,65.5000430091,1964701,62.2704979879,1272320,63.4903407185,1612387,-1104851,-692381
2457,SEABOARD CORP,2894.23076923,208,3000.0,236,2873.94957983,238,3439.56043956,273,28,2
2458,SEACOR HOLDINGS INC,52.5504964053,11684,54.4634224944,12412,57.9805850888,15143,59.4921835087,78296,728,2731
2459,SEADRILL LIMITED,3.39003782452,4594639,3.29990309863,2929783,3.23996127756,2317003,2.36969180383,2715965,-1664856,-612780
2460,SEADRILL PARTNERS LLC,3.65017495612,2568644,3.48200001448,138139,5.37181377712,18988,3.52798343133,210035,-2430505,-119151
2461,SEAGATE TECHNOLOGY PLC,36.6602498951,1866463,34.44970012,1609477,24.3599512728,6549931,38.54996566,2454866,-256986,4940454
2462,SEALED AIR CORP NEW,44.5992603241,406935,48.0095085289,490507,45.9701380654,586968,45.8192963511,927906,83572,96461
2463,SEARS CDA INC,5.11164645626,98794,2.79349116558,100233,2.96925677219,109455,2.4545516776,102259,1439,9222
2464,SEARS HLDGS CORP,20.5580490255,286749,10.3723693382,156377,9.09584458912,456802,4.69917694653,250895,-130372,300425
2465,SEASPINE HLDGS CORP,17.1661741945,21321,14.6759990969,13287,10.4731486296,13463,10.0725952813,11020,-8034,176
2466,SEATTLE GENETICS INC,44.8785747292,194770,35.0893764494,307016,40.4113714831,340325,54.0102405507,1350318,112246,33309
2467,SEAWORLD ENTMT INC,19.6866768335,93769,21.0344330788,13882,14.3330311217,219493,13.481848005,91753,-79887,205611
2468,SEI INVESTMENTS CO,52.4000920039,1282555,43.0502107115,1869143,48.1095204404,1790789,45.609470343,1221413,586588,-78354
2469,SELECT COMFORT CORP,21.4048107742,98903,19.3902152182,68024,21.3855322512,60742,21.5989928038,290708,-30879,-7282
2470,SELECT INCOME REIT,19.8148618942,133738,23.0535947373,153989,25.9904164828,97459,26.9001760058,480666,20251,-56530
2471,SELECT MED HLDGS CORP,11.9039379888,101143,11.8044387263,62180,10.8797252353,92006,13.4972428795,98835,-38963,29826
2472,SELECT SECTOR SPDR TR,51.5023145954,80278392,51.0778317527,93534589,52.6411904083,89876254,51.4912700821,98973554,13256197,-3658335
2473,SELECTIVE INS GROUP INC,33.5862635956,74197,36.607304328,105061,38.2117456667,93924,39.8566897686,85130,30864,-11137
2474,SEMGROUP CORP,28.8597900831,2574447,22.3999282168,3031349,32.5597237787,2336967,35.360080981,3777678,456902,-694382
2475,SEMPRA ENERGY,94.0102180303,3594822,104.050059941,3370839,114.019695198,2931476,107.189863893,3099099,-223983,-439363
2476,SEMTECH CORP,18.9198712107,2057625,21.9899425997,2024380,23.8602412543,1742145,27.7296579157,2139911,-33245,-282235
2477,SENIOR HSG PPTYS TR,14.8397439841,3494939,17.8898234848,3906858,20.8302070828,1386112,22.7100318142,3230951,411919,-2520746
2478,SENOMYX INC,3.76134889754,15420,2.61780104712,20628,2.75412327076,94767,4.26154037576,128592,5208,74139
2479,SENSATA TECHNOLOGIES HLDG NV,46.0599885284,4600913,38.8401655407,4306856,34.8898607758,4139942,38.7801050519,3928535,-294057,-166914
2480,SENSIENT TECHNOLOGIES CORP,62.8232984438,181334,63.4606078761,130191,71.0427276451,129401,75.8002513263,161543,-51143,-790
2481,SEQUENTIAL BRNDS GROUP INC N,7.91694518717,47872,6.38470163199,32108,7.97456478682,19186,7.98339453936,12526,-15764,-12922
2482,SERES THERAPEUTICS INC,35.07028255,21129,26.56065551,57604,29.0470644653,14597,12.2841464029,19863,36475,-43007
2483,SERITAGE GROWTH PPTYS,40.2199488303,817281,49.9694650152,843295,49.8399838865,804294,50.679749726,545642,26014,-39001
2484,SERVICE CORP INTL,26.0201155737,842233,24.6763509921,347985,27.0384767997,335189,26.5407889448,276141,-494248,-12796
2485,SERVICEMASTER GLOBAL HLDGS I,39.2398626754,601786,37.6816980994,425087,39.7994841173,253546,33.680748418,412283,-176699,-171541
2486,SERVICENOW INC,86.5597573,3616646,61.1800331591,2544098,66.4001179743,1566443,79.1501211501,1799833,-1072548,-977655
2487,SERVICESOURCE INTL INC,4.61070942052,28629,4.24595549495,32266,4.04596212979,18537,4.86176619984,13781,3637,-13729
2488,SHAKE SHACK INC,39.6009337483,35984,37.3223556558,190690,36.4326586802,287654,34.668986293,374773,154706,96964
2489,SHAW COMMUNICATIONS INC,17.1900508979,1176669,19.3097384652,1294321,19.1997551157,1496217,20.4595684968,427575,117652,201896
2490,SHELL MIDSTREAM PARTNERS L P,41.5200961287,5371134,36.610042554,6985952,33.7899500206,5076687,32.080039043,4309097,1614818,-1909265
2491,SHENANDOAH TELECOMMUNICATION,43.0302344015,26493,26.7480360969,61612,39.0559465416,70335,27.2122081114,97640,35119,8723
2492,SHERWIN WILLIAMS CO,259.599394113,472035,284.67038833,1301031,293.669561251,1473326,276.660004615,1278385,828996,172295
2493,SHINHAN FINANCIAL GROUP CO L,33.5887190784,124387,35.2138798496,118618,32.7375041377,120840,36.4360462653,118015,-5769,2222
2494,SHIP FINANCE INTERNATIONAL L,16.5662819521,89157,13.8866563075,111978,14.7355935951,198974,14.7298551869,136797,22821,86996
2495,SHIRE PLC,204.999983769,1232244,171.899340957,1756941,184.07991011,2486594,193.859428117,1127224,524697,729653
2496,SHOE CARNIVAL INC,23.1828978622,10525,26.9997476659,7926,25.0992169902,9323,26.6594775941,16692,-2599,1397
2497,SHORETEL INC,8.85081530868,154788,7.44127187823,224424,6.69010564202,240056,8.0013149014,571906,69636,15632
2498,SHUTTERFLY INC,44.5561491697,113991,46.3624479373,65786,46.6166957593,126607,44.6421941137,323192,-48205,60821
2499,SHUTTERSTOCK INC,32.342648211,95725,36.7354011436,5771,45.8080705747,64159,63.6970748019,104369,-89954,58388
2500,SIBANYE GOLD LTD,6.0912260945,653563,15.1712644549,382829,13.6201550631,954321,14.1298747584,516282,-270734,571492
2501,SIENTRA INC,5.91982853758,813706,6.83971971654,806612,6.58023224199,783407,8.99001361208,794882,-7094,-23205
2502,SIGMA DESIGNS INC,6.3042485153,21890,6.79738562092,19125,6.43518845909,14141,7.78826148848,219176,-2765,-4984
2503,SIGNATURE BK NEW YORK N Y,153.370323541,690453,136.120869631,715614,124.919601324,589251,118.44918774,1030273,25161,-126363
2504,SIGNET JEWELERS LIMITED,123.68985603,880533,124.030272267,316197,82.4105349909,344604,74.5310040231,365888,-564336,28407
2505,SILGAN HOLDINGS INC,53.7250726598,104253,53.1686130066,187874,51.4565828344,139127,50.5853285121,160679,83621,-48747
2506,SILICOM LTD,30.297320722,26537,34.1456547582,63932,29.8956387003,21943,41.407440325,63008,37395,-41989
2507,SILICON LABORATORIES INC,48.539994968,480923,44.9602760912,670503,48.7400957184,652748,58.8004659617,882476,189580,-17755
2508,SILICONWARE PRECISION INDS L,7.74069646672,51029,7.99534816107,13758,7.6608784474,29370,7.39087301587,20160,-37271,15612
2509,SILVER BAY RLTY TR CORP,15.6574923547,106275,14.8509616111,66191,17.0374923171,81350,17.5302784368,120135,-40084,15159
2510,SILVER SPRING NETWORKS INC,14.4102892159,29701,14.7318797879,27152,12.150952214,17118,14.1805766594,269171,-2549,-10034
2511,SILVER STD RES INC,5.17834633598,293530,5.54646924625,334447,12.9918678925,369154,12.0582369549,217113,40917,34707
2512,SILVER WHEATON CORP,12.4203363115,1187649,16.5798286594,1530052,23.5302603108,762550,27.0296736555,868009,342403,-767502
2513,SIMMONS 1ST NATL CORP,51.3541650481,64357,45.0725390524,107804,46.1813778735,112318,49.8978749294,115055,43447,4514
2514,SIMON PPTY GROUP INC NEW,194.439492543,2451359,207.689889778,2417850,216.899936942,2366068,207.009655518,3203039,-33509,-51782
2515,SIMPSON MANUFACTURING CO INC,34.151243932,52736,38.1766015759,93408,39.970663733,122715,43.946769861,97163,40672,29307
2516,SINA CORP,49.405468178,79222,47.369428886,167112,51.8696816625,58994,73.8304093567,346104,87890,-108118
2517,SINCLAIR BROADCAST GROUP INC,32.5400903695,846525,30.7495351305,1232604,29.8601257551,857699,28.879836352,1139030,386079,-374905
2518,SIRIUS XM HLDGS INC,4.0699544675,7146763,3.95003246062,6464757,3.95001624958,7083262,4.16991588181,9126563,-682006,618505
2519,SIX FLAGS ENTMT CORP NEW,54.9418252857,636273,55.489507632,648519,57.9502362782,567763,53.6100535133,836802,12246,-80756
2520,SJW CORP,29.711029711,7371,36.3439930856,23140,39.352896915,13290,43.6742993546,22622,15769,-9850
2521,SK TELECOM LTD,20.1342281879,19370,20.1635108231,47214,20.9199276993,131119,22.5991411367,166732,27844,83905
2522,SKECHERS U S A INC,30.2105263158,1073500,30.4496824102,1684878,29.7203892052,1724540,22.9003988035,1444822,611378,39662
2523,SKULLCANDY INC,4.74286502137,36265,3.55741670563,49193,6.14673096687,50596,6.34029398776,63404,12928,1403
2524,SKYWEST INC,19.0214702681,80856,19.9872029845,92209,26.4599165902,306199,26.4082814874,384955,11353,213990
2525,SKYWORKS SOLUTIONS INC,76.8293767435,854608,77.8995631469,508180,63.2803068241,1152191,76.1391921941,1205240,-346428,644011
2526,SL GREEN RLTY CORP,112.981182274,360830,96.8789316518,329855,106.472069803,444680,108.099937164,1012156,-30975,114825
2527,SLM CORP,6.51999574248,55929331,6.35999429496,48630704,6.18000263231,28864389,7.4699744374,24350418,-7298627,-19766315
2528,SM ENERGY CO,19.6605746491,1103630,18.7400550529,1205386,27.0006647994,917570,38.5807751782,931889,101756,-287816
2529,SMART & FINAL STORES INC,18.2359734971,16451,16.2022443576,31724,14.8838949309,37423,12.7686783729,203310,15273,5699
2530,SMITH & NEPHEW PLC,35.6001268819,122949,33.3161830051,149657,34.3205519012,155825,32.7763007976,131650,26708,6168
2531,SMITH & WESSON HLDG CORP,21.9800336119,846723,26.6202605073,284445,27.1810896628,396820,26.5902013509,484577,-562278,112375
2532,SMITH A O,76.6100823591,754744,76.3093978023,977835,88.1104337561,1258818,98.7895976653,1215381,223091,280983
2533,SMUCKER J M CO,123.340186865,983921,129.840617641,899033,152.409216648,1136552,135.540140477,1033620,-84888,237519
2534,SNAP ON INC,171.429750996,532883,156.990144268,829568,157.819953809,819212,151.961083608,802541,296685,-10356
2535,SNYDERS-LANCE INC,34.300521668,58658,31.4795160263,94220,33.888479797,63827,33.582739712,195130,35562,-30393
2536,SOCIEDAD QUIMICA MINERA DE C,19.0107843739,97734,20.5583572618,82886,24.7286409149,80797,26.9009068546,272370,-14848,-2089
2537,SODASTREAM INTERNATIONAL LTD,16.2974179152,25096,14.0790873492,132537,21.3235088894,71658,26.5561885034,96550,107441,-60879
2538,SOHU COM INC,57.1901953381,272809,49.5379994897,239069,37.8680038822,61820,44.2530191707,106569,-33740,-177249
2539,SOLAR CAP LTD,16.4406859734,21167,17.265456392,15754,19.067713828,25593,20.5088409733,36082,-5413,9839
2540,SOLARCITY CORP,51.0199174561,353509,24.5781556213,363819,23.9324483179,232237,19.5618022794,419491,10310,-131582
2541,SOLAREDGE TECHNOLOGIES INC,28.083313831,4273,25.1387528567,116394,19.6084947988,30089,17.235909908,56742,112121,-86305
2542,SONIC AUTOMOTIVE INC,22.760152595,449294,18.4770775372,66136,17.1079201256,53484,18.793557986,38311,-383158,-12652
2543,SONIC CORP,32.3075660301,280213,35.1593975569,651547,27.0502747856,555706,26.1785511437,445441,371334,-95841
2544,SONOCO PRODS CO,40.8674417803,319007,48.5709129777,648351,49.6599044083,991927,52.8298766524,1390785,329344,343576
2545,SONUS NETWORKS INC,7.12930304362,93277,7.51975205142,78726,8.69070690674,181113,7.77935868047,151812,-14551,102387
2546,SONY CORP,24.6100900637,546280,25.7199878946,733554,29.3502793643,660607,33.2087923754,678224,187274,-72947
2547,SORRENTO THERAPEUTICS INC,8.72323552736,5044,5.44234906974,7901,5.55555555556,9720,7.74275104685,12657,2857,1819
2548,SOTHEBYS,25.7600469981,258734,26.7312672291,658405,27.398914088,621229,38.0191560603,890893,399671,-37176
2549,SOTHERLY HOTELS INC,6.15978243184,43021,5.14651822288,28563,5.62376237624,25250,5.29457565533,19265,-14458,-3313
2550,SOUTH JERSEY INDS INC,23.5221421215,48550,28.4938941655,10318,31.6202795196,1111407,29.5503989621,1481469,-38232,1101089
2551,SOUTH ST CORP,71.9493306236,709541,64.2299251666,733630,68.0494612064,793996,75.0401355351,788578,24089,60366
2552,SOUTHERN CO,46.790182252,2952286,51.730172936,3996797,53.6300694176,4636578,51.3000306252,4679159,1044511,639781
2553,SOUTHERN COPPER CORP,26.1198054015,676881,27.7105143377,549250,26.9803022295,669822,26.3012614189,480015,-127631,120572
2554,SOUTHWEST AIRLS CO,43.060115272,2996044,44.8003085728,1799251,39.2102281797,2054872,38.8899333236,1984061,-1196793,255621
2555,SOUTHWEST BANCORP INC OKLA,17.4797031214,832394,15.0491074065,508070,16.9291912274,500969,18.9905168787,494352,-324324,-7101
2556,SOUTHWEST GAS CORP,55.1597663502,1325060,65.8498282941,1271651,78.7099625624,1076992,69.8601138237,1410075,-53409,-194659
2557,SOUTHWESTERN ENERGY CO,7.13408606692,25040909,8.24277764397,9860875,12.5799635077,6862818,13.8400578964,7439492,-15180034,-2998057
2558,SPARK NETWORKS INC,3.83838383838,19800,2.20791856897,26722,1.58020678134,22149,1.5846383296,21456,6922,-4573
2559,SPARK THERAPEUTICS INC,45.2155625657,4755,29.5119182747,57265,51.129850023,338452,60.0588374079,478947,52510,281187
2560,SPARTAN MTRS INC,3.10440144589,23515,3.94458644956,31689,6.26122304854,232223,9.58758179881,59139,8174,200534
2561,SPARTANNASH CO,21.64447301,110467,30.3067601363,178739,30.5809002433,131520,28.9199430036,156501,68272,-47219
2562,SPDR DOW JONES INDL AVRG ETF,173.989825474,882793,176.639221612,548004,178.999988185,761771,182.779740752,2356968,-334789,213767
2563,SPDR GOLD TRUST,101.459551055,1428727,117.640039454,3435871,126.469782389,3963682,125.639717045,3095900,2007144,527811
2564,SPDR INDEX SHS FDS,39.4831172467,25063092,41.2385344279,22265025,41.3340401495,21559591,41.6012790566,21071780,-2798067,-705434
2565,SPDR S&P 500 ETF TR,203.869976221,67946464,205.520015292,61507547,209.474977148,54481419,216.300037551,58495718,-6438917,-7026128
2566,SPDR S&P MIDCAP 400 ETF TR,254.03940203,244962,262.719876719,1103175,272.229569824,542127,282.268873651,617011,858213,-561048
2567,SPDR SER TR,24.7525495062,466659,28.587248853,568890,28.0730923566,437857,26.8467657805,404518,102231,-131033
2568,SPDR SERIES TRUST,42.9481534952,64181665,37.5678214963,75897028,38.3833302168,69709845,42.8590597777,64456057,11715363,-6187183
2569,SPECTRA ENERGY CORP,23.9402377659,4894730,30.6000036771,5221568,36.6300323573,5143812,42.7500129163,10761564,326838,-77756
2570,SPECTRA ENERGY PARTNERS LP,47.6999225061,1663357,48.1205120961,697291,47.1812717116,668422,43.6905352199,643343,-966066,-28869
2571,SPECTRANETICS CORP,15.0679897097,65304,14.5250460714,59690,18.7121238969,28217,25.0931301174,105766,-5614,-31473
2572,SPECTRUM BRANDS HLDGS INC,101.79976053,1124983,109.280483126,1198860,119.309659669,1291421,137.689637657,1181200,73877,92561
2573,SPECTRUM PHARMACEUTICALS INC,6.02966898661,1366410,6.36002022146,1457857,6.56969936734,1567195,4.66978674722,1645043,91447,109338
2574,SPHERIX INC,0.151760420882,59304,1.80299867147,10538,2.33404910839,10711,1.32050556499,10602,-48766,173
2575,SPIRIT AEROSYSTEMS HLDGS INC,50.0701891608,2429150,45.3598439088,2524678,43.0002124774,2532034,44.5399791188,3500765,95528,7356
2576,SPIRIT AIRLS INC,39.8509396025,206896,47.9790702965,395610,44.8681920678,443031,42.5297519004,708022,188714,47421
2577,SPIRIT RLTY CAP INC NEW,10.0183596044,541406,11.2492974015,647596,12.7705339082,1147407,13.3297270605,2843194,106190,499811
2578,SPLUNK INC,58.8097764208,2989724,48.9300260876,2767217,54.180298753,2139560,58.6802905998,2214730,-222507,-627657
2579,SPOK HLDGS INC,18.3249135868,94025,17.5111463939,108331,19.169184153,110229,17.8165714652,77905,14306,1898
2580,SPRAGUE RES LP,20.1703685485,1268544,20.4502594453,1323015,24.1203079213,1375936,23.6895034524,1391629,54471,52921
2581,SPRINT CORP,3.61976886657,3339716,3.48002443885,3622101,4.53006752874,3445644,6.63006082721,4291665,282385,-176457
2582,SPROUTS FMRS MKT INC,26.5901740843,759115,29.0402422689,343420,22.9002655745,1288151,20.6495836485,1541726,-415695,944731
2583,SPX CORP,9.32919377244,922159,15.0196268075,459066,14.849588711,143573,20.1386917555,123295,-463093,-315493
2584,SPX FLOW INC,27.9103000989,454850,25.0799937054,305024,26.0720542959,235156,30.9265968733,49957,-149826,-69868
2585,SS&C TECHNOLOGIES HLDGS INC,68.269381013,223995,63.4189263345,317082,28.0805339592,818040,32.1503288362,612311,93087,500958
2586,ST JOE CO,18.5072013742,121088,17.1506247108,69152,17.7240311078,123956,18.3798721121,124484,-51936,54804
2587,ST JUDE MED INC,61.7704451226,710793,54.9996458863,2160323,77.9999282554,5519582,79.7599845028,6256596,1449530,3359259
2588,STAG INDL INC,18.4500583473,1755008,20.3601075189,2403671,23.8098915975,3042643,24.5101955321,2052860,648663,638972
2589,STAGE STORES INC,9.10969443834,113725,8.06065311111,60541,4.88143075443,141352,5.61023952699,178602,-53184,80811
2590,STANDARD MTR PRODS INC,38.0317001657,23533,34.6534653465,23836,39.7817146473,25288,47.7609565211,276502,303,1452
2591,STANDEX INTL CORP,83.1515735776,248955,77.8099520469,281108,82.629836993,274344,92.8698104271,272349,32153,-6764
2592,STANLEY BLACK & DECKER INC,106.729825299,1323229,105.209715202,2027750,111.219698871,2769905,122.979780736,2723838,704521,742155
2593,STANTEC INC,24.7916594024,143395,25.3600017642,45347,24.2286909535,63107,23.5071090047,21100,-98048,17760
2594,STAPLES INC,9.46995975356,17816232,11.029996785,14780784,8.62002281396,11221200,8.54997424438,6054989,-3035448,-3559584
2595,STAR BULK CARRIERS CORP,0.607882579191,90478,0.752504206215,140863,2.96053332197,46951,4.54295154185,65376,50385,-93912
2596,STARBUCKS CORP,60.0300100958,8045959,59.6999860728,6390370,57.119862301,6093292,54.1403012502,4964047,-1655589,-297078
2597,STARWOOD PPTY TR INC,20.559926034,9905094,18.9300465423,9772612,20.7200305164,6530251,22.5200297494,6808872,-132482,-3242361
2598,STARZ,33.4981827837,241028,26.333405312,92620,29.9192875035,93418,31.190095285,2062129,-148408,798
2599,STATE BK FINL CORP,21.0294854971,1334317,19.7600192484,1346608,20.3501592471,1356697,22.8198042714,1337873,12291,10089
2600,STATE NATL COS INC,9.81923677751,26886,12.6077174513,23557,10.5410930227,40603,11.1123081896,64973,-3329,17046
2601,STATE STR CORP,66.3599074942,878648,58.5201384018,1187557,53.9197522602,1419554,69.6301431758,1834737,308909,231997
2602,STATOIL ASA,13.9609665349,475182,15.5597708719,532977,17.3106098834,604427,16.8001133178,536544,57795,71450
2603,STEADYMED LTD,3.2380952381,21000,2.45031309556,14692,3.25396825397,12600,3.61344537815,11900,-6308,-2092
2604,STEEL DYNAMICS INC,17.870029276,3094343,22.5100327185,2825007,24.4999950138,5816042,24.9899627766,5048707,-269336,2991035
2605,STEELCASE INC,14.9026996791,339670,14.9197342618,846999,13.5697997889,857345,13.890385249,640443,507329,10346
2606,STEPAN CO,49.6997641004,55956,55.2885614171,72203,59.5318299301,81637,72.6568023432,79208,16247,9434
2607,STERICYCLE INC,117.272614262,780293,126.189910617,736715,104.118670211,457065,80.1392810061,1366159,-43578,-279650
2608,STERIS PLC,75.3409763467,528849,71.0497022535,642325,68.7495916901,918420,73.0995593098,872495,113476,276095
2609,STERLING BANCORP DEL,16.2208309619,119476,15.9308644832,311157,15.6988402205,297729,17.5004247676,535587,191681,-13428
2610,STEWART INFORMATION SVCS COR,37.3235003148,33357,36.2695431915,45796,41.4208120042,25591,44.4546790359,45597,12439,-20205
2611,STIFEL FINL CORP,42.3598299867,1351894,29.6006695245,1233114,31.4496120119,1466282,38.449465549,2354285,-118780,233168
2612,STILLWATER MNG CO,8.57125803307,251305,10.647397803,133272,11.8593542363,417645,13.3605404495,736572,-118033,284373
2613,STMICROELECTRONICS N V,6.65714285714,175000,5.58236988813,133635,5.89011385549,266039,8.14876723778,593464,-41365,132404
2614,STONE ENERGY CORP,4.29048886705,667523,0.790250070244,284720,12.0707752287,40014,11.8741906455,45561,-382803,-244706
2615,STONEGATE BK FT LAUDERDALE F,32.8399629972,6486,29.99751058,8034,32.2499157966,11876,33.7513546989,12918,1548,3842
2616,STONERIDGE INC,14.8000181918,1407228,14.559813495,1239645,14.947926353,43016,18.4015603594,258402,-167583,-1196629
2617,STORE CAP CORP,23.2018964424,230326,25.8804984976,609030,29.4503007564,570894,29.4702136308,797076,378704,-38136
2618,STRATASYS LTD,23.4808328807,528431,25.9209455034,490067,22.8918822267,209725,24.0890661525,227157,-38364,-280342
2619,STRYKER CORP,92.9400505556,1042812,107.290002379,1753127,119.83005253,1919652,116.41002836,1227798,710315,166525
2620,STUDENT TRANSN INC,3.73200639773,16881,5.03175781572,12123,5.13177350613,22994,5.98120193677,31599,-4758,10871
2621,STURM RUGER & CO INC,59.5997498437,15990,68.3844520899,68305,64.0168902042,106097,57.7714285714,35000,52315,37792
2622,SUBURBAN PROPANE PARTNERS L,24.3107373606,563537,29.8903253298,546799,33.4019921299,585504,33.2995357276,562170,-16738,38705
2623,SUCAMPO PHARMACEUTICALS INC,17.2972051806,117360,10.9253245662,148737,10.9767490139,77072,12.3095868134,212761,31377,-71665
2624,SUMITOMO MITSUI FINL GROUP I,7.58989090279,2007934,6.01006050164,2019780,5.7198965602,1615239,6.74970789518,1917120,11846,-404541
2625,SUMMIT HOTEL PPTYS,11.9455006337,63120,11.974368379,139047,13.2450709374,175084,13.1561304571,253570,75927,36037
2626,SUMMIT MATLS INC,20.0397176822,2128523,19.4497339571,2041776,20.4602099725,1882532,18.5499583664,2314237,-86747,-159244
2627,SUMMIT MIDSTREAM PARTNERS LP,18.7296908525,2319152,16.9798475758,1508553,22.849643655,1290042,22.9398344297,2900762,-810599,-218511
2628,SUN CMNTYS INC,68.5293927857,232455,71.6101759425,394106,76.6411455352,463015,78.4812943425,458364,161651,68909
2629,SUN HYDRAULICS CORP,31.6736926057,8777,33.2051022474,19756,29.6928327645,26370,32.2638572968,33412,10979,6614
2630,SUN LIFE FINL INC,31.2001879226,357594,32.2700216604,879485,32.8307813883,918711,32.5404459569,413762,521891,39226
2631,SUNCOKE ENERGY INC,3.46606900865,230232,6.50017263206,217225,5.81736873022,52773,8.03298500036,42201,-13007,-164452
2632,SUNCOR ENERGY INC NEW,25.8001204502,4489824,27.8101423192,4456180,27.7297835217,2350397,27.7797571255,1361279,-33644,-2105783
2633,SUNEDISON SEMICONDUCTOR LTD,7.84539948082,17335,6.45040665607,10697,5.92735115676,128894,11.3903561722,933509,-6638,118197
2634,SUNOCO LOGISTICS PRTNRS L P,25.6999996417,14514436,25.0700125525,16244587,28.7500074874,16527787,28.4099941827,17480609,1730151,283200
2635,SUNOCO LP,39.609842607,1578850,33.130013669,835466,29.949876413,3411767,29.0102189895,2056172,-743384,2576301
2636,SUNPOWER CORP,30.0083501496,172452,22.3425089221,201186,15.4890621071,139195,8.91872649029,317422,28734,-61991
2637,SUNRUN INC,11.7707164764,649833,6.55066530194,4885,5.93081588994,266911,6.30188698548,195497,-644948,262026
2638,SUNSHINE HEART INC,1.3442454434,25293,0.824340527578,26688,0.450484270591,26638,0.553148335945,21694,1395,-50
2639,SUNSTONE HOTEL INVS INC NEW,12.4907983671,597720,13.9997851863,2141390,12.0698501089,1904249,12.7899189225,1182572,1543670,-237141
2640,SUNTRUST BKS INC,42.8400396529,5080084,36.079942846,4728278,41.0799266207,5211280,43.7999461654,6300784,-351806,483002
2641,SUPER MICRO COMPUTER INC,24.506943634,25707,34.04839112,16036,24.866364436,29558,23.3696497849,379167,-9671,13522
2642,SUPERIOR DRILLING PRODS INC,1.01610264359,58065,1.36964716435,82503,2.18530351438,78250,0.942223385461,76415,24438,-4253
2643,SUPERIOR ENERGY SVCS INC,13.4690228346,567079,13.3896236319,1990870,18.4097386889,1336032,17.900652856,1351906,1423791,-654838
2644,SUPERIOR INDS INTL INC,18.4069066623,30695,22.0875183929,62524,26.777332496,154459,29.1608220624,155414,31829,91935
2645,SUPERNUS PHARMACEUTICALS INC,13.4414969209,33776,15.256639809,53616,20.3571614516,38414,24.7340834037,208336,19840,-15202
2646,SUPERVALU INC,6.77989531066,2011093,5.7600923859,5133251,4.71991289427,3954734,4.98998070284,3533681,3122158,-1178517
2647,SUPPORT COM INC,1.0144092219,43375,0.869916425886,32187,0.831579220914,38481,0.833285443365,34802,-11188,6294
2648,SURGICAL CARE AFFILIATES INC,39.7611418584,6866,46.2735330271,61828,47.6647131948,28155,48.7600035532,123831,54962,-33673
2649,SVB FINL GROUP,118.898636735,279036,102.049671315,260432,95.160638582,292022,110.53820129,362671,-18604,31590
2650,SWIFT TRANSN CO,13.8198609777,2318909,18.6304889343,549583,15.4110775527,490686,21.4734743011,82241,-1769326,-58897
2651,SYKES ENTERPRISES INC,30.7689430073,53463,30.1762192323,113268,28.9599139009,131941,28.1352369666,178886,59805,18673
2652,SYMANTEC CORP,21.0000931479,12796848,18.3799439604,12761682,20.5400314775,11809719,25.1001172784,9195216,-35166,-951963
2653,SYNACOR INC,1.75252104462,34807,1.4256730822,18237,3.09673213267,12271,2.91648254529,22630,-16570,-5966
2654,SYNAPTICS INC,80.3363392889,195279,79.7398091457,363733,53.7500276252,407237,58.5804936103,577257,168454,43504
2655,SYNCHRONOSS TECHNOLOGIES INC,35.2409441254,45799,32.3401504466,170160,31.8614092994,163301,41.1790996977,284149,124361,-6859
2656,SYNCHRONY FINL,30.4100850214,11954521,28.6600145768,20388580,25.2800126826,16450862,27.9999702565,16406946,8434059,-3937718
2657,SYNERGY PHARMACEUTICALS INC,5.67042019953,336483,2.7594731131,556628,3.79941069596,531135,5.51071417078,652547,220145,-25493
2658,SYNERGY RES CORP,8.5194192991,425968,7.76873577163,273661,6.66001016187,1806754,6.92996430958,6097434,-152307,1533093
2659,SYNERON MEDICAL LTD,7.6909476662,11312,7.34032411821,10490,7.66098419491,14489,7.13043478261,11500,-822,3999
2660,SYNGENTA AG,78.7334307052,145148,82.8175398832,229420,76.7906797548,238792,87.6001671034,263310,84272,9372
2661,SYNNEX CORP,89.9312479874,177013,92.5905299504,475837,94.8205062499,476089,114.109907876,861012,298824,252
2662,SYNOPSYS INC,45.6102896934,1588852,48.4401087214,1888497,54.0797942429,1735639,59.3500412403,1948339,299645,-152858
2663,SYNOVUS FINL CORP,32.3795282715,1107459,28.9100489891,939189,28.9901401941,1038560,32.5304507199,791689,-168270,99371
2664,SYNTHESIS ENERGY SYS INC,0.958973375412,57353,1.1013215859,19068,1.06826737206,19658,1.20905693559,18196,-38285,590
2665,SYNTHETIC BIOLOGICS INC,2.27863282031,25015,2.35710634431,105638,1.83116645303,10922,1.70891483908,28088,80623,-94716
2666,SYPRIS SOLUTIONS INC,1.12749349523,11530,0.989413277926,10107,0.878103296879,12527,0.997913453688,11023,-1423,2420
2667,SYSCO CORP,41.0000329364,12539307,46.7299402049,8773968,50.7401246904,4596185,49.0101054564,4343594,-3765339,-4177783
2668,T MOBILE US INC,41.3593970069,3755930,38.5584674222,4729078,48.2338154618,1701068,50.0548475802,1205158,973148,-3028010
2669,T2 BIOSYSTEMS INC,10.9399368175,4174887,9.85979122113,4223416,7.88996702265,4252616,7.24001414659,4252616,48529,29200
2670,TABLEAU SOFTWARE INC,94.2197649401,2430870,45.8701001615,1986392,48.9197569687,1550253,55.2700927333,1430231,-444478,-436139
2671,TAHOE RES INC,8.66831643799,213767,10.0298674676,414163,14.9704629712,304533,12.8306335042,374962,200396,-109630
2672,TAIWAN SEMICONDUCTOR MFG LTD,22.7498868644,4202922,26.2000906496,4178726,26.2299527017,3865047,30.5899164582,5324042,-24196,-313679
2673,TAKE-TWO INTERACTIVE SOFTWAR,34.8406155581,312107,37.6709528474,574793,37.9206301067,451733,45.0817763868,493969,262686,-123060
2674,TAL ED GROUP,46.4708073957,883049,49.679828938,876875,62.0600957105,1008458,70.8404825433,1058392,-6174,131583
2675,TALEN ENERGY CORP,6.22977875289,2095259,8.99983765555,1410581,13.5490356064,475532,13.8507553203,725520,-684678,-935049
2676,TALLGRASS ENERGY GP LP,15.970063094,5224588,18.4774330276,30199,22.5640193174,73923,24.0487814144,52643,-5194389,43724
2677,TALLGRASS ENERGY PARTNERS LP,41.2085528355,161350,38.3205598134,87029,46.0237971235,124805,48.2007929977,133670,-74321,37776
2678,TANGER FACTORY OUTLET CTRS I,32.7011876369,491817,36.3905164363,716313,40.1804063382,542553,38.9602642422,452615,224496,-173760
2679,TANGOE INC,8.38730569948,30880,7.88112140537,49866,7.70576629565,53726,8.24938526216,100856,18986,3860
2680,TANZANIAN ROYALTY EXPL CORP,0.263132805797,262225,0.221105164836,221614,0.703329091031,89574,0.801924619086,26187,-40611,-132040
2681,TARENA INTL INC,10.4400865903,5457426,10.8100857484,5457126,10.3299824008,5205914,14.4804714031,980562,-300,-251212
2682,TARGA RES CORP,27.0597382726,2567098,29.8600286374,9961109,42.1400430676,11259979,49.1099971963,12807881,7394011,1298870
2683,TARGET CORP,72.6102672916,3871615,82.2800304107,3713161,69.8197850947,3826709,68.6802022623,3499218,-158454,113548
2684,TARO PHARMACEUTICAL INDS LTD,154.549785154,207823,143.24783675,180631,145.599194792,466960,110.510181254,406777,-27192,286329
2685,TASEKO MINES LTD,0.34433483119,58083,0.549249359209,32772,0.48822165263,32772,0.482633514737,60087,-25311,0
2686,TASER INTL INC,17.2896767083,87104,19.6360597902,43084,24.8888888889,12375,28.6038503678,25556,-44020,-30709
2687,TATA MTRS LTD,29.4695057494,973413,29.0440200612,71581,34.6702500522,1206308,39.9798013715,1542679,-901832,1134727
2688,TAUBMAN CTRS INC,76.7217630854,217800,71.2281112053,342070,74.20006984,1509163,74.4099816479,1867908,124270,1167093
2689,TAYLOR MORRISON HOME CORP,16.0177154457,27095,14.1169691731,34710,14.84193824,40965,17.5996538482,277335,7615,6255
2690,TC PIPELINES LP,49.7110043266,693609,48.2205542325,807892,57.2597612592,731002,57.0290241446,742692,114283,-76890
2691,TCF FINL CORP,14.1189203752,430557,12.2608429087,877509,12.6495781189,875128,14.5101128454,804818,446952,-2381
2692,TCP CAP CORP,13.9461557119,16492,14.8972527713,22823,15.2925907116,17721,16.3878104923,29107,6331,-5102
2693,TD AMERITRADE HLDG CORP,34.7099237962,1560159,31.5307688647,903657,28.4749911485,1403723,35.2399394575,1939135,-656502,500066
2694,TE CONNECTIVITY LTD,64.6112603677,853489,61.9206395436,796568,57.1107185249,1449080,64.3800051939,1374697,-56921,652512
2695,TEAM HEALTH HOLDINGS INC,43.8899035999,220643,41.8099984562,757857,40.66988934,1018616,32.5595835305,1320625,537214,260759
2696,TEAM INC,31.9507186858,12175,30.4236855539,9795,24.799694773,10484,32.7084070275,254430,-2380,689
2697,TEARLAB CORP,1.39538540152,50882,0.631393930086,117201,0.637402796074,70599,0.648254236266,66332,66319,-46602
2698,TECH DATA CORP,66.3802067022,399125,76.770374152,509285,71.8490627623,514704,84.7102223842,1026287,110160,5419
2699,TECK RESOURCES LTD,3.85964937556,2776418,7.60992443827,2939451,13.1697318866,2492154,18.0305043904,1578658,163033,-447297
2700,TEEKAY CORPORATION,9.87140643107,143242,8.6603507696,1023977,7.12995786235,747550,7.70970078809,227765,880735,-276427
2701,TEEKAY LNG PARTNERS L P,13.1499734269,878709,12.6798837516,826506,11.2506535876,1005986,15.1297069314,1474979,-52203,179480
2702,TEEKAY OFFSHORE PARTNERS L P,6.47993965502,5206067,5.67324521697,16569,5.925473427,16370,6.31079203335,17272,-5189498,-199
2703,TEEKAY TANKERS LTD,6.87500739566,84509,3.65732862622,39373,2.98342818462,79774,2.52769310832,40353,-45136,40401
2704,TEGNA INC,25.5196481982,2040467,23.4596909259,2934054,23.1700661734,2774226,21.8604558028,1747905,893587,-159828
2705,TEKLA HEALTHCARE INVS,29.6606314257,274775,24.0006715609,262076,23.433667501,79501,23.8166656668,33338,-12699,-182575
2706,TELECOM ARGENTINA S A,16.0717332961,193383,17.8904659226,199883,18.3300288569,203764,18.3003324482,191308,6500,3881
2707,TELECOM ITALIA S P A NEW,12.6513477368,279654,10.7887230282,228572,8.03102669942,160378,8.11131836021,221419,-51082,-68194
2708,TELEDYNE TECHNOLOGIES INC,88.7022215178,151428,88.1392450994,355517,99.0496698989,310208,107.928468094,296539,204089,-45309
2709,TELEFLEX INC,131.450769227,1149921,157.010177756,1091891,177.309143362,1128622,168.04950429,1079664,-58030,36731
2710,TELEFONICA BRASIL SA,9.03006296191,1557132,12.4898971526,1116022,13.6005113609,1658320,14.4696401017,1988923,-441110,542298
2711,TELEFONICA S A,11.0601027743,2241028,11.1302462866,1950451,9.48000114853,1741350,10.0797864348,1929902,-290577,-209101
2712,TELENAV INC,5.68274600738,30619,5.90166497303,25586,5.10155430533,20974,5.7111274871,21712,-5033,-4612
2713,TELEPHONE & DATA SYS INC,25.8892882103,362003,30.0891947117,410114,29.6590193696,341515,27.1789743537,290997,48111,-68599
2714,TELETECH HOLDINGS INC,27.917066752,28119,27.7535740795,30987,27.1384899348,34674,28.9894337578,36910,2868,3687
2715,TELIGENT INC NEW,8.88824129389,75493,4.896746682,104355,7.13938623706,80259,7.60338414412,109688,28862,-24096
2716,TELUS CORP,27.6499160041,1731036,32.5297664534,2198448,32.200165249,1495924,32.9994177986,333218,467412,-702524
2717,TEMPUR SEALY INTL INC,70.4599519399,496878,60.7909428101,499581,55.3222548504,294565,56.7410833672,403852,2703,-205016
2718,TENARIS S A,23.8000175704,1400083,24.7596343289,1522680,28.8399574426,1187103,28.4000169479,1227288,122597,-335577
2719,TENET HEALTHCARE CORP,30.3001855205,1789560,28.9291915198,1190493,27.6401689826,811681,22.6596158919,1273808,-599067,-378812
2720,TENNANT CO,56.2610888038,21418,51.4603616134,38107,53.8810234816,46547,64.7875388402,49562,16689,8440
2721,TENNECO INC,45.91114018,571822,51.5079765555,180341,46.6088246995,223713,58.2696622283,518812,-391481,43372
2722,TERADATA CORP DEL,26.4218213789,411743,26.2405509943,872314,25.0697763182,1006072,30.9997505569,1278849,460571,133758
2723,TERADYNE INC,20.6699398592,1142819,21.5901868169,1925736,19.6901216426,1904102,21.5802038022,2510866,782917,-21634
2724,TEREX CORP NEW,18.4805723516,258163,24.8776160243,374232,20.3110975869,391067,25.4095064268,258604,116069,16835
2725,TERRAFORM GLOBAL INC,5.5962691539,52535,2.37873048984,109302,3.2497784242,44003,4.11153889027,233246,56767,-65299
2726,TERRAFORM PWR INC,12.5799897989,1978221,8.65012782531,2167020,10.9156242584,29499,13.9136868857,62169,188799,-2137521
2727,TERRENO RLTY CORP,22.6201609361,2379205,23.4497767579,2565824,25.8701932759,2944547,27.5100080609,2940130,186619,378723
2728,TESARO INC,52.3347202959,54075,44.0239183961,71075,84.051157656,133157,100.241381765,154527,17000,62082
2729,TESCO CORP,7.20325712496,12772,8.64271757102,13306,6.69848940224,50907,8.14728600148,18902,534,37601
2730,TESLA MTRS INC,240.010278813,1183016,229.770025162,2856269,212.280032766,1416120,204.02935499,575030,1673253,-1440149
2731,TESORO CORP,105.370250721,2032177,86.0097522553,2396984,74.9197300118,1551327,79.5599956226,1398077,364807,-845657
2732,TESORO LOGISTICS LP,50.3198855067,7041113,45.6600335995,5635804,49.5300704871,5458159,48.4398880943,4063779,-1405309,-177645
2733,TESSERA TECHNOLOGIES INC,30.0176321335,23253,31.0032713188,249135,30.6405371076,275550,38.4381101784,239684,225882,26415
2734,TETRA TECH INC NEW,26.0182237348,54654,29.8206249922,79777,30.7420579039,41897,35.4706684857,171522,25123,-37880
2735,TETRA TECHNOLOGIES INC DEL,7.52466471404,103792,6.3506043504,172582,6.36999157565,270644,6.11261112375,232961,68790,98062
2736,TETRALOGIC PHARMACEUTICALS C,1.74459176553,25794,0.184617656833,54166,0.310181098041,41911,0.158618658086,44131,28372,-12255
2737,TETRAPHASE PHARMACEUTICALS I,10.0294298321,249067,4.63399668477,109193,4.29407744198,67302,3.83877159309,41680,-139874,-41891
2738,TEUCRIUM COMMODITY TR,21.3082259663,4036,20.16985138,4710,20.4081632653,4410,18.7347931873,4110,674,-300
2739,TEVA PHARMACEUTICAL INDS LTD,65.6400988648,4999962,53.5097401834,4080416,50.2297485454,3302306,46.0102067234,2363932,-919546,-778110
2740,TEXAS CAPITAL BANCSHARES INC,49.4206554124,704503,38.3794474407,740735,46.7605743468,719217,54.9195290752,1152031,36232,-21518
2741,TEXAS INSTRS INC,54.8100789072,4094174,57.4201759756,4359809,62.6501895175,3390716,70.1800595065,4396491,265635,-969093
2742,TEXAS ROADHOUSE INC,35.7687813595,218235,43.57928637,332245,45.5981962829,419578,39.0299799469,802870,114010,87333
2743,TEXTAINER GROUP HOLDINGS LTD,14.107107812,86623,14.8296852739,30884,11.1341919402,12035,7.52361133344,12494,-55739,-18849
2744,TEXTRON INC,42.0098766681,3084846,36.4599854372,4331598,36.5601825992,3421263,39.7497938476,2996569,1246752,-910335
2745,TFS FINL CORP,18.8275191952,262435,17.3710928588,350640,17.2186418427,335160,17.8091456119,346002,88205,-15480
2746,THE ONE GROUP HOSPITALITY IN,2.98107927237,16437,3.00875273523,29248,2.60343653623,24967,2.50561038848,45897,12811,-4281
2747,THERAPEUTICSMD INC,10.3696219584,296925,6.39990961036,123908,8.49424380652,87471,6.81072076045,142863,-173017,-36437
2748,THERAVANCE BIOPHARMA INC,16.4056278205,18835,18.7667560322,14547,22.6671703816,15882,36.2572210398,26312,-4288,1335
2749,THERMO FISHER SCIENTIFIC INC,141.849685779,1371487,141.590104873,1464721,147.759488754,1312870,159.059915818,1491526,93234,-151851
2750,THERMON GROUP HLDGS INC,16.9193198599,1294792,17.5597904314,1229001,19.210405174,1316422,19.7497525212,1318295,-65791,87421
2751,THIRD PT REINS LTD,13.4114871868,699475,11.3692115085,845881,11.7203002382,813887,11.9998266805,784678,146406,-31994
2752,THOMSON REUTERS CORP,37.8509258237,1286098,40.4797731451,1726566,40.4201176406,1869762,41.3795878481,869825,440468,143196
2753,THOR INDS INC,56.1490351273,157171,63.7707273126,410690,64.7407356938,381599,84.7004116148,687293,253519,-29091
2754,THRESHOLD PHARMACEUTICAL INC,0.481649166747,51905,0.459532031783,291601,0.637872961936,167745,0.679583909306,129491,239696,-123856
2755,TIDEWATER INC,6.95040727762,86182,6.84059236619,54966,4.40955363669,168271,2.81990504594,424837,-31216,113305
2756,TIER REIT INC,14.7492308023,92954,13.4404510592,151111,15.3317472905,71877,15.4258769085,57047,58157,-79234
2757,TIFFANY & CO NEW,76.2885213509,417009,73.3794483032,843833,60.6395780599,698867,72.6317169122,1007122,426824,-144966
2758,TILE SHOP HLDGS INC,16.3992134204,82382,14.9063230759,107337,19.8775630624,27116,16.5675057208,21850,24955,-80221
2759,TILLYS INC,6.65375639307,20139,6.70223407803,29990,5.78936656189,44219,9.38739736138,86712,9851,14229
2760,TIM PARTICIPACOES S A,8.48008141977,1165319,11.0598122202,1185644,10.5495287665,1730883,12.2405308246,1103792,20325,545239
2761,TIME INC NEW,15.6699802884,493619,15.4399535493,1016130,16.4604240825,684065,14.4779622673,506563,522511,-332065
2762,TIME WARNER INC,64.6697028178,2527103,72.549877816,2499508,73.5399724182,2729332,79.6096295264,2611468,-27595,229824
2763,TIMKEN CO,28.5876820093,256649,33.4903992782,379034,30.660090123,295596,35.1402955556,760466,122385,-83438
2764,TIMKENSTEEL CORP,8.37230483597,57093,9.10156153201,282479,9.60315606426,38529,10.471693703,21391,225386,-243950
2765,TIPTREE FINL INC,6.13050415699,35723,5.71060661199,35723,5.48666125465,35723,5.94906587008,39502,0,0
2766,TITAN INTL INC ILL,3.93645204421,120413,5.37364087738,31822,6.17247314381,16849,10.1204958869,172620,-88591,-14973
2767,TITAN MACHY INC,10.9181794265,60816,11.5507208235,68394,11.1481374159,124236,10.3994955138,90389,7578,55842
2768,TJX COS INC NEW,70.9104809441,1706955,78.3495543871,2413530,77.2297837264,1750607,74.779445335,2194694,706575,-662923
2769,TOKAI PHARMACEUTICALS INC,8.74146808765,16702,5.59375962229,19486,5.5067775724,25968,1.54660917655,21337,2784,6482
2770,TOLL BROTHERS INC,33.2998884263,1103307,29.5099846223,1375365,26.9103784306,1187906,29.8603045934,1063385,272058,-187459
2771,TOOTSIE ROLL INDS INC,31.5738732225,24894,34.9480203495,27126,38.5606004857,13589,36.8175470863,29361,2232,-13537
2772,TOPBUILD CORP,30.7691952814,433518,29.7384646119,365419,36.2010813269,316648,33.2012045908,226799,-68099,-48771
2773,TORCHMARK CORP,57.1602019658,887873,54.1596077699,701833,61.820130761,919846,63.8902373914,949613,-186040,218013
2774,TORO CO,73.0735647239,73296,86.110599644,97758,88.2034140099,142999,46.8398985204,1652352,24462,45241
2775,TORONTO DOMINION BK ONT,39.1703199814,1306576,43.130014173,3153187,42.9298701816,3215337,44.4008591826,1093132,1846611,62150
2776,TOTAL S A,44.9496686082,1160409,45.4208235985,903110,48.1004123869,878059,47.6998074921,868536,-257299,-25051
2777,TOTAL SYS SVCS INC,49.7993304701,2217078,47.5796089249,1537045,53.1101699734,1653318,47.1503164781,3041443,-680033,116273
2778,TOWER INTL INC,28.5703052627,1220883,27.1999424264,1111620,20.5800763305,1131920,24.0999213696,1168759,-109263,20300
2779,TOWN SPORTS INTL HLDGS INC,1.19060743027,45355,2.86388140162,11872,2.71699221618,40854,3.08538811611,38893,-33483,28982
2780,TOYOTA MOTOR CORP,123.03809164,415603,106.320520102,385617,99.9914270009,396594,116.060428622,426950,-29986,10977
2781,TPG SPECIALTY LENDING INC,16.2218172723,27987,16.1414608428,24657,16.6084385918,37210,18.1035350992,39716,-3330,12553
2782,TRACTOR SUPPLY CO,85.5000121587,3372058,90.4597910326,3478341,91.1801565546,2827896,67.3502412017,1965160,106283,-650445
2783,TRANS WORLD ENTMT CORP,3.57157518782,48718,3.61685454217,16589,3.78119485757,15868,3.45800988003,14170,-32129,-721
2784,TRANSALTA CORP,3.53838628771,288267,4.64715436375,301690,5.22272705982,42698,4.48818897638,12700,13423,-258992
2785,TRANSATLANTIC PETROLEUM LTD,1.39015703016,121569,0.749612971564,61365,0.819672131148,89060,1.22226296432,89997,-60204,27695
2786,TRANSCANADA CORP,32.5895093934,870188,39.310027815,1192164,45.2201487262,2963701,47.5599592004,3699057,321976,1771537
2787,TRANSDIGM GROUP INC,228.444912609,153792,220.338586667,384835,263.688022423,482009,289.119860924,486639,231043,97174
2788,TRANSENTERIX INC,2.48045445512,825252,4.25079247528,467207,1.221040455,280089,1.69036926148,160320,-358045,-187118
2789,TRANSGLOBE ENERGY CORP,1.7935095259,59102,1.6467810092,32184,1.83818165903,34273,1.97713118265,30347,-26918,2089
2790,TRANSMONTAIGNE PARTNERS L P,26.7585487749,291533,36.6487208138,275644,41.0887361236,411670,41.2593165277,525142,-15889,136026
2791,TRANSOCEAN LTD,12.3800721809,2118566,9.13994231701,6566234,11.8900996843,3691054,10.6594291847,2118969,4447668,-2875180
2792,TRANSOCEAN PARTNERS LLC,8.82977806398,986095,8.85984220498,1030831,12.6105427481,885291,12.3282791519,258268,44736,-145540
2793,TRANSPORTADORA DE GAS SUR,6.09002585983,1284231,5.8403469513,1262425,6.74957478849,1282303,6.82972268608,1258177,-21806,19878
2794,TRANSUNION,27.5700048391,72356498,27.6099972403,63416341,33.4399930138,63416341,34.5000042425,55510341,-8940157,0
2795,TRAVELCENTERS AMER LLC,9.39685129016,117699,6.77335125772,116043,8.16248223178,114671,7.15895419964,118034,-1656,-1372
2796,TRAVELERS COMPANIES INC,112.860375527,2274988,116.710277089,2048440,119.040576327,2437505,114.549878307,2509588,-226548,389065
2797,TRAVELPORT WORLDWIDE LTD,12.9001181484,3035166,13.6598364333,4759281,12.8899720157,5445551,15.0300114017,5573715,1724115,686270
2798,TREDEGAR CORP,13.6247384329,21505,15.7310302283,25936,16.1051462421,27010,18.5809214877,31753,4431,1074
2799,TREEHOUSE FOODS INC,78.4597421812,2692744,86.7500121768,3264403,102.650134254,3564876,87.1899370411,2982741,571659,300473
2800,TREMOR VIDEO INC,2.06801470588,52224,1.76343433577,52738,1.83690618099,51173,1.71257658353,41458,514,-1565
2801,TREVENA INC,10.5151456685,10366,8.25791855204,17680,6.2818336163,23560,6.74937043785,430855,7314,5880
2802,TREX CO INC,38.0297098111,69472,47.9332116608,81092,44.9267348631,79574,58.7205210873,244412,11620,-1518
2803,TRI POINTE GROUP INC,12.670094297,1032589,11.7798481508,1152986,11.8199311809,561763,13.1797685325,1606705,120397,-591223
2804,TRIANGLE PETE CORP,0.769900654841,822184,0.540982424082,83182,0.288104666731,177019,0.274285825248,411979,-739002,93837
2805,TRIBUNE MEDIA CO,33.8139564594,172207,38.3493887425,92596,39.1816589715,125620,36.5183647413,198941,-79611,33024
2806,TRICO BANCSHARES,27.4397514821,649933,25.3204456302,663061,27.5985348595,672427,26.7705243946,767075,13128,9366
2807,TRIMAS CORP,18.6701277955,10016,17.5123312813,26153,18.0001285994,793161,18.6099037894,2627257,16137,767008
2808,TRIMBLE NAVIGATION LTD,21.4499584716,1014967,24.7996993751,1077755,24.3597245489,1321033,28.5601459065,1666273,62788,243278
2809,TRINA SOLAR LIMITED,11.0197656113,394473,9.94109865775,375713,7.74056936711,382530,10.2397948957,454013,-18760,6817
2810,TRINITY INDS INC,24.0205758854,802104,18.3096358338,1179379,18.5698144991,1216975,24.1793859542,1556822,377275,37596
2811,TRINSEO S A,28.2042080359,75237,36.8084665288,395534,42.9290767872,549115,56.5604747117,899409,320297,153581
2812,TRIPADVISOR INC,85.2507049037,797272,66.4997098231,792620,64.2992255255,420285,63.1799551056,906126,-4652,-372335
2813,TRIPLE-S MGMT CORP,23.9118471738,76322,24.8526035237,86671,24.4325038597,148327,21.929076805,140772,10349,61656
2814,TRIUMPH GROUP INC NEW,39.7496466129,2207919,31.4792387543,346800,35.5006300208,264277,27.8800766014,312266,-1861119,-82523
2815,TRONOX LTD,3.90929220432,130970,6.36233497694,12574,4.41458733205,31260,9.37068257814,299658,-118396,18686
2816,TROVAGENE INC,5.40260462412,158257,4.65220874503,213447,4.52820825623,193454,4.48644841004,119248,55190,-19993
2817,TRUEBLUE INC,25.7581648523,123456,26.1533512585,164759,18.9254623872,151172,22.6584575117,168105,41303,-13587
2818,TRUECAR INC,9.54415003671,59932,5.5898846305,55994,7.84661666644,72133,9.43772431211,112845,-3938,16139
2819,TRUETT-HURST INC,1.44953795978,11038,1.64754005227,17602,1.52842278526,17011,1.60806174957,18656,6564,-591
2820,TRUSTCO BK CORP N Y,6.14381067961,52736,6.05520926091,28075,6.40569395018,57605,7.08831192166,111310,-24661,29530
2821,TRUSTMARK CORP,23.0400978545,284504,23.032186641,342347,24.8498406812,360284,27.5604674336,551950,57843,17937
2822,TSAKOS ENERGY NAVIGATION LTD,7.920977775,319910,6.18036263115,507899,4.68752449584,191359,4.8190894776,115582,187989,-316540
2823,TTM TECHNOLOGIES  INC,6.50963159777,195710,6.64923177509,152950,7.53139179065,151632,11.4494151107,616014,-42760,-1318
2824,TUESDAY MORNING CORP,6.50919988399,31033,8.18578165317,11239,6.98978416161,13019,5.97616414793,203475,-19794,1780
2825,TUNIU CORP,15.9872849663,10696,10.4166666667,12384,8.42827112185,254026,10.1199151247,451486,1688,241642
2826,TUPPERWARE BRANDS CORP,55.6487187536,242108,57.979438624,285584,56.2781161061,261416,65.368787591,284310,43476,-24168
2827,TURQUOISE HILL RES LTD,2.54016832441,1241650,2.54002323622,2042501,3.37962185091,2029517,2.9697491392,975840,800851,-12984
2828,TURTLE BEACH CORP,2.00106723586,14992,1.09159472065,10077,0.986971969996,10132,1.33668815852,12718,-4915,55
2829,TUTOR PERINI CORP,16.7401539496,53524,15.5468929145,43610,23.5520325323,135742,21.4685845218,260986,-9914,92132
2830,TWENTY FIRST CENTY FOX INC,27.1896183195,13789675,28.0148702437,14985363,27.1259580808,15208790,24.4132062342,13861514,1195688,223427
2831,TWITTER INC,23.1400280216,4239580,16.5500061156,6458910,16.9100866986,3465683,23.0499780886,3368116,2219330,-2993227
2832,TWO HBRS INVT CORP,8.10005477084,6368352,7.9398444856,5349601,8.56001998957,13234899,8.52999930999,13072334,-1018751,7885298
2833,TYLER TECHNOLOGIES INC,174.320038359,227329,128.611081738,378280,166.709616854,434612,171.231508348,315345,150951,56332
2834,TYSON FOODS INC,53.5835442703,6684067,66.7156637145,3417893,66.8974031115,3443467,74.7295630635,3957577,-3266174,25574
2835,U S CONCRETE INC,52.6315789474,3819,59.5141700405,4940,60.9172915987,55206,46.0634576238,82039,1121,50266
2836,U S G CORP,24.2877327276,167739,24.8105047131,850285,26.9605708351,746275,25.8507065184,809533,682546,-104010
2837,U S GEOTHERMAL INC,0.628837436789,114497,0.675886451076,96170,0.818537431573,348182,0.72485182356,358694,-18327,252012
2838,U S PHYSICAL THERAPY INC,53.683737646,13356,49.7605274616,16077,60.2397189502,9678,62.7190853691,18543,2721,-6399
2839,U S SILICA HLDGS INC,18.7322928755,345553,22.7182834984,490486,34.4702033541,368028,46.5611230234,627734,144933,-122458
2840,UBIQUITI NETWORKS INC,31.6891796878,362679,33.2533589251,20840,38.6557377049,61000,53.501239266,79886,-341839,40160
2841,UBS GROUP AG,19.3699954218,22231394,16.0199786343,12360004,12.959970548,16433525,13.6200111586,16462615,-9871390,4073521
2842,UDR INC,37.5699822887,1065984,38.5298981635,1148900,36.9197277589,1152067,35.9902735511,1409353,82916,3167
2843,UGI CORP NEW,33.7604244954,552185,40.290532213,737543,45.2504884103,1165004,45.2396903073,1822581,185358,427461
2844,ULTA SALON COSMETCS & FRAG I,185.000066714,1498940,193.740150505,1286868,243.640529787,1358132,237.980422742,1477735,-212072,71264
2845,ULTIMATE SOFTWARE GROUP INC,195.508698431,129851,193.502749453,149848,210.289591494,142960,204.393041112,164624,19997,-6888
2846,ULTRA CLEAN HLDGS INC,5.07274119449,10448,5.35252860834,32508,5.69335774929,60070,7.40704564694,61428,22060,27562
2847,ULTRAGENYX PHARMACEUTICAL IN,112.181604547,396598,63.3115200139,472647,48.9100973708,636433,70.9394063134,641618,76049,163786
2848,ULTRAPAR PARTICIPACOES S A,15.2507769067,431519,19.2804334616,473952,22.0074289317,544089,21.8909859542,639624,42433,70137
2849,ULTRAPETROL BAHAMAS LTD,0.106887091602,112268,0.282978823751,21203,0.321408744266,102673,0.301808906283,102714,-91065,81470
2850,UMB FINL CORP,46.549599577,881318,51.6302795037,525002,53.2107418147,343145,59.4464432819,142027,-356316,-181857
2851,UMPQUA HLDGS CORP,15.9002167127,1466458,15.8603843217,1553178,15.4707849163,1279767,15.0502951995,1424291,86720,-273411
2852,UNDER ARMOUR INC,80.6099372461,3221315,84.8299869412,2611270,38.6662118523,3339091,36.6779387374,3904636,-610045,727821
2853,UNI PIXEL INC,0.516290819243,162699,0.923343455208,105053,1.47331911171,130318,1.66721915645,102566,-57646,25265
2854,UNIFIRST CORP MASS,104.179927859,4713,109.146341463,8200,115.777145725,5977,131.871674996,12406,3487,-2223
2855,UNILEVER N V,43.3204847133,877137,44.6786618827,833888,46.9397994527,825142,46.1015185438,722666,-43249,-8746
2856,UNILEVER PLC,43.119187108,859942,45.1804579023,988901,47.9105758591,1014849,47.3990358742,1047996,128959,25948
2857,UNILIFE CORP NEW,0.493947144986,374534,0.679688549166,364873,3.29271728412,56792,2.10028415609,56659,-9661,-308081
2858,UNION PAC CORP,78.2000162046,3480498,79.549883394,5070064,87.2501826104,5237926,97.5298205567,4874909,1589566,167862
2859,UNISYS CORP,11.057382334,31020,7.7123738233,8817,7.27640552093,30647,9.74366550934,135370,-22203,21830
2860,UNIT CORP,12.1903456379,40852,8.80490576877,80069,15.5632856133,216471,18.600078386,301074,39217,136402
2861,UNITED BANKSHARES INC WEST V,36.9916319686,271629,36.702974986,92908,37.5179714471,109201,37.6693637191,104435,-178721,16293
2862,UNITED CMNTY BKS BLAIRSVLE G,19.4879591072,181548,18.4644821813,62715,18.2917425656,447415,21.0189510551,214711,-118833,384700
2863,UNITED CMNTY FINL CORP OHIO,5.86439588689,12448,5.8727152797,46997,6.08511382857,51437,7.11332503113,100375,34549,4440
2864,UNITED CONTL HLDGS INC,57.3000273474,5591027,59.8598440861,3985276,41.0397044184,1462608,52.4704796462,2299007,-1605751,-2522668
2865,UNITED DEV FDG IV,11.0024289372,76165,3.20344079881,112067,3.19638331876,113253,3.20106197962,119023,35902,1186
2866,UNITED FINL BANCORP INC NEW,12.8958940659,20239,12.5774793388,38720,12.9829192852,50759,13.8423006396,44718,18481,12039
2867,UNITED FIRE GROUP INC,38.3302704122,19045,43.818514953,32201,42.4226826234,23313,42.311230036,47836,13156,-8888
2868,UNITED MICROELECTRONICS CORP,1.86771258571,37479,2.07970593925,20676,1.9916963109,100919,1.85040038139,123757,-16803,80243
2869,UNITED NAT FOODS INC,39.3594052647,612306,40.2993258717,310030,46.7999860236,429295,40.0396422953,432871,-302276,119265
2870,UNITED PARCEL SERVICE INC,96.2300219554,3184183,105.470240166,3683001,107.719842595,3293163,109.359916206,3606934,498818,-389838
2871,UNITED RENTALS INC,72.539584496,872627,62.1902536513,792584,67.1006374695,889768,78.4913028089,782609,-80043,97184
2872,UNITED STATES ANTIMONY CORP,0.289978815437,124147,0.225402907698,212952,0.20983136723,195395,0.448646433709,334339,88805,-17557
2873,UNITED STATES CELLULAR CORP,40.8344429649,9012,45.7040725137,15666,39.2882094275,24333,36.3364090819,45409,6654,8667
2874,UNITED STATES NATL GAS FUND,8.66995174375,1372672,6.65899189635,354408,8.63990766484,1150591,8.36003992,3842685,-1018264,796183
2875,UNITED STATES OIL FUND LP,10.9998996429,3148756,9.70018975955,2436241,11.5699966148,2091444,10.9300773384,5255864,-712515,-344797
2876,UNITED STATES STL CORP NEW,7.97998612176,1259526,16.0515430408,449178,16.8599537327,2237432,18.8600035616,1555461,-810348,1788254
2877,UNITED TECHNOLOGIES CORP,96.0700383887,2088112,100.099834762,4278069,102.549888671,3579019,101.600286224,3558051,2189957,-699050
2878,UNITED THERAPEUTICS CORP DEL,156.610111741,915688,111.430184705,970518,105.92041988,1053253,118.079933236,795639,54830,82735
2879,UNITEDHEALTH GROUP INC,117.640043097,2993275,128.899931046,2904827,141.199693677,3103909,140.000157585,3045968,-88448,199082
2880,UNIVAR INC,17.0095046751,1617625,17.1802384163,1612725,18.9097935537,3044084,21.8500488054,4221867,-4900,1431359
2881,UNIVERSAL AMERN CORP NEW,6.9934912062,43326,7.13460282369,19903,7.56927235864,22195,7.6713434945,19814,-23423,2292
2882,UNIVERSAL CORP VA,56.0906515581,22945,56.806343942,94074,57.7342311791,82568,58.2167487685,101500,71129,-11506
2883,UNIVERSAL DISPLAY CORP,54.4265262465,24308,54.1026590399,132341,67.8013541611,225084,55.5092854038,246139,108033,92743
2884,UNIVERSAL ELECTRS INC,51.3613096268,40439,61.9859671948,21521,72.280611258,31018,74.4618692594,85574,-18918,9497
2885,UNIVERSAL FST PRODS INC,68.3637528018,62460,85.8217428328,70460,92.6980838944,63723,98.4843426587,134793,8000,-6737
2886,UNIVERSAL HEALTH RLTY INCM T,50.0256981326,40859,56.2284211103,18247,57.1691176471,16320,63.025210084,16422,-22612,-1927
2887,UNIVERSAL HLTH SVCS INC,119.491218125,391602,124.719628381,464562,134.099211041,755299,123.219783347,741553,72960,290737
2888,UNIVERSAL TECHNICAL INST INC,4.67338249039,28887,4.32613781839,22653,2.258663162,151417,1.77821153274,120908,-6234,128764
2889,UNUM GROUP,33.2902526239,889029,30.9199095636,1585645,31.7897098344,1959502,35.3103333273,2302782,696616,373857
2890,UQM TECHNOLOGIES INC,0.649614291514,24630,0.575335048057,29548,0.644025589283,46582,0.614947965941,42280,4918,17034
2891,UR ENERGY INC,0.649486695998,47730,0.505011860127,65345,0.597051484209,65321,0.489266711516,65404,17615,-24
2892,URBAN EDGE PPTYS,23.4474017744,272994,25.8403247632,277125,29.8593330352,351113,28.139342924,440984,4131,73988
2893,URBAN OUTFITTERS INC,22.7500747939,4084558,33.0918767975,418985,27.4993136131,866858,34.520095538,2045678,-3665573,447873
2894,URSTADT BIDDLE PPTYS INC,19.2424103458,54515,20.9249262619,17969,24.7925062048,37471,22.2254894754,40809,-36546,19502
2895,US BANCORP DEL,42.6699607066,3310221,40.5897922865,4215518,40.3300928386,4318785,42.8898187131,4623335,905297,103267
2896,US ECOLOGY INC,36.4974697132,6521,44.2018231927,18868,45.9795162345,13767,44.8698773557,6686,12347,-5101
2897,USANA HEALTH SCIENCES INC,127.735068007,40584,121.423525256,11324,111.433286186,42420,138.340473086,42952,-29260,31096
2898,V F CORP,62.2501620631,3345919,64.7594521622,897784,61.4897313371,2012336,56.0502050341,2118672,-2448135,1114552
2899,VAALCO ENERGY INC,1.60326030741,96678,0.94281854145,102883,1.06445027705,68580,0.931784692728,184592,6205,-34303
2900,VAIL RESORTS INC,127.989807527,762131,133.699999866,745273,138.229959433,759734,156.879838657,1229680,-16858,14461
2901,VALE S A,3.17875328501,9004159,3.60890577691,10780553,4.6947544054,8491392,5.2043381054,11207381,1776394,-2289161
2902,VALEANT PHARMACEUTICALS INTL,101.649966027,5814847,26.3000527806,7180670,20.1400053147,6337188,24.5499150564,4735495,1365823,-843482
2903,VALERO ENERGY CORP NEW,70.7099673189,4177643,64.1398805034,3049460,50.9997768363,2836483,53.0001859252,3829496,-1128183,-212977
2904,VALERO ENERGY PARTNERS LP,51.6099555536,3887157,47.3600655704,3557702,47.0102635069,3756903,43.6900595165,4150784,-329455,199201
2905,VALHI INC NEW,1.33625527821,130963,1.18506814142,70882,1.56746452023,23605,2.31153138955,19035,-60081,-47277
2906,VALIDUS HOLDINGS LTD,46.2895464206,454055,47.1892316591,482377,48.5915954332,580018,49.8196737544,838203,28322,97641
2907,VALLEY NATL BANCORP,9.85028628961,1954664,9.53967361575,2632480,9.12022006741,2328014,9.72983067418,2002707,677816,-304466
2908,VALMONT INDS INC,106.041571494,17512,123.840968967,58454,135.27546106,85130,134.579464552,73882,40942,26676
2909,VALSPAR CORP,82.9500976886,1232488,107.019649124,1411666,108.02849069,516660,106.070739762,668337,179178,-895006
2910,VANDA PHARMACEUTICALS INC,9.31456920117,59262,8.36033824855,312906,11.1904474454,347886,16.6396480679,840162,253644,34980
2911,VANGUARD BD INDEX FD INC,80.6604086451,1492591,83.1142622664,2973160,84.865360316,5129914,83.6086157003,3384101,1480569,2156754
2912,VANGUARD INDEX FDS,124.376010441,13173698,120.66790075,11310423,125.180272344,11621999,127.136299285,11213375,-1863275,311576
2913,VANGUARD INTL EQUITY INDEX F,36.2201631032,31135862,38.8134039477,28040545,38.7327327752,28728053,41.0229232237,27146749,-3095317,687508
2914,VANGUARD MALVERN FDS,48.3498068336,2989650,49.1297456267,3534254,49.4800348525,3632455,49.649906213,4510220,544604,98201
2915,VANGUARD NAT RES LLC,2.97915634049,191665,1.4603987764,868256,1.41057934509,29775,0.899558654035,35573,676591,-838481
2916,VANGUARD SCOTTSDALE FDS,82.5547452196,1051690,86.021378199,1352780,83.7379003201,1540330,86.8761031628,1383522,301090,187550
2917,VANGUARD SPECIALIZED PORTFOL,77.7602657486,777878,81.2494808789,746454,83.2398388869,682750,83.9301664151,668389,-31424,-63704
2918,VANGUARD STAR FD,45.1130983693,142575,44.9246956881,116328,44.4769489138,110754,47.2086377686,240062,-26247,-5574
2919,VANGUARD TAX MANAGED INTL FD,36.7199416641,10757016,35.8799830913,10432530,35.3598979739,11785215,37.4098929611,12147081,-324486,1352685
2920,VANGUARD WHITEHALL FDS INC,66.7500286557,479835,69.0402264214,786498,71.4600377238,878491,72.8075830379,1067224,306663,91993
2921,VANGUARD WORLD FD,86.6634695361,266906,89.3438551956,235573,110.791031786,163154,111.171498716,160077,-31333,-72419
2922,VANGUARD WORLD FDS,84.725869164,1128038,85.6539302162,1024880,74.1184151819,1528554,113.862487969,332480,-103158,503674
2923,VANTIV INC,47.420384932,2509638,53.8800613505,1572604,56.5992367833,1638591,56.2697551921,1549909,-937034,65987
2924,VARIAN MED SYS INC,80.8003513348,601136,80.0212555935,594667,82.2297118006,580362,99.5296094995,366504,-6469,-14305
2925,VASCO DATA SEC INTL INC,16.7305835776,112907,15.3967487905,84953,16.3838857379,82337,17.616892911,33150,-27954,-2616
2926,VCA INC,55.0018027854,593526,57.6895941759,978010,67.6099876585,2215294,69.9801826439,2171329,384484,1237284
2927,VECTOR GROUP LTD,23.5961246456,74419,22.840730729,183488,22.4203456271,292859,21.5287626175,335644,109069,109371
2928,VECTREN CORP,42.4227949957,272165,50.5609938157,258559,52.6702376085,288626,50.2000642814,429362,-13606,30067
2929,VECTRUS INC,20.8936853639,66623,22.7574090035,60332,28.4856643303,64629,15.2295632699,129485,-6291,4297
2930,VEDANTA LTD,5.56040264087,230379,5.50315164339,224962,7.86672116152,256905,10.3697040314,282361,-5417,31943
2931,VEECO INSTRS INC DEL,20.5641831597,37541,19.4748505809,14891,16.5676486801,32654,19.6361139719,29130,-22650,17763
2932,VEEVA SYS INC,28.850174344,2178739,25.0398786452,2199172,34.1202143216,2530963,41.2799867948,2399056,20433,331791
2933,VENTAS INC,56.4300379094,5869250,62.9600465883,7519483,72.8198927001,6478477,70.6300166058,5537235,1650233,-1041006
2934,VERASTEM INC,1.8625476254,164828,1.57057243232,24195,1.30776775583,51997,1.33113252755,37562,-140633,27802
2935,VEREIT INC,7.92000788831,3123608,8.87000215303,2582412,10.1399615876,4077333,10.3697771505,2522330,-541196,1494921
2936,VERIFONE SYS INC,28.0198797541,533407,28.2409326687,494495,18.5381031519,244901,15.7399562854,2584950,-38912,-249594
2937,VERINT SYS INC,40.5599619852,1719331,33.3796515587,2161856,33.1299405301,2751982,37.6301643183,2910936,442525,590126
2938,VERISIGN INC,87.3601109038,1240715,88.5393636301,1284536,86.4599313716,1192217,78.2404650034,725328,43821,-92319
2939,VERISK ANALYTICS INC,76.8803449224,716451,79.9194854202,650317,81.0807369384,628275,81.2802701056,732158,-66134,-22042
2940,VERIZON COMMUNICATIONS INC,46.2199825923,16512252,54.0800369617,15029631,55.8399735218,20708373,51.9800393685,18893791,-1482621,5678742
2941,VERMILION ENERGY INC,27.1410322616,183965,29.220804346,129223,31.8240575454,113719,38.7096774194,6200,-54742,-15504
2942,VERSAR INC,3.12304809494,12808,2.44386742019,13094,1.09580463369,12776,1.52402342183,12467,286,-318
2943,VERTEX ENERGY INC,1.10923304458,18932,1.95407914021,16376,1.30807869401,19112,1.1523151058,47730,-2556,2736
2944,VERTEX PHARMACEUTICALS INC,125.830161356,2869924,79.4900738599,4409972,86.0200686918,3637407,87.2099864718,3594703,1540048,-772565
2945,VIACOM INC NEW,41.1721767606,7303233,41.2957846131,7445651,41.4917848954,7990160,38.1161900279,6594232,142418,544509
2946,VIAD CORP,28.1899109792,18872,29.1502774934,18559,31.0255938133,21724,36.9100975481,18965,-313,3165
2947,VIASAT INC,60.98584457,17873,73.4674405661,25154,71.4192581003,30678,74.651668158,70407,7281,5524
2948,VIAVI SOLUTIONS INC,6.08999078089,17972441,6.86000343558,18634393,6.63002832909,14182594,7.38995703336,15370996,661952,-4451799
2949,VICAL INC,0.410364638293,102348,0.393175835071,116996,4.54000342642,11674,3.01802875069,12591,14648,-105322
2950,VICON INDS INC,1.74849629319,28596,0.946040644709,57080,0.500704695497,53924,0.713019740461,49087,28484,-3156
2951,VIMPELCOM LTD,3.27935492045,1097167,4.25795729988,232271,3.88659440547,110894,3.4798739733,2779411,-864896,-121377
2952,VINCE HLDG CORP,4.58440926612,106884,6.32610026529,14701,5.48197663522,64028,5.64275037369,53520,-92183,49327
2953,VIOLIN MEMORY INC,0.901618536577,114239,0.521656655074,63260,0.920424345872,231415,0.730939350776,53356,-50979,168155
2954,VIPER ENERGY PARTNERS LP,13.9536379127,31103,16.3239431039,25239,18.6319869951,15994,16.1513264098,594688,-5864,-9245
2955,VIPSHOP HLDGS LTD,15.269995585,18187890,12.8800254016,22644210,11.1699840723,22896004,14.6700018912,25671435,4456320,251794
2956,VIRGIN AMER INC,36.0213143872,14075,38.5752060974,32145,56.2077157917,171311,53.50832735,284124,18070,139166
2957,VIRNETX HLDG CORP,2.5694774109,699364,4.58978772232,90636,3.9992632936,38007,3.05620012451,35338,-608728,-52629
2958,VIRTU FINL INC,22.6396516711,926251,22.1097992799,804304,17.9998579677,915285,14.9696821262,943173,-121947,110981
2959,VIRTUSA CORP,41.3580840627,20794,37.4675026763,13078,28.8741939459,24347,24.6773376713,130322,-7716,11269
2960,VISA INC,77.5499994723,14308601,76.4800698042,8833857,74.1700967588,7539885,82.6999914928,14223230,-5474744,-1293972
2961,VISHAY INTERTECHNOLOGY INC,12.0499807082,1381413,12.2102079503,1958689,12.3900226882,1458028,14.0898698527,1131948,577276,-500661
2962,VISHAY PRECISION GROUP INC,11.3288566077,21891,14.0309687517,17889,13.4069701009,26255,16.0141093474,14175,-4002,8366
2963,VISTA GOLD CORP,0.275639096543,750982,0.478040751975,750982,1.92015254693,750982,1.05950000271,369042,0,0
2964,VISTA OUTDOOR INC,44.5100851119,3711114,51.9101459988,3447014,47.7300960693,3894482,39.8599672565,4570074,-264100,447468
2965,VISTEON CORP,114.500212255,859815,79.586981662,302650,65.8085528811,493097,71.6603487888,762123,-557165,190447
2966,VITAL THERAPIES INC,11.5263117343,64895,9.0729609968,113965,6.20519835841,91375,6.1252692255,80323,49070,-22590
2967,VITAMIN SHOPPE INC,32.6961043964,41534,30.9601953975,104812,30.5758539911,57202,26.8505288045,174261,63278,-47610
2968,VIVUS INC,1.01983310107,848178,1.39958012596,332957,1.12030116925,396322,1.13915975576,329190,-515221,63365
2969,VMWARE INC,56.5699141502,2632972,52.3101502915,846222,57.2188748784,676158,73.3493136562,543168,-1786750,-170064
2970,VOCERA COMMUNICATIONS INC,12.1998511509,1627151,12.7497851721,1701362,12.8500931016,1689015,16.9000771161,1390112,74211,-12347
2971,VODAFONE GROUP PLC NEW,32.2600049826,5402758,32.0501356316,4931742,30.8901435576,5447919,29.1500127364,5272279,-471016,516177
2972,VOLTARI CORP,4.99442586399,22425,3.93659379461,66555,3.61430692981,55889,2.64258641258,66223,44130,-10666
2973,VONAGE HLDGS CORP,5.73961807382,978985,4.56895204508,812659,6.09983073584,1139048,6.60950654143,1248656,-166326,326389
2974,VORNADO RLTY TR,99.9597037944,2628039,94.4301938877,3634166,100.119978153,3601489,101.209798923,3859567,1006127,-32677
2975,VOXX INTL CORP,5.27157495706,16883,4.46481024556,17022,2.78904511584,164931,2.98578765078,92103,139,147909
2976,VOYA FINL INC,36.9099974619,4617692,29.7699413954,2179010,24.7600330809,4247773,28.8196904489,1308411,-2438682,2068763
2977,VOYAGER THERAPEUTICS INC,21.8995290424,815360,8.73007218447,797817,10.9902864729,689245,12.0099861714,594422,-17543,-108572
2978,VTTI ENERGY PARTNERS LP,20.7300139499,1554847,18.4998425922,1467526,20.3002965807,1453230,19.0098765478,2673505,-87321,-14296
2979,VULCAN MATLS CO,94.969831216,359809,105.569499476,1557429,120.361262426,873271,113.731020542,425460,1197620,-684158
2980,VUZIX CORP,7.59857920058,22241,5.29891304348,14720,7.54285714286,13125,8.85935769657,12642,-7521,-1595
2981,VWR CORP,28.3100439586,165383,27.0582469896,342816,28.8999815953,3743601,28.3600110912,3967100,177433,3400785
2982,W & T OFFSHORE INC,2.3134708711,225635,2.19067251708,154747,2.32199121819,158054,1.75912126931,554254,-70888,3307
2983,W P CAREY INC,58.999872273,1197867,62.2395871193,1375700,69.4199102019,1512059,64.5300953783,1330387,177833,136359
2984,WABASH NATL CORP,11.8300404945,901603,13.2000776794,921737,12.6998060342,847572,14.2392655792,618501,20134,-74165
2985,WABCO HLDGS INC,102.259446205,314015,106.919929033,308876,91.5710314957,351858,113.531446781,183262,-5139,42982
2986,WABTEC CORP,71.1209380235,373125,79.2880147307,290006,70.229439626,406425,81.6496079707,654798,-83119,116419
2987,WADDELL & REED FINL INC,28.6603188793,850165,23.5394889347,1100916,17.219960824,1373290,18.1597543646,722697,250751,272374
2988,WAFERGEN BIO-SYSTEMS INC,0.738075468217,21678,0.640950938119,17162,0.811406050771,17254,0.843923749007,20144,-4516,92
2989,WAGEWORKS INC,45.3698775945,60128,50.621815592,18253,59.8043095075,111196,60.9076214713,236949,-41875,92943
2990,WAL-MART STORES INC,61.2999747887,8742108,68.4901144506,11816187,73.0200681178,9960974,72.1200792264,10396536,3074079,-1855213
2991,WALGREENS BOOTS ALLIANCE INC,85.1550966552,9298363,84.2400331919,8127276,83.269915874,7133945,80.6200476416,7073650,-1171087,-993331
2992,WALTER INVT MGMT CORP,14.2325867517,35763,7.64070070816,10732,2.76484433618,97293,4.0640509411,106790,-25031,86561
2993,WASHINGTON FED INC,23.8300353678,682542,22.6497880288,708351,24.2598579538,628528,26.6811204938,724145,25809,-79823
2994,WASHINGTON REAL ESTATE INVT,27.059961689,2018739,29.2101905643,2260444,31.4601125447,2812927,31.1197350912,2356736,241705,552483
2995,WASTE CONNECTIONS INC,56.3192103804,625719,64.5903701671,885519,72.0499719081,2867371,74.6996446428,1554492,259800,1981852
2996,WASTE MGMT INC DEL,53.3701639242,1637769,59.0006224079,1537577,66.2695673904,1344584,63.7598598917,1832297,-100192,-192993
2997,WATERS CORP,134.580150444,925129,131.921049457,862008,140.650717658,851798,158.489898563,650155,-63121,-10210
2998,WATSCO INC,117.129201403,336227,134.740223275,534228,140.690901998,476797,140.900774444,453099,198001,-57431
2999,WATTS WATER TECHNOLOGIES INC,49.6694676589,1048914,55.1302826198,965785,58.2598156656,957933,64.8392737135,665137,-83129,-7852
3000,WAYFAIR INC,47.6155610875,40974,43.2082896636,50569,39.003652723,48457,39.3760148457,17244,9595,-2112
3001,WD-40 CO,98.6747916743,27241,108.012537169,24886,117.447299289,31214,112.425316948,123522,-2355,6328
3002,WEATHERFORD INTL PLC,8.39011365022,2083762,7.78003705793,11936447,5.55006015909,4784813,5.62006249088,10298462,9852685,-7151634
3003,WEB COM GROUP INC,20.0104115384,424529,19.8198289954,392738,18.1904460614,56898,17.2700211093,297973,-31791,-335840
3004,WEBMD HEALTH CORP,48.2983439823,38345,62.6304924023,682511,58.1070553138,105254,49.698141949,481849,644166,-577257
3005,WEBSTER FINL CORP CONN,37.1899831676,3157006,35.9000022806,3113231,33.9501513113,3272062,38.0102495857,3408528,-43775,158831
3006,WEC ENERGY GROUP INC,51.3098785031,1487199,60.0696662241,2678773,65.3000194932,1790367,59.8800899751,1761821,1191574,-888406
3007,WEIBO CORP,19.5000283431,141128,17.9465433754,73106,28.4137607139,68136,50.1423175382,167583,-68022,-4970
3008,WEIGHT WATCHERS INTL INC NEW,22.7998120209,408556,14.5316326922,287029,11.6297891945,160622,10.3182594725,176774,-121527,-126407
3009,WEINGARTEN RLTY INVS,34.5800710169,3276685,37.5202025802,3237829,40.81998517,3441672,38.9799941572,3477784,-38856,203843
3010,WEIS MKTS INC,44.329596739,13738,45.0805008945,11180,50.5518968556,10781,53.0155421632,22069,-2558,-399
3011,WELLCARE HEALTH PLANS INC,78.2116113975,205660,92.750034227,664679,107.278862469,520988,117.090195933,1075880,459019,-143691
3012,WELLS FARGO & CO NEW,56.2176570381,15451391,49.1775238491,21450470,48.0769542369,24069370,45.0166559525,26116489,5999079,2618900
3013,WELLTOWER INC,68.0297347972,2463511,69.3401494713,2466695,76.1701186177,2802280,74.7702380907,2599430,3184,335585
3014,WENDYS CO,10.7698320197,867423,10.8903283062,1478376,9.61970719138,1294634,10.8004293319,1295967,610953,-183742
3015,WERNER ENTERPRISES INC,23.3898420978,409494,27.1607772712,635917,22.9698691665,587770,23.270611321,617646,226423,-48147
3016,WESCO AIRCRAFT HLDGS INC,11.9894990392,36949,14.3889343716,210092,13.4232017855,157712,13.4291792668,508594,173143,-52380
3017,WESCO INTL INC,43.6805366605,819587,54.6701391426,889663,51.4898692036,763859,61.490577452,786836,70076,-125804
3018,WEST MARINE INC,8.48233140926,28412,9.05401186388,12812,8.38389769687,30654,8.27707660699,17035,-15600,17842
3019,WEST PHARMACEUTICAL SVSC INC,60.2186243095,283683,69.3195359848,626014,75.8801482786,683578,74.4993751303,925793,342331,57564
3020,WESTAMERICA BANCORPORATION,46.7393869471,76274,48.6986817815,38461,49.2471769134,38256,50.8930989978,62759,-37813,-205
3021,WESTAR ENERGY INC,42.4104446055,1059456,49.6102712111,2514056,56.0900284078,1761133,56.7498778395,2863037,1454600,-752923
3022,WESTELL TECHNOLOGIES INC,1.24909339995,24818,1.15647045218,17294,0.674515575178,16308,0.514767389486,15541,-7524,-986
3023,WESTERN ALLIANCE BANCORP,35.8606715852,129306,33.379236509,978872,32.6492727936,929791,37.5387075322,542853,849566,-49081
3024,WESTERN ASSET MTG CAP CORP,10.2203366635,182675,10.0495335165,175033,9.3885238595,139106,10.4197205542,289931,-7642,-35927
3025,WESTERN DIGITAL CORP,60.0504403547,1627665,47.240016624,5582280,47.2599469378,3830601,58.4700121974,2305404,3954615,-1751679
3026,WESTERN GAS EQUITY PARTNERS,36.289347686,988527,35.6396532063,183279,38.2500089057,3031764,42.4908989348,830672,-805248,2848485
3027,WESTERN GAS PARTNERS LP,47.5299573957,3682730,43.4098888089,4900934,50.3999477439,5082664,55.0498616993,3975396,1218204,181730
3028,WESTERN REFNG INC,35.6196438742,1132465,29.0896428933,582991,20.6294341493,831191,26.4603246852,1054560,-549474,248200
3029,WESTERN REFNG LOGISTICS LP,24.5298267042,1367315,23.3496123794,1212397,26.1898664046,1530592,23.1799003639,3015975,-154918,318195
3030,WESTERN UN CO,17.909943603,4529495,19.2898408369,4529379,19.1798665021,4205608,20.8199102874,4161065,-116,-323771
3031,WESTLAKE CHEM CORP,54.320939462,768525,46.300367786,1873916,42.9198470559,1541478,53.500160021,1581042,1105391,-332438
3032,WESTLAKE CHEM PARTNERS LP,22.1798412364,565243,19.7000378404,391116,19.981364261,384208,22.8380727985,263989,-174127,-6908
3033,WESTPAC BKG CORP,24.2299861288,739662,23.2592048767,781841,22.0901684007,779985,22.7395858006,734622,42179,-1856
3034,WESTPORT INNOVATIONS INC,2.02156334232,69748,2.61322404166,106382,1.67259609517,221213,1.60345709899,87935,36634,114831
3035,WESTROCK CO,45.6199360376,3083060,39.0300067026,2733256,38.869731432,2701588,48.4803545712,1306818,-349804,-31668
3036,WEX INC,88.3994673999,1152835,83.3603086269,225515,88.6699507389,177016,108.090316987,186853,-927320,-48499
3037,WEYERHAEUSER CO,29.9801031262,5000283,30.9799541372,5823895,29.7700963634,2647892,31.9400810483,7927375,823612,-3176003
3038,WGL HLDGS INC,62.9887852479,631668,72.3704110326,981893,70.7904106902,1177603,62.6998334244,1222268,350225,195710
3039,WHIRLPOOL CORP,146.868020062,271761,180.337198341,342647,166.639241943,352480,162.157746987,465226,70886,9833
3040,WHITE MTNS INS GROUP LTD,726.811773436,8086,802.672661421,8007,841.985990935,9708,830.135194069,9172,-79,1701
3041,WHITESTONE REIT,12.0100083403,29975,12.5895640206,24703,15.0914596617,40619,13.8730339929,63072,-5272,15916
3042,WHITEWAVE FOODS CO,38.9091482082,710784,40.6405004787,1666884,46.9406113108,1058316,54.4299206501,2040330,956100,-608568
3043,WHITING PETE CORP NEW,9.43987745114,2677789,7.98015671429,2651577,9.25994362841,3625940,8.73986789691,7417389,-26212,974363
3044,WHOLE FOODS MKT INC,33.5000190502,25301508,31.1099993339,21123337,32.020038306,13832307,28.3500485457,12259591,-4178171,-7291030
3045,WIDEPOINT CORP,0.698125709958,84512,0.573065902579,13960,0.608383524974,16437,0.433087916847,16163,-70552,2477
3046,WILEY JOHN & SONS INC,45.0269050512,115220,48.8919175729,208378,52.1791029613,393740,51.6384166423,629144,93158,185362
3047,WILLIAMS COS INC DEL,25.6999613168,19512364,16.0699136267,14969900,21.6300648582,10268254,30.7299950207,17508366,-4542464,-4701646
3048,WILLIAMS PARTNERS L P NEW,27.8499163651,12149839,20.4499720162,13657916,34.6400387771,14705584,37.1899579384,15408111,1508077,1047668
3049,WILLIAMS SONOMA INC,58.4099428287,2418869,54.7397939417,2384956,52.1299164279,2247999,51.0800228414,1516542,-33913,-136957
3050,WINDSTREAM HLDGS INC,6.43985494137,972848,7.67973016674,661742,9.26768990635,153760,10.0492432331,154539,-311106,-507982
3051,WINTRUST FINL CORP,48.5206148773,497335,44.3414053369,366204,51.0016097299,111820,55.5730066489,114606,-131131,-254384
3052,WIPRO LTD,11.5426513668,177169,12.5779115437,187392,12.3619558626,217684,9.70975174587,450063,10223,30292
3053,WIRELESS TELECOM GROUP INC,1.7355215997,26505,1.32259786064,43097,1.33757318797,39624,1.70856092573,38629,16592,-3473
3054,WISDOMTREE INVTS INC,15.680721239,539516,11.4299895486,991252,9.7913261843,343263,10.2876464866,215890,451736,-647989
3055,WISDOMTREE TR,49.5640960908,19040779,51.4200925792,13763997,49.9234386198,12438386,53.1413638351,11268943,-5276782,-1325611
3056,WISDOMTREE TRUST,47.1339463476,16316966,43.5965213255,13016222,39.558431592,9048564,42.6770769375,8714983,-3300744,-3967658
3057,WIX COM LTD,22.7447660099,25984,20.2732481269,29497,30.3510957679,182201,43.4462143237,48842,3513,152704
3058,WMIH CORP,2.59256845322,138087,2.33975393099,443209,2.2287801556,48457,2.33968545735,368853,305122,-394752
3059,WNS HOLDINGS LTD,31.1914997999,154914,30.6414925648,152114,27.0048139016,102204,29.9828669332,7004,-2800,-49910
3060,WOLVERINE WORLD WIDE INC,16.7098875816,454641,18.4214493831,570422,20.3160787907,261960,23.0293685919,540918,115781,-308462
3061,WOODWARD INC,49.660576398,578628,52.0202532379,828312,57.6399620479,1092957,62.4806194741,1138385,249684,264645
3062,WORKDAY INC,79.6804124918,512786,76.8398686498,543585,74.6700801196,835127,91.6896192442,1173797,30799,291542
3063,WORLD FUEL SVCS CORP,38.4599243441,1215239,48.5794198702,1217038,47.4900896549,703810,46.259905199,1052099,1799,-513228
3064,WORLD WRESTLING ENTMT INC,17.8359096314,68962,17.6638555017,30118,18.4042729381,48304,21.2851405622,29880,-38844,18186
3065,WORTHINGTON INDS INC,30.1294793961,93065,35.6408933308,331389,42.2991642504,175890,48.0305684639,460082,238324,-155499
3066,WPCS INTL INC,1.38222619725,24598,1.38222619725,24598,1.62614846736,24598,1.30054866897,24605,0,0
3067,WPP PLC NEW,114.744488339,78470,116.422399187,94432,104.519041756,92586,117.721075782,91394,15962,-1846
3068,WPX ENERGY INC,5.73995729094,5189063,6.98990968786,2874143,9.30998841074,3862196,13.1899705514,3991366,-2314920,988053
3069,WRIGHT MED GROUP N V,24.1801772594,1270793,16.5996824015,1192071,17.3696169714,608649,24.5291713416,499120,-78722,-583422
3070,WSFS FINL CORP,32.3597391714,779209,32.5200483098,763406,32.1911074361,767945,36.490489508,845645,-15803,4539
3071,WYNDHAM WORLDWIDE CORP,72.6505835626,1048388,76.4298780852,1003652,71.230679687,386575,67.3281115518,462422,-44736,-617077
3072,WYNN RESORTS LTD,69.1899869247,1034008,93.4309427336,168563,90.637971725,263554,97.4195820363,743988,-865445,94991
3073,XCEL ENERGY INC,35.9104087834,1650385,41.8198973904,6131005,44.7800601476,5075183,41.1400529711,5741242,4480620,-1055822
3074,XENCOR INC,14.6051754439,33002,13.4299626316,44155,18.9815817985,23075,24.4904135054,138789,11153,-21080
3075,XENIA HOTELS & RESORTS INC,15.3294392215,379205,15.62032496,307484,16.7776268201,265711,15.1816869759,383159,-71721,-41773
3076,XERIUM TECHNOLOGIES INC,11.8556092957,16954,5.22309403911,42695,6.37748515363,38730,7.94016699964,19521,25741,-3965
3077,XEROX CORP,10.6297301418,4144696,11.1601054019,6576730,9.49000320494,6602316,10.1298609891,8268919,2432034,25586
3078,XILINX INC,46.9696988411,3238556,47.4296448413,1827549,46.1299109809,3003626,54.3400738846,2246206,-1411007,1176077
3079,XOMA CORP DEL,1.32539114273,65641,0.772445756376,72497,0.550876845338,252325,0.457636814339,235995,6856,179828
3080,XPO LOGISTICS INC,27.2615232931,40570,30.7030357759,75302,26.2606437141,135526,36.6700258249,2336895,34732,60224
3081,XYLEM INC,36.5000704954,2964734,40.8999457574,6192551,44.6500143047,5928128,52.4500522746,5717878,3227817,-264423
3082,YADKIN FINL CORP,25.1714005877,10210,23.6912495224,20936,25.0897513367,196933,26.2890059166,236791,10726,175997
3083,YAHOO INC,33.2599792136,40742088,36.809996037,31103046,37.5600333569,23618536,43.099978156,34210783,-9639042,-7484510
3084,YAMANA GOLD INC,1.85991326374,2568937,3.04010032891,3393638,5.20002263036,7459006,4.30993914902,3442508,824701,4065368
3085,YANDEX N V,15.7202532865,1661360,15.3202976843,1637305,21.8498450347,1486784,21.0504540659,483410,-24055,-150521
3086,YELP INC,28.7999210961,365001,19.8800832516,556386,30.3594329578,376621,41.6998588183,380361,191385,-179765
3087,YOU ON DEMAND HLDGS INC,1.8963690111,53787,1.85287610619,36160,1.63004105289,49692,1.53505031554,41041,-17627,13532
3088,YPF SOCIEDAD ANONIMA,15.7200433969,12294877,17.8800273029,12007532,19.1999409395,11188524,18.2199816428,10893809,-287345,-819008
3089,YRC WORLDWIDE INC,14.2477999721,7159,9.33402050049,34926,8.79933793849,59209,12.3273579656,59299,27767,24283
3090,YULONG ECO MATLS LTD,4.45731090892,21762,4.0127069052,11962,1.6719612105,11962,2.3407456947,11962,-9800,0
3091,YUM BRANDS INC,73.0499936558,15108297,81.8500699379,5048047,82.9202272015,3409132,90.8100376394,3063549,-10060250,-1638915
3092,YUMA ENERGY INC,0.185678034289,48471,0.203263049488,73796,0.292033629978,65061,0.243087207536,65820,25325,-8735
3093,YUME INC,3.52818539011,24942,3.74635770778,14414,3.67718041879,113946,3.97157382806,108773,-10528,99532
3094,YY INC,62.4954262715,13665,61.5892326243,204841,33.8675573069,166472,53.2827912067,149842,191176,-38369
3095,ZAGG INC,10.942344267,76766,9.00909107471,109778,5.2535347602,120871,8.10617106987,80926,33012,11093
3096,ZAYO GROUP HLDGS INC,26.5898929137,792632,24.2402811555,692855,27.9298640697,923635,29.7095426764,1488377,-99777,230780
3097,ZEBRA TECHNOLOGIES CORP,69.6498102231,651818,68.9970925114,255547,50.1013834347,233766,69.6104958091,415785,-396271,-21781
3098,ZELTIQ AESTHETICS INC,28.5306704708,79213,27.160720011,65499,27.3345153664,54144,39.2131549646,61969,-13714,-11355
3099,ZENDESK INC,26.4544270096,52959,20.9422524093,67137,26.3825718104,81569,30.7096335652,288346,14178,14432
3100,ZILLOW GROUP INC,23.9904514838,511912,24.2973808853,251879,36.328365857,355177,34.6156654532,191734,-260033,103298
3101,ZIMMER BIOMET HLDGS INC,102.590004954,32161174,106.630011873,5717124,120.379614737,2301702,130.02082401,1237994,-26444050,-3415422
3102,ZION OIL & GAS INC,1.86576089557,20903,1.73022853435,13871,1.3651328997,12453,1.37618392293,12353,-7032,-1418
3103,ZIONS BANCORPORATION,27.2451349826,6359484,24.2100302332,6051624,25.1302270393,3007056,31.020325651,2097399,-307860,-3044568
3104,ZIOPHARM ONCOLOGY INC,8.30911425771,236728,7.41975724683,169143,5.48921760827,140275,5.63035127679,266058,-67585,-28868
3105,ZIX CORP,5.08126284327,80295,3.93011980195,194905,3.75212522718,255855,4.10132689988,323310,114610,60950
3106,ZOES KITCHEN INC,27.9793744678,954739,38.9881832363,490405,36.2675007447,322272,22.1895241847,566123,-464334,-168133
3107,ZOETIS INC,47.9199253164,5014219,44.3298241986,4990974,47.4602121106,4227794,52.0100077077,4535704,-23245,-763180
3108,ZOGENIX INC,14.7392023583,127551,9.23969669742,864747,8.05038883183,869399,11.4294288451,853061,737196,4652
3109,ZUMIEZ INC,15.1221900942,85768,19.9229342086,35035,14.3139710443,85441,18.0044408275,99531,-50733,50406
3110,ZYNGA INC,2.68003719907,1337668,2.27949892673,1248520,2.48990084466,1089200,2.91016858207,1328789,-89148,-159320
